,camera_id,timestamp,md5,bicycle,car,motorcycle,bus,truck,total
0,1702,2022-10-01 00:02:00,4fa329c809cfa328de68b9b04132903c,0,14,0,0,0,14
1,1702,2022-10-01 00:07:00,accf238260f05c60c70679144fdc9450,0,12,2,0,1,15
2,1702,2022-10-01 00:12:00,63f093630b7477b00c07f356c25de50c,0,15,1,0,0,16
3,1702,2022-10-01 00:17:00,2dbf61fbaa538a140fa02dd6a87a4545,0,6,0,0,0,6
4,1702,2022-10-01 00:23:00,33924a42799d3d0ca7495eba574a9cbd,0,5,1,0,1,7
5,1702,2022-10-01 00:27:00,c8c6055f92fb3be0cf717a0227ac112c,0,16,0,1,0,17
6,1702,2022-10-01 00:33:00,9e20f50bba6800abc377076b5a6025b9,0,14,0,0,0,14
7,1702,2022-10-01 00:36:00,daf45fbbafc5c3448573eb37bc3eee73,0,16,0,0,1,17
8,1702,2022-10-01 00:41:00,c0b9ed3ccb5a76fe888d7f7644cc393f,1,19,1,0,0,21
9,1702,2022-10-01 00:48:00,00dcef07dd5794a68ed5ace3e8844f74,0,13,1,0,1,15
10,1702,2022-10-01 00:52:00,affea745d9e75b718e14d8e77e053e95,2,16,0,0,0,18
11,1702,2022-10-01 00:57:00,f0462c810e23b51c58a2586b77b57160,0,7,0,3,0,10
12,1702,2022-10-01 01:02:00,427f45b386971d065beabcfaf519d9da,0,7,1,0,1,9
13,1702,2022-10-01 01:07:00,de687bc194baacbad02722499f81c34f,0,12,1,0,1,14
14,1702,2022-10-01 01:11:00,4c4a1f528efea2f911c54dfd6ef2697f,0,4,0,0,1,5
15,1702,2022-10-01 01:17:00,f6bccac9348c412598cd9fede65ef04f,0,9,0,0,2,11
16,1702,2022-10-01 01:22:00,34b4912ed0e3ee1211686233026140bf,0,9,2,0,0,11
17,1702,2022-10-01 01:27:00,9af352ddd5bd693c00e50ee84a139d4c,0,8,0,0,0,8
18,1702,2022-10-01 01:33:00,5fea65e8d589c8c4b602853fa2d84027,0,8,1,0,0,9
19,1702,2022-10-01 01:37:00,86935b621e0d7d4fd2542d29fd13ef66,0,11,0,1,0,12
20,1702,2022-10-01 01:42:00,f488e99f05e5a7cc6dd4751fd8f99686,0,12,2,0,1,15
21,1702,2022-10-01 01:47:00,f3391dd84eb9cafbc4195d06dea08019,0,4,0,0,0,4
22,1702,2022-10-01 01:52:00,84919faace1aeed612ee1d83370df637,0,16,2,0,2,20
23,1702,2022-10-01 01:57:00,fb2c102a59a3a678ce0e886df02159fc,0,12,0,0,0,12
24,1702,2022-10-01 02:02:00,016dc0f9bb7ee7c61f85d2ab65c7e7dc,0,8,1,0,0,9
25,1702,2022-10-01 02:07:00,e87a4c8f110c4b7fecf92b73ea244d7c,0,8,1,0,0,9
26,1702,2022-10-01 02:11:00,40516056eb50fb8f746a8c20c53d48a7,0,7,5,1,0,13
27,1702,2022-10-01 02:17:00,efc3169817394594738e4bf5c278938d,0,9,0,0,0,9
28,1702,2022-10-01 02:22:00,3fa9e7b6f9e17ffd3bf16471323be480,0,11,0,0,1,12
29,1702,2022-10-01 02:27:00,05f330ab94799184b2e43aea97dcaab7,0,2,0,0,1,3
30,1702,2022-10-01 02:33:00,93bec6dbe2b198f672bc87caa6498fec,0,10,0,0,0,10
31,1702,2022-10-01 02:37:00,3b0cc6d908d4463e8e2de1c90a4f35a8,0,8,0,0,0,8
32,1702,2022-10-01 02:42:00,c70034866b1b1ff14c6e2da91b5f9b51,0,9,0,0,1,10
33,1702,2022-10-01 02:48:00,39afc927f68258e372ab1dd05bd3e36b,0,11,0,1,1,13
34,1702,2022-10-01 02:52:00,2a0513789715998bac5d16e220d783a3,0,3,0,0,1,4
35,1702,2022-10-01 02:57:00,c122956b3daa6892ebb76b535a8f476b,0,15,1,0,1,17
36,1702,2022-10-01 03:02:00,51be27277e313d6a40f9df07b6a500d0,0,8,3,0,0,11
37,1702,2022-10-01 03:08:00,4001b19591de5f15bb613ba5ab5dfb9a,0,13,0,0,1,14
38,1702,2022-10-01 03:12:00,e6d4804093bd8737863310585894bd23,0,8,0,0,0,8
39,1702,2022-10-01 03:17:00,70483cebbf601e41b29a2c5741092227,0,15,0,0,0,15
40,1702,2022-10-01 03:22:00,1fbbe0ae917400cbfd09b5a3eca16d16,0,11,0,3,0,14
41,1702,2022-10-01 03:26:00,82402e0aafd413dacd835a91b355f0ca,0,2,0,0,1,3
42,1702,2022-10-01 03:32:00,5a2cb6d8c1e8c8efc4902b2d448c63e0,0,3,1,0,0,4
43,1702,2022-10-01 03:38:00,d077871167a6176a6ba69cbed2ed4442,0,6,0,0,1,7
44,1702,2022-10-01 03:43:00,fa7c1d487c3ffe7de41d008c8937aa65,0,9,0,0,0,9
45,1702,2022-10-01 03:47:00,5ad5c9a36e080fbea5e6e39949b68b96,0,4,0,0,1,5
46,1702,2022-10-01 03:52:00,4cee6d809f7a8d6fcf56f795755150b3,0,1,2,0,0,3
47,1702,2022-10-01 03:57:00,8c5159e852f9d26942adb87a041ba2ac,0,6,0,0,0,6
48,1702,2022-10-01 04:03:00,3e6de5337e6bc2877ccce677ed33e4fe,0,2,0,0,0,2
49,1702,2022-10-01 04:08:00,fcd8ccc6cb6a3bfde2e6a51a90284cac,0,5,0,0,0,5
50,1702,2022-10-01 04:14:00,70ec074cc42a57a58058c95632926f07,0,3,0,1,1,5
51,1702,2022-10-01 04:17:00,ad643ecfb840d53ad50a7a3cd4633125,0,7,0,0,0,7
52,1702,2022-10-01 04:23:00,3f88e864e9f07f3f37258ce5ae1c7906,0,4,0,0,0,4
53,1702,2022-10-01 04:26:00,ae8f23a2bea42ced4327eb6816d0cc9d,0,6,1,0,1,8
54,1702,2022-10-01 04:32:00,e8ebdcc6dc3b6224e74c8594bf60d79d,0,5,0,0,1,6
55,1702,2022-10-01 04:36:00,5e056000c4cb4f1b8add144aba1dddce,0,6,0,0,0,6
56,1702,2022-10-01 04:41:00,9e8e5088b1aa739204283323c661ac12,0,4,0,0,2,6
57,1702,2022-10-01 04:47:00,da9f9df138ed1ef241eafd19b5ddb5cb,0,1,0,0,1,2
58,1702,2022-10-01 04:52:00,378dacc2f55029d2abaa299b41bff395,0,1,0,1,0,2
59,1702,2022-10-01 04:57:00,1054e7d175e77079eac4213663cea8bd,0,11,0,0,1,12
60,1702,2022-10-01 05:02:00,5315fa10c5c1147477dc9dde98649781,0,11,0,0,3,14
61,1702,2022-10-01 05:07:00,bf8a9c6eb5d3092c0d5b211184e64d69,0,2,0,1,0,3
62,1702,2022-10-01 05:11:00,32b4d5a3825c6eda5b79e8bc526adbdf,1,7,0,0,1,9
63,1702,2022-10-01 05:16:00,1100030d6c545804da7c80a756460697,0,1,0,0,1,2
64,1702,2022-10-01 05:21:00,91f90c34713c1992bb72cfefb485492a,0,5,0,0,0,5
65,1702,2022-10-01 05:26:00,687cb139cc5a04ec01a3dc2a1c891c34,0,2,0,0,0,2
66,1702,2022-10-01 05:31:00,e79eb3b1b8d751be61167f024575fb05,0,8,0,0,0,8
67,1702,2022-10-01 05:37:00,63f7fa4ec47a3ccfb3e99b181caeaaa4,0,6,1,0,0,7
68,1702,2022-10-01 05:41:00,eb027f1911c6eb87232c2a3f426e5b50,0,9,0,0,3,12
69,1702,2022-10-01 05:46:00,6a75c621250556e538c406732695a33f,0,6,0,1,0,7
70,1702,2022-10-01 05:52:00,43a79a50bdcdc958b1e2198ab7ff8456,0,5,1,1,2,9
71,1702,2022-10-01 05:57:00,a6f2a429ddca58f89b6105125c5f85ca,0,15,0,0,1,16
72,1702,2022-10-01 06:01:00,a486bbb103d1d776c83fc9946786c1bd,0,7,0,0,0,7
73,1702,2022-10-01 06:07:00,2321f6772f17c1bb21a26f990166a51a,0,7,1,2,0,10
74,1702,2022-10-01 06:11:00,756a46917d0dfb8be361be35c89f6ecc,0,8,1,0,0,9
75,1702,2022-10-01 06:17:00,d05a05c7229b5c9a0153e504f393fdf6,0,1,0,0,0,1
76,1702,2022-10-01 06:22:00,2cac99fe76f72da394bd0946ef5dbfdd,0,3,0,0,0,3
77,1702,2022-10-01 06:26:00,e973ecc6e8b9eba6e9ddc421fe85a88a,0,4,0,0,0,4
78,1702,2022-10-01 06:32:00,9fa38481df6ccc16609319f5581cb632,0,12,0,2,0,14
79,1702,2022-10-01 06:37:00,731bd9e9b3b6c0f6d13e8cd74ff53864,0,7,1,1,0,9
80,1702,2022-10-01 06:41:00,3dc911f3afbdcf6a3f87eda3a92a5d46,0,8,0,1,1,10
81,1702,2022-10-01 06:47:00,2166b95201047773992f49d9482c15de,0,15,1,0,6,22
82,1702,2022-10-01 06:52:00,41e8c33df54a2d7c17bf9c8776d14b42,0,9,0,1,5,15
83,1702,2022-10-01 06:56:00,ea7fe0f555b6c2055616393beb1be001,0,21,1,2,2,26
84,1702,2022-10-01 07:03:00,a9e681e4b51a7bde9aee0d82654ed375,0,9,0,1,6,16
85,1702,2022-10-01 07:07:00,9f684df97014b9ddcc6fc624a00d3a04,0,6,1,0,7,14
86,1702,2022-10-01 07:12:00,cdec675b9eb7c5f801be78325d38087b,0,8,0,0,9,17
87,1702,2022-10-01 07:17:00,a94cd87b8c3c15d6c0452c728689afae,1,5,0,3,14,23
88,1702,2022-10-01 07:21:00,96b4f94f9359a8b1038f6d241bd1d232,0,8,0,0,9,17
89,1702,2022-10-01 07:26:00,a21a7c09949237b28cf96bd6f7bae28d,0,13,0,0,7,20
90,1702,2022-10-01 07:32:00,ef48b9310766c2cb1770963b7c235c18,0,18,0,0,9,27
91,1702,2022-10-01 07:37:00,3fe50184e817cfc84d22849d4e483822,0,14,0,2,3,19
92,1702,2022-10-01 07:41:00,27250da027bb2fa2d5ec4436c28c9291,0,10,0,2,11,23
93,1702,2022-10-01 07:49:00,fe633e84c78219a191aab7ce9872d062,0,9,0,3,7,19
94,1702,2022-10-01 07:52:00,c437420eee60e299d5885565746c7951,0,10,0,1,11,22
95,1702,2022-10-01 07:56:00,887b829d343abb0c1389b2054aced8be,1,6,0,0,13,20
96,1702,2022-10-01 08:02:00,2290ce1d4f5af6a60b73e47244fc1183,2,6,0,6,5,19
97,1702,2022-10-01 08:07:00,60db8071b3de7a7c2191d8e3df5946fb,0,9,0,2,8,19
98,1702,2022-10-01 08:12:00,cb417b3ed66b5fa3ae15f2c27490c3d8,0,18,0,2,5,25
99,1702,2022-10-01 08:17:00,ce6ea23f58da4a2d60e41e648f2ff02e,0,9,0,0,12,21
100,1702,2022-10-01 08:21:00,9971940d254fdc9093164d6e196ac392,1,12,0,0,13,26
101,1702,2022-10-01 08:27:00,3b671a7e649c0bac758d36354a190797,0,11,0,1,10,22
102,1702,2022-10-01 08:32:00,6453587139cda3cb0d72b34b79eb70b5,0,16,0,0,12,28
103,1702,2022-10-01 08:36:00,2b026c9240c6541d7f26c74a26c72df9,0,8,0,0,15,23
104,1702,2022-10-01 08:41:00,aa1b0b022a2e51f087bd1765ca46cbf3,0,16,0,2,11,29
105,1702,2022-10-01 08:47:00,48517f64861952d7abacbec01edf806e,0,13,0,1,8,22
106,1702,2022-10-01 08:52:00,a3cb2db0438c6c5bae0df1139c3ce32e,1,12,0,2,10,25
107,1702,2022-10-01 08:57:00,4f64b6697a295b0c4b9325458305d278,1,12,0,0,13,26
108,1702,2022-10-01 09:02:00,5cb98432fca881ff8580cee2135c25d0,0,9,1,0,9,19
109,1702,2022-10-01 09:07:00,053a995527db3b3221c8c3be0791e421,0,15,0,2,10,27
110,1702,2022-10-01 09:11:00,6cac15f64c8f2f92e280ad4f2a6e2f69,0,12,0,6,7,25
111,1702,2022-10-01 09:18:00,8dce040ef069b0863ab4a08a44e06779,2,14,0,1,7,24
112,1702,2022-10-01 09:22:00,c7cc4d3a5e27bdf8e5fde432ef3ab8d5,0,11,0,2,12,25
113,1702,2022-10-01 09:28:00,0278cbf88cc23d80f2a7f858daefece0,0,14,1,3,10,28
114,1702,2022-10-01 09:31:00,6953a2af0fc5e834573f03121ea535a3,0,12,0,4,8,24
115,1702,2022-10-01 09:37:00,8ab6e3646d7aa549cea004b915c4586b,0,7,1,2,13,23
116,1702,2022-10-01 09:42:00,8a377228327a9b624d62ab018a2cbc0d,0,9,2,3,10,24
117,1702,2022-10-01 09:47:00,a66c818dc18764af1700a8df59f54b1e,0,15,0,1,9,25
118,1702,2022-10-01 09:52:00,808facf7f9e6a3547bd8cf100e443f55,0,12,0,1,11,24
119,1702,2022-10-01 09:57:00,17d123988a84a7be2b29d6782498ec26,0,11,0,1,13,25
120,1702,2022-10-01 10:01:00,f6530e1b434f2a9acfe174d203bfa4ed,0,7,0,0,8,15
121,1702,2022-10-01 10:07:00,9c6aa4eaf1e2e7578d84452024b38d1a,1,15,0,3,4,23
122,1702,2022-10-01 10:11:00,456de9276f65dbee1c0712bd151c3fb3,0,11,1,3,8,23
123,1702,2022-10-01 10:17:00,502ccb7f2805aa89adb07282ad815a16,2,8,0,3,12,25
124,1702,2022-10-01 10:23:00,e5414a450ed7141a191b027e6813c83e,0,8,0,2,12,22
125,1702,2022-10-01 10:27:00,539c95628d6ef78d52da82605443fcb6,1,15,0,4,2,22
126,1702,2022-10-01 10:32:00,12351999c7d1919d789030fc4e9f74b1,0,20,0,2,7,29
127,1702,2022-10-01 10:37:00,5869d31c75be379337bd6f1ec8670eae,0,16,0,2,8,26
128,1702,2022-10-01 10:42:00,b7d34a47384d61a7e13c8b85a53c7260,0,12,0,1,15,28
129,1702,2022-10-01 10:47:00,3937a35dc1bd9ddecd1856ef5ea5c156,0,14,0,0,13,27
130,1702,2022-10-01 10:52:00,b4e4b4cfc4fcba8b6962e55eee8a9a35,0,7,0,4,13,24
131,1702,2022-10-01 10:56:00,f2cf67bf13ebdf166071345be900c546,0,15,0,1,11,27
132,1702,2022-10-01 11:02:00,28358a5505f3667d99c30887674509af,1,18,1,5,7,32
133,1702,2022-10-01 11:07:00,63fb8ec7c679def2836095c8c449d3a1,0,17,0,0,5,22
134,1702,2022-10-01 11:13:00,77b30444373faa5dd05647d407a6be78,0,13,0,1,5,19
135,1702,2022-10-01 11:17:00,2d548ff4ba2f78f42b36146219564f1f,1,14,1,2,4,22
136,1702,2022-10-01 11:22:00,cd0f83e4534b1ce1d42d1449d783da7e,0,7,0,3,18,28
137,1702,2022-10-01 11:26:00,df1cb8464a81d7506ca225aedfea32fe,0,18,0,6,2,26
138,1702,2022-10-01 11:32:00,29099d26e3f5fef33538682ab29b3eaa,0,14,1,2,11,28
139,1702,2022-10-01 11:37:00,e788d453ab00db8409f92c518a49536e,0,10,0,6,11,27
140,1702,2022-10-01 11:42:00,c07dc874f1151bdf9bfea72f2cdbaf2a,0,12,0,5,16,33
141,1702,2022-10-01 11:47:00,8cdf2c3a00a0c2bcb8a77c7a21704ffc,0,16,0,4,6,26
142,1702,2022-10-01 11:52:00,a0ff9ab6a7999118fd21ca3cc7c3a599,0,18,0,5,11,34
143,1702,2022-10-01 11:56:00,3b3d9adc564e37e57f1649832e2457fd,0,13,0,1,15,29
144,1702,2022-10-01 12:02:00,01017ea0fca5038b7ddb08f32524e27e,0,17,0,0,6,23
145,1702,2022-10-01 12:07:00,1b67e448967d67ed15725d7b449b29bc,1,15,0,3,8,27
146,1702,2022-10-01 12:12:00,461e73f507333ca709a7ce318c26a092,0,12,0,0,14,26
147,1702,2022-10-01 12:17:00,4cdb00057c0e5b00c0eafc1cd0aa4756,1,11,2,4,8,26
148,1702,2022-10-01 12:22:00,d4ecaf8fee8a477a1e7817b6f2ca5122,0,18,0,5,10,33
149,1702,2022-10-01 12:27:00,6b6c72fdb5d12e21b17f5304942d0062,0,13,0,1,5,19
150,1702,2022-10-01 12:32:00,a21a397031f7bec94113d11e56354e3d,0,18,0,2,8,28
151,1702,2022-10-01 12:37:00,981d7f2f0723eb4ebd80942af70d84f3,0,14,0,3,13,30
152,1702,2022-10-01 12:42:00,1950fd0d87e5283b17d4f7e825d1e7ba,3,12,0,4,11,30
153,1702,2022-10-01 12:47:00,f4f1810d4a95ddabce44261c5ecb346b,0,12,0,5,9,26
154,1702,2022-10-01 12:53:00,a0f90f45bdf4e4db6802349094e3c7e2,0,13,0,2,8,23
155,1702,2022-10-01 12:57:00,03380820958207175eaf8ef33323c849,0,18,0,1,12,31
156,1702,2022-10-01 13:02:00,92bc401675106fd5f8c5053333ee2c2b,2,17,0,3,11,33
157,1702,2022-10-01 13:07:00,71ac048f62d8ae89fbf427ccc03fa197,1,19,0,0,7,27
158,1702,2022-10-01 13:11:00,a8665ac11d5402ba93d91ac2fd51a0db,0,25,0,3,10,38
159,1702,2022-10-01 13:17:00,430e61d07d1cdd965d5c6d072231e7d7,0,17,0,2,9,28
160,1702,2022-10-01 13:22:00,2073091eae18520feab8f76c3cbb96f2,0,21,0,4,7,32
161,1702,2022-10-01 13:26:00,8e54131201c2e6dde67a19865f1fd07f,0,23,0,0,5,28
162,1702,2022-10-01 13:31:00,6272ab0046f02411ca8251e38ebd23d8,0,28,0,1,2,31
163,1702,2022-10-01 13:37:00,93b76d9e2182494c4fe386bb0fd49e97,0,31,0,3,3,37
164,1702,2022-10-01 13:42:00,1e3965af0f47a7462b429e50f9068c41,0,24,0,3,6,33
165,1702,2022-10-01 13:46:00,b6569c458a654663ad0f8e89272c2b01,0,25,0,2,5,32
166,1702,2022-10-01 13:51:00,43b466b13d7cd1238ea44b61e0b2df5f,0,20,0,4,4,28
167,1702,2022-10-01 13:56:00,4aee4be0ec7a85fba315e97f4ced45e3,1,19,0,0,2,22
168,1702,2022-10-01 14:02:00,add8f310a82db267245c146482f85aee,0,19,0,3,6,28
169,1702,2022-10-01 14:07:00,81925c44e489fdc48fbe642e8aa758c2,0,26,0,3,9,38
170,1702,2022-10-01 14:11:00,bd7a2d19925edb40669f3541832c4e9d,0,22,0,0,7,29
171,1702,2022-10-01 14:17:00,d48f06b92df9e894a86c30c643aabf49,1,23,0,4,5,33
172,1702,2022-10-01 14:22:00,e25b7d8139b6a562a45d7d82ef552041,0,16,0,1,13,30
173,1702,2022-10-01 14:26:00,5d5c8b34f0df1eaa72332829a0350cc9,0,23,0,2,8,33
174,1702,2022-10-01 14:32:00,a31bf82e0b2f5ad122cabbd824b52347,0,14,0,2,8,24
175,1702,2022-10-01 14:37:00,916b85adc7ff21e586d0201d0e10f97d,0,12,0,4,9,25
176,1702,2022-10-01 14:42:00,17930dcc8ec1660d46a46f5ce39a8767,0,22,0,1,5,28
177,1702,2022-10-01 14:47:00,58da3591bd7ab91e7994ecac9e92447a,0,20,0,6,8,34
178,1702,2022-10-01 14:52:00,dc6287a273d31d4b8a2bff50aa955404,0,17,0,4,11,32
179,1702,2022-10-01 14:57:00,21c4bd860933e6e89eb796e00b9d1300,0,18,0,1,6,25
180,1702,2022-10-01 15:02:00,13a4d886b3eaf4cf077903a28bc4b798,0,18,0,2,11,31
181,1702,2022-10-01 15:07:00,f16092c63cadcdba49d872971fcd05ad,1,17,0,0,7,25
182,1702,2022-10-01 15:12:00,ba5c6d002a795466b6804c5892b4368d,0,23,0,0,6,29
183,1702,2022-10-01 15:17:00,c52654a7817723e266573c68f383dcdc,0,13,0,1,9,23
184,1702,2022-10-01 15:22:00,62d46b42a4c8ed62b5bdbbc5f4fa5c3e,0,13,0,0,16,29
185,1702,2022-10-01 15:27:00,4d6876a9f9ecdae0299bdd1c2f7044e8,2,12,0,1,16,31
186,1702,2022-10-01 15:32:00,1dcb0ba337af9407a8d8f66acdacb01c,0,14,0,2,6,22
187,1702,2022-10-01 15:37:00,7017a18fab4dcd9ad9e2ff174c404e19,0,16,2,1,8,27
188,1702,2022-10-01 15:42:00,57d88c5293c11e01d690df67b0cdb5d7,1,15,0,3,13,32
189,1702,2022-10-01 15:47:00,c2f8a515cd5cacf08da75eccb831ee3a,0,15,0,3,10,28
190,1702,2022-10-01 15:53:00,7773c5d4d9467bc2d35dc6dd200f81f5,0,13,0,2,12,27
191,1702,2022-10-01 15:57:00,9c7e01400320a68b6eb87d86609569ab,0,15,1,7,7,30
192,1702,2022-10-01 16:02:00,50f0662834b118b3fb6cf97130873acc,0,14,0,2,15,31
193,1702,2022-10-01 16:07:00,1565eddb3556fc4b8dab2238593fe2db,0,12,1,3,8,24
194,1702,2022-10-01 16:12:00,0ba5566d635482ff73b7e96f2d9f0f83,2,16,0,3,10,31
195,1702,2022-10-01 16:17:00,0ca2455f15fab0c2566273d61374e8d3,0,10,0,0,17,27
196,1702,2022-10-01 16:23:00,bbe5c0bc3d9af88c219a00971b977665,1,13,0,1,6,21
197,1702,2022-10-01 16:26:00,ecd123bbfab600e7d3dc74f37cbc267f,0,17,0,2,8,27
198,1702,2022-10-01 16:31:00,41f4aef75658f7c69bf37379ab23aced,1,12,0,5,9,27
199,1702,2022-10-01 16:37:00,7f81848a70cc8a1df3407de4043a886a,0,16,1,5,7,29
200,1702,2022-10-01 16:41:00,7f6460b4365a994589ec4d1269cffe06,0,19,1,3,8,31
201,1702,2022-10-01 16:47:00,d20aa4ec3849c0ec7895b963e9cfe870,0,13,0,1,10,24
202,1702,2022-10-01 16:52:00,a3b42dcbae9044eb5c62ef77b6876503,0,19,0,0,8,27
203,1702,2022-10-01 16:57:00,bb84d96c3cd17ca421dc14aa03358958,0,20,0,2,7,29
204,1702,2022-10-01 17:03:00,4cc8dc3778984601429230dbe344db5e,0,9,0,0,15,24
205,1702,2022-10-01 17:07:00,935180445b903b11a38fd752a44d0a53,0,16,1,4,8,29
206,1702,2022-10-01 17:12:00,2f93af29eb49eaf82363c894088bb957,0,26,0,1,0,27
207,1702,2022-10-01 17:16:00,5a49428cd7f6b980972333be8e4b0b38,0,23,0,1,4,28
208,1702,2022-10-01 17:22:00,51a8cb9e810920668518e4fd272d7602,0,20,0,5,3,28
209,1702,2022-10-01 17:27:00,85b40d498513b5c735b53f9f5acd0cd7,0,21,0,4,5,30
210,1702,2022-10-01 17:32:00,54c4fd67ffcbc99d7f43ac072a7c5d3c,0,27,1,1,4,33
211,1702,2022-10-01 17:38:00,26f62b5b950b013556364c36c7c456f4,0,21,0,5,4,30
212,1702,2022-10-01 17:41:00,c06ca844eb5139f78fe099b6b28808c0,0,22,0,1,6,29
213,1702,2022-10-01 17:48:00,1904202799ac33267f0ccdd541b7da93,0,12,1,1,14,28
214,1702,2022-10-01 17:52:00,fb6d31460182d5efe2e6e9cd4c1ee4b6,0,21,0,0,12,33
215,1702,2022-10-01 17:57:00,cc8006804cb30beb3876629663467228,0,25,0,3,8,36
216,1702,2022-10-01 18:03:00,3eab233119af47ae5bd02e6ae5cb1c69,1,18,0,3,5,27
217,1702,2022-10-01 18:06:00,fc8a6a51f9f23979ed5cda9b52110a7c,0,15,0,1,12,28
218,1702,2022-10-01 18:12:00,056b4377b970a332beab645290b79350,1,17,0,0,6,24
219,1702,2022-10-01 18:17:00,3d5eb25f6f6897603bc2f666ffe712f6,1,11,0,3,13,28
220,1702,2022-10-01 18:22:00,a224f3ac7581dd42149c5e6c5f3b4571,0,16,0,2,11,29
221,1702,2022-10-01 18:27:00,0c0c5c41e95395362a6b7de958acbc83,0,20,0,6,10,36
222,1702,2022-10-01 18:32:00,791bf1460d7dc292b53b163628d7d191,0,14,0,2,13,29
223,1702,2022-10-01 18:37:00,8abf184f4b3eadfe36919adfd539e40e,0,15,0,3,9,27
224,1702,2022-10-01 18:41:00,84ca486751e16ff315d65b8280f0a034,0,17,0,4,10,31
225,1702,2022-10-01 18:47:00,09d2e56c4d77182c51d0320e20b02dfb,2,18,0,5,5,30
226,1702,2022-10-01 18:51:00,e7b38fbc47a8d36bfd5da7baf1d6a63b,0,13,1,3,6,23
227,1702,2022-10-01 18:57:00,4f6296a68538b9bde493edeba0dad5d7,0,9,0,1,8,18
228,1702,2022-10-01 19:02:00,d50d237bf3bf921428dbede320938284,0,17,0,0,4,21
229,1702,2022-10-01 19:06:00,d4f2d44c8b2e3949e416103d43a0e5fb,0,25,0,3,2,30
230,1702,2022-10-01 19:11:00,d335d6391e41ec6958849e019d097018,0,24,0,2,0,26
231,1702,2022-10-01 19:16:00,b4376c19e8b3865c358c2e8f129f2f37,0,15,4,2,2,23
232,1702,2022-10-01 19:22:00,7d5f999615a78f6c951c6e0247ee6741,0,12,0,2,1,15
233,1702,2022-10-01 19:26:00,a6446cefeca834b6b84af9bc5d440ae0,0,18,1,4,0,23
234,1702,2022-10-01 19:31:00,abe0cdd9d16bc8db6a39eb2044adb2a6,0,20,0,1,0,21
235,1702,2022-10-01 19:37:00,2482d56790941d5774f56fe84562eed1,0,15,0,0,1,16
236,1702,2022-10-01 19:41:00,04d52beecdb3835b4a082f84a1761c48,0,16,0,1,0,17
237,1702,2022-10-01 19:47:00,ce2ef70af3282702c446c0deff8ecc18,0,18,0,0,0,18
238,1702,2022-10-01 19:52:00,a063cfc240b006b2dea329a64be2c383,0,19,0,1,2,22
239,1702,2022-10-01 19:57:00,0a203626f1d19d0986992c4382c24f98,0,17,0,2,0,19
240,1702,2022-10-01 20:02:00,7f75ded75c198918600b95f9fe5c7b37,0,10,0,1,0,11
241,1702,2022-10-01 20:07:00,25d3e6b358e344f979868d689e63efc1,0,20,1,0,0,21
242,1702,2022-10-01 20:11:00,53810a6c0ff9ca09879c388fd6f49ee9,0,28,0,0,0,28
243,1702,2022-10-01 20:17:00,1b941949a6dc461d89adfcda1419001a,0,7,0,0,0,7
244,1702,2022-10-01 20:21:00,186574fc74b60919913b9c5564ea6591,0,13,0,0,2,15
245,1702,2022-10-01 20:26:00,cced6a0b784219337a4ef992e7e6c14b,0,12,1,2,2,17
246,1702,2022-10-01 20:31:00,1dbf6593e9feedaf9fef58d190a1e91a,0,11,0,0,0,11
247,1702,2022-10-01 20:37:00,31446e32e62a5d87f065c0cbe599e046,0,17,1,0,0,18
248,1702,2022-10-01 20:42:00,786cf25422e5863f6126eb26299e73dc,0,17,0,0,1,18
249,1702,2022-10-01 20:48:00,23a269b5d34fdcfdc604b83858aafca7,0,19,0,0,0,19
250,1702,2022-10-01 20:51:00,43b8be64b117b243b796c5d6d5ebefbf,0,18,4,0,0,22
251,1702,2022-10-01 20:56:00,d2ca4cdd15e8d0f3d8e99c56cede5f83,0,19,0,1,0,20
252,1702,2022-10-01 21:02:00,565c4e01709fa495a15d1da07a94413c,0,18,1,0,1,20
253,1702,2022-10-01 21:07:00,93e7ab9fd550b23fe240ac3c87eaacee,0,21,0,1,0,22
254,1702,2022-10-01 21:12:00,fa892a0bc979307744161c064ed43e26,0,20,0,2,0,22
255,1702,2022-10-01 21:16:00,8fa4c9b15718dbd0e5acef3e82f03faf,3,21,1,1,2,28
256,1702,2022-10-01 21:21:00,19d8c7573c16c77fd91f4cbdd0b14668,0,21,1,0,1,23
257,1702,2022-10-01 21:27:00,0c0c63154460506ab648688f9968f763,0,15,1,0,0,16
258,1702,2022-10-01 21:31:00,9a1d0ab95bcbb6f3ca0aac4a4df744a1,0,12,0,0,0,12
259,1702,2022-10-01 21:37:00,ceadd3df72cd1682506a49852a0199f7,0,14,0,0,0,14
260,1702,2022-10-01 21:42:00,993f5b49c4ad46ccb6232dc8158097ed,0,22,0,0,0,22
261,1702,2022-10-01 21:47:00,38bf00f64cbc682ef251036ae7b7abd1,0,18,0,2,0,20
262,1702,2022-10-01 21:52:00,fa6ae4993b3c48baea57f54281e1cf01,0,16,0,1,0,17
263,1702,2022-10-01 21:57:00,9b741289b92cbf87c73a1d894e129c5f,0,21,0,0,1,22
264,1702,2022-10-01 22:02:00,8199e2fec471c4812bdedda07c5ee094,0,16,0,1,0,17
265,1702,2022-10-01 22:07:00,a2725bfbc8311bb155257a4506db9315,0,20,4,1,1,26
266,1702,2022-10-01 22:11:00,bbf2a64e5440e6febc32fed2dba0290a,0,18,0,0,0,18
267,1702,2022-10-01 22:17:00,52970a10a606b88976c701081b9991cd,0,18,0,0,1,19
268,1702,2022-10-01 22:22:00,f69bbd53eac8eeaec61f62bb8ebe76fe,0,13,1,0,3,17
269,1702,2022-10-01 22:26:00,8b8e3f9c0c36ee676beb596094a2b88c,0,14,0,0,3,17
270,1702,2022-10-01 22:32:00,2e2c52c69fee08c530b2ad00d9cfb944,0,11,0,0,0,11
271,1702,2022-10-01 22:36:00,8a35b45b7a57c9ccbc192cf0dfcbf807,0,18,1,0,1,20
272,1702,2022-10-01 22:42:00,ffeba9fc5776e6e4e3cb2795f181d4de,0,16,0,1,0,17
273,1702,2022-10-01 22:47:00,fc1f939f4f9a7275eafc712c216c43f8,0,18,0,0,1,19
274,1702,2022-10-01 22:51:00,1c703f2839d8e003211d27882d2843ab,0,18,0,1,0,19
275,1702,2022-10-01 22:57:00,62450b67eb04fb812df2975553a3f651,0,10,2,0,1,13
276,1702,2022-10-01 23:02:00,82bae6d8f4051ed507d3696afc777385,0,15,0,0,1,16
277,1702,2022-10-01 23:07:00,115d77bcbe4aa2cd85860ab9d28f8b1a,0,17,0,0,0,17
278,1702,2022-10-01 23:12:00,aeec58c239e0b4d5f23c58e68aec3b7e,0,16,0,1,0,17
279,1702,2022-10-01 23:17:00,839c622357d5b3f216fa0ea4ff2f06e6,0,15,3,1,2,21
280,1702,2022-10-01 23:22:00,ef10715c1adb95be6453a4d269da8bd7,0,18,2,0,0,20
281,1702,2022-10-01 23:26:00,4f32c8a1a85d007db2f20acfc6362c01,0,13,2,0,0,15
282,1702,2022-10-01 23:31:00,b757a499c23a7e27cf4276e0a21b0c44,0,8,0,1,0,9
283,1702,2022-10-01 23:37:00,270a978540f6a87ddcfc2e05f98d8276,0,14,0,0,0,14
284,1702,2022-10-01 23:42:00,d014496c68618685c4bf292978b9fdd0,0,8,0,0,0,8
285,1702,2022-10-01 23:46:00,5abb5f6267665ae0b5389d6c5cd41c4f,0,11,1,0,2,14
286,1702,2022-10-01 23:52:00,8357c46075547b750dd79dcb692d971e,0,7,1,0,1,9
287,1702,2022-10-01 23:56:00,46e739dbf06745ce0d2b3fc72e4c7604,0,12,0,0,1,13
288,1702,2022-10-02 00:02:00,678d670440a4e6b6cf0633ce13cdac75,0,17,0,0,0,17
289,1702,2022-10-02 00:08:00,769a0ec1cafa859fbea65ff88aa6ca31,0,11,0,0,3,14
290,1702,2022-10-02 00:11:00,959ac3d183b1316107bbf494bbbca887,0,10,0,0,0,10
291,1702,2022-10-02 00:16:00,bf1853876a36668408271abc1b85a582,0,8,0,0,2,10
292,1702,2022-10-02 00:21:00,6d9cc9004b9df3c505af886db27033a5,1,13,0,0,3,17
293,1702,2022-10-02 00:27:00,6f29a519a460c114b4bb490974285c52,0,7,0,0,1,8
294,1702,2022-10-02 00:31:00,19685a3da9d9ed6921233b47682b243f,0,11,1,0,0,12
295,1702,2022-10-02 00:38:00,5bd1c571a1be8e211b34f421f7332417,0,5,0,1,1,7
296,1702,2022-10-02 00:42:00,b51d0945954b7f1f0f988f8392d1ccbb,0,8,0,0,2,10
297,1702,2022-10-02 00:47:00,86b2435e21ad139f2806ffc0917e61a4,0,7,1,0,0,8
298,1702,2022-10-02 00:52:00,9308941b8e50b36cf0c0c8f32af54260,0,18,0,0,2,20
299,1702,2022-10-02 00:57:00,ec35d6a29bdea8e0abc656ec5ef221e1,0,14,2,0,0,16
300,1702,2022-10-02 01:02:00,05c960f2fe496092ae84b3235651aca3,0,11,0,0,0,11
301,1702,2022-10-02 01:07:00,741fe7af918e854b94700f95e18a19c3,0,8,1,0,1,10
302,1702,2022-10-02 01:11:00,ef36be07e884c7d54c9930fb5103f08a,0,8,0,0,0,8
303,1702,2022-10-02 01:17:00,e7cee1678d58cf9ab73ab8ac0956c3c8,0,8,0,0,1,9
304,1702,2022-10-02 01:22:00,a8bcac40b7bd692c763ee6faaddc422d,0,2,1,0,0,3
305,1702,2022-10-02 01:26:00,e7b14f69111644d815140c6924ecbe03,0,9,0,1,0,10
306,1702,2022-10-02 01:31:00,9d9a737e50196f207a95fafde8ca8e86,0,8,0,0,0,8
307,1702,2022-10-02 01:37:00,cd56428db5ff9e6dac63e5e93a1f7710,0,8,0,0,0,8
308,1702,2022-10-02 01:41:00,17bfaa21f291b2971bb102a7f3ec299f,0,8,1,0,0,9
309,1702,2022-10-02 01:46:00,c5eb4615d1bf50b1fd4d54e17de1f1e4,0,8,0,0,0,8
310,1702,2022-10-02 01:51:00,0c54ff5d82957754d2a423193ae51660,1,14,0,0,0,15
311,1702,2022-10-02 01:56:00,b6505215927de199780f1029e768bef7,0,13,1,0,0,14
312,1702,2022-10-02 02:02:00,962e840032db3dc1aa0e524ab29a1650,0,10,1,0,0,11
313,1702,2022-10-02 02:06:00,bfd723edb67b0db4615a1d72db852976,0,8,2,1,0,11
314,1702,2022-10-02 02:11:00,5cc3623adadec6bdf182a639a9f89415,0,3,0,0,0,3
315,1702,2022-10-02 02:16:00,69215f98e97ffe9bc3cfbf0b46551fe8,0,17,0,0,1,18
316,1702,2022-10-02 02:22:00,15d2c83d591e8e898a77fccf570b2d5a,0,12,0,0,1,13
317,1702,2022-10-02 02:26:00,31f50960e6147199050633bfae3ec573,0,8,1,0,0,9
318,1702,2022-10-02 02:31:00,3a058749de652b05a7f90c82fe7a79ea,0,8,0,1,0,9
319,1702,2022-10-02 02:37:00,a8ce1f8754eea15575c3c01653b42310,0,13,0,0,0,13
320,1702,2022-10-02 02:41:00,700f9b3f6a51c88ea97b2e065d81f8ff,0,7,0,0,0,7
321,1702,2022-10-02 02:47:00,49de31b9d9aab6b54b1b693bc1c07af8,0,17,0,0,1,18
322,1702,2022-10-02 02:51:00,b01a6dddac04cd084ccf0e1bcae666fa,0,6,1,0,1,8
323,1702,2022-10-02 02:56:00,72115572baa3a4d98a3eafd24d79ccdf,0,8,1,0,2,11
324,1702,2022-10-02 03:01:00,3677708b78c318c249a7c77552261e53,0,10,1,0,2,13
325,1702,2022-10-02 03:07:00,e0d7c70cf943988cb51b479773796048,0,6,0,0,0,6
326,1702,2022-10-02 03:11:00,fddc3868c7552689c9873d4cf0213020,0,8,0,0,2,10
327,1702,2022-10-02 03:17:00,597bbe37bc0bcc4607b66d0898b1aa32,0,2,0,0,0,2
328,1702,2022-10-02 03:21:00,83962595b9d4169bce3d35e620b1d43c,0,6,1,0,0,7
329,1702,2022-10-02 03:27:00,26370af7bbe55fff45afae04cacd0396,0,4,0,0,1,5
330,1702,2022-10-02 03:31:00,478c73c331af2175e1bd04ee6c0c359a,0,12,0,0,0,12
331,1702,2022-10-02 03:37:00,1fa134723031f49792a461eee5ca8b26,0,10,0,0,0,10
332,1702,2022-10-02 03:41:00,effe8c2763b3896a83b352545bc4b3f3,0,7,2,0,0,9
333,1702,2022-10-02 03:46:00,701b89fbd8dd9ff0880ddf487cab8169,0,9,0,0,0,9
334,1702,2022-10-02 03:51:00,9fac6ab02f30c12c6d3fd23091ea8dca,0,6,0,0,0,6
335,1702,2022-10-02 03:56:00,61ab7185e5a49b459cba736fd5cc175d,0,3,0,0,1,4
336,1702,2022-10-02 04:01:00,f442bfe083773adbd888dc68ab0788ce,0,9,0,1,0,10
337,1702,2022-10-02 04:07:00,e30c3b143505e801740d1de364cab25f,0,4,2,2,0,8
338,1702,2022-10-02 04:11:00,42fa20271fed9b17f382899e0ecb561e,0,3,1,0,0,4
339,1702,2022-10-02 04:17:00,77eede5218928a41453e0e4726ba4612,0,6,0,0,1,7
340,1702,2022-10-02 04:21:00,7e42588fde615e12d73db887177c3cc5,0,6,0,0,0,6
341,1702,2022-10-02 04:26:00,fb18c5c1b9d41054c144d3abe8f14ede,0,4,0,0,0,4
342,1702,2022-10-02 04:31:00,a29adb1f966d896dd4e8bac57d91349e,0,0,0,0,0,0
343,1702,2022-10-02 04:36:00,4fbe1483308b0a1210406ff61ee0210d,0,1,0,0,0,1
344,1702,2022-10-02 04:41:00,b736490da9084aa6710ba8eb75f7a3b9,0,0,0,0,0,0
345,1702,2022-10-02 04:47:00,b5d318fee0206cebdba1e7b964563c42,0,1,0,0,0,1
346,1702,2022-10-02 04:52:00,1d62c1e26697e72ab4de54ef9027deae,0,0,0,0,0,0
347,1702,2022-10-02 04:56:00,d491add0ca336b655d5430dc561b3c36,0,4,0,0,0,4
348,1702,2022-10-02 05:01:00,c9e5bef56c34242f95ef2f1dab69665f,0,1,0,0,0,1
349,1702,2022-10-02 05:07:00,ac785b8ab516c2b932e8022bc75ea87c,0,0,1,0,0,1
350,1702,2022-10-02 05:11:00,4bb926dc17aacf132cc952679490b202,0,0,0,0,0,0
351,1702,2022-10-02 05:17:00,4a1f93ed1811c9c9b72e9511a4a60a21,0,2,0,0,0,2
352,1702,2022-10-02 05:22:00,8366baf74f59fe5359cc9eacb5d8155c,0,0,0,0,0,0
353,1702,2022-10-02 05:27:00,dfc072122e8e1b5f89696f5bc53b48a0,0,1,0,0,0,1
354,1702,2022-10-02 05:32:00,b8ed5729319bf1e56f001fe13c25fff0,0,0,0,0,0,0
355,1702,2022-10-02 05:38:00,ca9aa303574028796392cca8e22741c7,0,2,0,0,0,2
356,1702,2022-10-02 05:42:00,f23737cec0048085c40bc8baff178658,0,1,0,0,1,2
357,1702,2022-10-02 05:47:00,771ef180cc408c6a445215b3bd622944,0,0,0,0,0,0
358,1702,2022-10-02 05:52:00,97fca6762cc265d588d28158a179c36e,0,1,0,1,0,2
359,1702,2022-10-02 05:57:00,27c08407d4359ea4a507dd485f93a044,0,0,0,0,0,0
360,1702,2022-10-02 06:03:00,c474b687548fa4c04365185fcaf5f6e7,0,0,0,0,0,0
361,1702,2022-10-02 06:08:00,a3370d90f551ea80128afe4f38ea61e1,0,0,0,0,0,0
362,1702,2022-10-02 06:12:00,15812e9d6001eea2b6f03fc0438cf4c5,0,0,0,0,0,0
363,1702,2022-10-02 06:17:00,dea8365d53a703dce7daca666244353a,0,0,1,0,0,1
364,1702,2022-10-02 06:22:00,1faa7e9d9ac24fec08e5a02fbb9f3aaa,0,2,0,0,0,2
365,1702,2022-10-02 06:27:00,636351ddc6ba9fd2b5875571dc6b8f36,0,3,0,0,0,3
366,1702,2022-10-02 06:32:00,ab50e186f038288e3d861c7bf101c3f4,0,1,0,0,0,1
367,1702,2022-10-02 06:38:00,0e181101264ffb9037d2764b2647361b,0,3,0,0,0,3
368,1702,2022-10-02 06:44:00,d9529353b6dd79eebd318d3788b5c1d1,0,1,0,0,0,1
369,1702,2022-10-02 06:47:00,e6d15eba57965ab86eeace4d30e74321,0,3,0,0,0,3
370,1702,2022-10-02 06:52:00,ae0fefd18a0bcc70b1cdaacd602e53d6,0,1,0,0,0,1
371,1702,2022-10-02 06:57:00,98832afafccbba3c2e478d7f93b6d001,0,1,0,0,0,1
372,1702,2022-10-02 07:02:00,52e2b992a2152ebec6f37831df6d14a9,0,1,0,0,0,1
373,1702,2022-10-02 07:07:00,e172ed71bad0f2d36f2da940fe035dc4,0,6,0,1,0,7
374,1702,2022-10-02 07:12:00,2d37e86c39f8966027756fd89aa4ff76,0,3,0,0,0,3
375,1702,2022-10-02 07:17:00,92371694822868b622212f3c43cab219,0,12,0,0,0,12
376,1702,2022-10-02 07:22:00,4429c19c05f413f02d71c46012801fcc,0,4,0,0,0,4
377,1702,2022-10-02 07:28:00,d5d83626c9bcffd48fe129c1d37122f1,0,6,0,0,1,7
378,1702,2022-10-02 07:33:00,a65d731f1d5c072e089a1b14cfaad8b8,0,5,0,1,0,6
379,1702,2022-10-02 07:37:00,756490b6309fe0eadb22852821002333,0,7,0,0,1,8
380,1702,2022-10-02 07:42:00,ae1b599fbd86c099f5599bc7cf71fb36,0,4,0,0,2,6
381,1702,2022-10-02 07:48:00,599fcee546cc70577fdadd6a2102907e,1,9,0,2,2,14
382,1702,2022-10-02 07:53:00,7c7a597acd642cb434a24850cdee0d7c,1,8,1,0,7,17
383,1702,2022-10-02 07:57:00,53a2fe258e82ebc4aad5a2a778ed84e1,1,12,0,1,5,19
384,1702,2022-10-02 08:03:00,2d3e5fbdf5e66abc3f80b5b31457cf89,0,8,1,0,6,15
385,1702,2022-10-02 08:07:00,43756a7545afa0dc6e969ea5e840bf12,1,9,0,0,6,16
386,1702,2022-10-02 08:12:00,be6f47b355b56f90b73abddc073e3fe2,0,14,0,1,6,21
387,1702,2022-10-02 08:17:00,fec3ab1897c1e49a0139dfb56f558b3f,0,12,1,0,2,15
388,1702,2022-10-02 08:22:00,6adc822fb9162956b7d53d1d5d492035,0,12,0,0,4,16
389,1702,2022-10-02 08:28:00,6479dcd5ab29f0dd5adaf78ab8a5c9f3,0,7,0,0,9,16
390,1702,2022-10-02 08:32:00,c6c5df9068e302327f5d07daa5a8a6a8,0,10,0,1,7,18
391,1702,2022-10-02 08:38:00,3f436d0aa9790589af254dc1072436a5,0,14,0,1,10,25
392,1702,2022-10-02 08:42:00,aca259ceb2c5e1db1b5bcfe47ad7a090,0,12,0,1,5,18
393,1702,2022-10-02 08:48:00,f9f25ffbdca5135316b1fced75925506,1,12,0,1,9,23
394,1702,2022-10-02 08:53:00,eb24c7e8beb64d5cf73c5c45a7da5db7,0,11,0,1,7,19
395,1702,2022-10-02 08:57:00,2a899b8bf88db2b0003c855a98b3ca5a,0,6,0,1,10,17
396,1702,2022-10-02 09:03:00,6d382457a384812fc1c26f218f1b9bec,0,18,0,2,3,23
397,1702,2022-10-02 09:08:00,a198c58e40884c0dd669d1eeccba7b72,0,15,0,0,7,22
398,1702,2022-10-02 09:13:00,27831bd1082b61bc4edc13b43006ca61,0,5,0,1,9,15
399,1702,2022-10-02 09:17:00,aa92cc53243340a6029cf7556c1aa757,2,15,1,1,6,25
400,1702,2022-10-02 09:23:00,4404e6887a8f7ca8dec7b2c11a3d42b7,0,12,0,1,9,22
401,1702,2022-10-02 09:29:00,53e6392284e3b564586b6f4270b4845c,0,11,0,1,6,18
402,1702,2022-10-02 09:32:00,80235d0e4642b90395b4d9aa28ebe4f4,1,13,0,1,11,26
403,1702,2022-10-02 09:39:00,4a401fb02c1e091ee655f53d00fd8953,0,9,1,3,4,17
404,1702,2022-10-02 09:44:00,0fe3d0f46f5c3b37f0bc388a6045cc0c,0,12,0,4,13,29
405,1702,2022-10-02 09:47:00,f74c2128691d3653da4ca37670f51b96,1,13,0,3,9,26
406,1702,2022-10-02 09:53:00,e630b76246f4a02e14d8cf9c6c655ed2,0,14,0,1,8,23
407,1702,2022-10-02 09:57:00,2314d18614b14bc0bb2d4e2f00d4a055,0,17,0,1,7,25
408,1702,2022-10-02 10:04:00,d13c4786299c893b714429c4c05ef13e,0,18,0,0,10,28
409,1702,2022-10-02 10:09:00,41f58fb2c99527770ce91609d3bca242,1,13,0,2,9,25
410,1702,2022-10-02 10:13:00,0af30c8b782cd5ffb822b3632bae0511,1,8,0,5,8,22
411,1702,2022-10-02 10:18:00,5334ef62929ce2e8cf5b994ca0717b1e,0,13,0,0,11,24
412,1702,2022-10-02 10:23:00,1cd77cf43ab95f7d3db5fef0cd921581,0,13,0,1,6,20
413,1702,2022-10-02 10:28:00,fed3eda8f3a96ea136ba5583890cf6da,0,13,0,3,9,25
414,1702,2022-10-02 10:34:00,57770742b4c840c8ce9aae1c424ed211,0,11,0,1,9,21
415,1702,2022-10-02 10:38:00,1dd1e70ae9251adb517425487dcc2198,3,17,0,0,9,29
416,1702,2022-10-02 10:43:00,149da8ee749191d179149e5a9e444e8b,0,16,0,2,3,21
417,1702,2022-10-02 10:49:00,2c73d56fcd73ec4a1cec6856bf27dd41,1,17,0,1,14,33
418,1702,2022-10-02 10:53:00,1a73c354d382de1ce166b6de38e421d8,0,8,0,2,9,19
419,1702,2022-10-02 10:58:00,e06faedf0ebcc134244afeac31683c75,0,11,0,2,8,21
420,1702,2022-10-02 11:03:00,d1ef21d6ba0a0b2133e76499b0881f92,0,10,0,3,7,20
421,1702,2022-10-02 11:09:00,52f41e79efb34c5c6af57ec83a039208,3,22,0,3,4,32
422,1702,2022-10-02 11:14:00,3d0c9ab66e73b3e59318e145af74d751,1,13,0,2,8,24
423,1702,2022-10-02 11:24:00,d2df1e5134ea13ec14ace9c536e00dd3,0,16,0,1,8,25
424,1702,2022-10-02 11:27:00,f93b5c04143d4b20b2cdb3c51279a81e,0,12,0,3,12,27
425,1702,2022-10-02 11:34:00,1c7a743fb36e915e8ffc6ef686371534,0,11,0,2,8,21
426,1702,2022-10-02 11:38:00,5cbaa07746b75624cb069dad418fd0fb,2,15,0,3,10,30
427,1702,2022-10-02 11:42:00,ed8bd4a9aca3831b1c117047cb8cb2e5,0,21,2,1,3,27
428,1702,2022-10-02 11:48:00,36a880e6d91abff7e50ef82a74dbe1c9,0,17,1,1,3,22
429,1702,2022-10-02 11:53:00,42adf8c5af5422ebfbd8562050b88eaf,1,12,1,0,12,26
430,1702,2022-10-02 11:59:00,9a991be2d2b208c05da9b55132d8d770,1,18,0,2,7,28
431,1702,2022-10-02 12:04:00,9a31da0bf866e74ead96df5e28f91791,0,16,1,1,5,23
432,1702,2022-10-02 12:07:00,a09b4ae472c05da528ab4a5bdca1345b,0,16,0,2,14,32
433,1702,2022-10-02 12:12:00,75e33f0904318f77657d93a33bf74b1e,0,12,0,2,8,22
434,1702,2022-10-02 12:17:00,38320315b83fef01b39822da89f61d78,0,10,0,2,12,24
435,1702,2022-10-02 12:22:00,27fc03f16310b1c0a589cf52bfa86322,3,7,0,4,9,23
436,1702,2022-10-02 12:29:00,09240cc461f246d366c6ce35e20c50a6,0,11,0,2,6,19
437,1702,2022-10-02 12:32:00,c9503727d59a2a0bd5dba6a32a5cfdd5,0,22,0,5,4,31
438,1702,2022-10-02 12:38:00,217688b36403d8a87a041073391bca56,0,20,0,1,4,25
439,1702,2022-10-02 12:43:00,a16f2d6841845d9e909b20fffc1964fa,0,14,0,3,9,26
440,1702,2022-10-02 12:49:00,33cbb6eaacd4d0773ed3e68d1428464f,0,13,0,6,8,27
441,1702,2022-10-02 12:52:00,801128c6fd209a1470649d5cbf8e608a,0,17,0,3,5,25
442,1702,2022-10-02 12:59:00,bc43ab16bdf2c3fd854652e271bff532,0,13,0,3,10,26
443,1702,2022-10-02 13:03:00,e21aa3121021534c9518c0aa926db0b7,0,15,0,1,6,22
444,1702,2022-10-02 13:08:00,120eefc34ae22907fc71bbc6aa62a509,0,14,0,1,7,22
445,1702,2022-10-02 13:13:00,cbbcf3467cbbdf0485b31a9d0ac40c3a,0,12,0,1,9,22
446,1702,2022-10-02 13:18:00,e4ee57c90ebd035b7972fe97f48c8e75,0,15,0,4,6,25
447,1702,2022-10-02 13:23:00,fec6f5fbdd80b3b1ca014c707bf8d96a,0,17,1,1,12,31
448,1702,2022-10-02 13:27:00,1e8a2d2cd97c3d369394786ef000bbb8,0,11,0,4,10,25
449,1702,2022-10-02 13:32:00,18f8814f612a3f7481e55c9500f8b976,0,12,1,1,9,23
450,1702,2022-10-02 13:37:00,61dee1edd00e715a8f6179720f10020a,0,15,0,2,6,23
451,1702,2022-10-02 13:43:00,954bb050f35eeaf23743216ff013ab5d,0,17,0,3,4,24
452,1702,2022-10-02 13:47:00,5ffa84eb7e26f9248b131450b30985e9,0,20,0,8,1,29
453,1702,2022-10-02 13:54:00,fe1b42e2d127a6131d457e10f6153bd1,0,26,0,3,6,35
454,1702,2022-10-02 13:57:00,6dbcf883480bcdacf337fbf20798741f,0,30,1,3,3,37
455,1702,2022-10-02 14:03:00,c34363f461debf4ea169d14c208713d7,0,21,1,4,4,30
456,1702,2022-10-02 14:08:00,b3b34744b8261fe885e3b9897776a0e8,1,15,0,2,10,28
457,1702,2022-10-02 14:12:00,b8703d353da0cbc9c2648b82ae2ab5f8,0,21,0,1,4,26
458,1702,2022-10-02 14:19:00,4038afe840328344a028a16b8cd71614,0,15,0,1,5,21
459,1702,2022-10-02 14:22:00,ad1a8183683fa2f208c231c68c7950d4,0,14,0,2,8,24
460,1702,2022-10-02 14:28:00,cd7581337fc16b585c677b0c9607f485,0,21,0,0,10,31
461,1702,2022-10-02 14:32:00,64b4c54abd190443c4a2aa099184b0c5,0,23,1,4,6,34
462,1702,2022-10-02 14:38:00,6bca267576b93b0f7cd8b63ea82aeb49,0,15,1,2,6,24
463,1702,2022-10-02 14:43:00,15f215c872ee96641ae64b27dd08a68a,0,18,0,0,7,25
464,1702,2022-10-02 14:47:00,14816f698e8eaeda59282b33449f3e49,0,19,0,5,3,27
465,1702,2022-10-02 14:53:00,979847f32df2851a9ba06896bb639cf3,0,23,0,2,8,33
466,1702,2022-10-02 14:57:00,2dd46ac90b24d20ab96f6d49cde3d8a0,0,14,1,1,12,28
467,1702,2022-10-02 15:02:00,bc914cb48a953d650d7e86782df90dbf,0,16,0,2,8,26
468,1702,2022-10-02 15:08:00,9c3237cae4ec543a4bf6c4c6b655d02a,1,17,1,3,8,30
469,1702,2022-10-02 15:14:00,f2ac6a339a65748302097e3a975038d4,0,23,1,2,1,27
470,1702,2022-10-02 15:19:00,940029852dd4001c32be344194d32c36,0,13,0,6,6,25
471,1702,2022-10-02 15:23:00,34ce04696ee8e4dd493545f4e7592238,0,16,0,3,5,24
472,1702,2022-10-02 15:28:00,9b5aa41e2945510cb09d0af385b5c28e,0,11,0,1,8,20
473,1702,2022-10-02 15:33:00,85959364379862ec8d9cc77ee43a8f54,0,19,0,0,10,29
474,1702,2022-10-02 15:39:00,ea32f4b3cc1dcaa259be79971a9538e4,0,14,0,1,4,19
475,1702,2022-10-02 15:43:00,9777a5e5a09d63a6d90c473e7cc3193d,0,14,1,2,8,25
476,1702,2022-10-02 15:48:00,a5feb7c09c23a8b8043a1bb8e9619ad3,1,8,0,0,8,17
477,1702,2022-10-02 15:53:00,1d98e9456e4dc0d7cec52c703b75046c,0,14,0,1,8,23
478,1702,2022-10-02 15:58:00,50fcdf074cbbd824faf5dfde0a868b36,2,10,0,2,10,24
479,1702,2022-10-02 16:02:00,0d14d8ebd8c44ca944c71552104ec370,0,10,0,3,10,23
480,1702,2022-10-02 16:08:00,7e334060fcfe281aeb892c0d6c4ba464,0,21,0,5,8,34
481,1702,2022-10-02 16:13:00,10b75ea7f46ef85f922ee8338d8a013a,0,13,0,2,10,25
482,1702,2022-10-02 16:18:00,a4d7ba734fb27bb4ceb84fae93690500,0,17,0,1,10,28
483,1702,2022-10-02 16:24:00,bc335586ef91e46be9d46c697bbc93f4,0,16,1,1,4,22
484,1702,2022-10-02 16:29:00,fd74839622b581b31c82ae2fbebda20e,1,18,0,1,5,25
485,1702,2022-10-02 16:32:00,111052e2d509d10bb185683d3dfd5c21,2,14,0,5,9,30
486,1702,2022-10-02 16:38:00,f0c54e962daf1e366bc4ea6d53a5ae57,0,15,0,0,11,26
487,1702,2022-10-02 16:41:00,d4033fa0090a9ca88a3458046d74e226,0,15,0,0,13,28
488,1702,2022-10-02 16:47:00,f215de6136dab633bcfed6f590acc8d5,0,21,1,3,2,27
489,1702,2022-10-02 16:53:00,4a36b708cd6abcfb8ab0fbe7b9216df8,0,17,0,3,8,28
490,1702,2022-10-02 16:58:00,312f974c49ac1b23c9130e3b3ebd6698,1,23,0,0,5,29
491,1702,2022-10-02 17:03:00,6a675f30d08d495bbb977e4acb4d1f08,0,22,0,0,7,29
492,1702,2022-10-02 17:08:00,6d3dc2cd714281190b99dde7a713b6d2,0,13,0,2,5,20
493,1702,2022-10-02 17:13:00,b12c1150937d063b44443565594ef95b,0,13,0,0,5,18
494,1702,2022-10-02 17:17:00,ba2e75cc68fd865822e8c02e69a6ed96,0,14,0,1,12,27
495,1702,2022-10-02 17:22:00,b3c02ae3805998e55be5fe2b0bca2072,0,17,0,4,8,29
496,1702,2022-10-02 17:27:00,56feda3e9484e36e55986d062521001a,0,17,0,0,9,26
497,1702,2022-10-02 17:32:00,2c27fbfad2599ded7610f41ad510ab5c,0,14,0,0,15,29
498,1702,2022-10-02 17:39:00,214b361d312568a7bde246c857390a0f,0,11,0,2,13,26
499,1702,2022-10-02 17:43:00,156e742fa991023cf3fbefa52b3e4aca,0,19,0,1,7,27
500,1702,2022-10-02 17:48:00,ce9d99b0f614c2e960b80bbe7f1d23db,0,11,0,2,9,22
501,1702,2022-10-02 17:54:00,cdf003b40e754c819fa6446b82a76486,2,18,0,2,5,27
502,1702,2022-10-02 17:57:00,a112aea74c976c11d85c695c7eaeb112,0,18,0,0,9,27
503,1702,2022-10-02 18:03:00,a8f5a02b6709543ccaa5c469b36e22d8,0,22,0,0,1,23
504,1702,2022-10-02 18:08:00,b1ed3505815779ddb482a2ea1b25880b,0,17,0,0,2,19
505,1702,2022-10-02 18:12:00,08032fc92431e8754bf4ecb854d48d15,0,10,0,0,6,16
506,1702,2022-10-02 18:17:00,13c9bcb81005320503b3a6d74d77fb85,1,15,0,0,7,23
507,1702,2022-10-02 18:22:00,641efcabefe614af25ab37ba4d1ae793,0,25,0,1,6,32
508,1702,2022-10-02 18:27:00,718dffc1af2b604a3f003a838b0ab7ef,0,20,0,1,5,26
509,1702,2022-10-02 18:32:00,76ac4c7288f6c9d78a1bcd558ac12f96,0,14,1,0,6,21
510,1702,2022-10-02 18:37:00,af4aa55dd631aa39d1978de25477796c,0,15,0,0,0,15
511,1702,2022-10-02 18:42:00,8cd9b816708e9a28fbb5dc3f47a9d54e,0,13,0,0,0,13
512,1702,2022-10-02 18:47:00,97420d85546b66a457d0d7577190d754,0,8,0,0,0,8
513,1702,2022-10-02 18:53:00,a52e16a252d03aab31d2fc07052fa008,0,15,0,1,0,16
514,1702,2022-10-02 18:59:00,f3b84a532facdccfa4b7a58042c44ce2,0,14,0,0,1,15
515,1702,2022-10-02 19:02:00,36e8e6b4aa53ca957503ab63e3b564ed,0,15,1,0,1,17
516,1702,2022-10-02 19:07:00,c73fcce45597b323ecde1fc1301277bd,0,23,0,0,1,24
517,1702,2022-10-02 19:12:00,211edad6a4c23de8b183205c39092abf,0,17,0,0,0,17
518,1702,2022-10-02 19:18:00,be479e9188ddbf5d07be74025b20bef4,0,9,0,0,0,9
519,1702,2022-10-02 19:22:00,6581982412d8f9458f6e52fb6fb637f6,0,18,0,0,0,18
520,1702,2022-10-02 19:27:00,44afd98b6fba9d0ed44febadc0ecf3f7,0,18,0,0,0,18
521,1702,2022-10-02 19:34:00,10e233971cb0ce35b2b01f70652faa5c,0,20,0,0,2,22
522,1702,2022-10-02 19:38:00,d49358ffb3f3b784754026de34d85598,0,10,0,1,0,11
523,1702,2022-10-02 19:42:00,fe60ce4fee5f85a59385084eb280f264,0,16,0,0,0,16
524,1702,2022-10-02 19:47:00,bac7060e7dd5ec6bfd5e44c7eaac2ddd,0,20,2,0,0,22
525,1702,2022-10-02 19:52:00,9470ec42ee507450bdd786c8b83d2c36,0,13,1,1,0,15
526,1702,2022-10-02 19:57:00,0fc1a3128509932b81c1aafb9b480d8c,0,14,0,0,0,14
527,1702,2022-10-02 20:02:00,5cc14db63b2b1b8dc4b14983a480cd05,0,16,2,0,0,18
528,1702,2022-10-02 20:07:00,92e09de764cd5623b3d0f28e94e906c0,0,21,2,1,0,24
529,1702,2022-10-02 20:11:00,46290c269eb279dc0d13f8e79b1ff8bc,0,19,0,0,1,20
530,1702,2022-10-02 20:16:00,03233f4e7b0c3f85c00c714973beb48b,1,17,0,1,1,20
531,1702,2022-10-02 20:23:00,178fb251ff23e9686e6a81b613d946f1,0,24,0,1,0,25
532,1702,2022-10-02 20:27:00,eba1d4a2a9d1990cbeda89627f54b39c,0,18,2,0,1,21
533,1702,2022-10-02 20:32:00,e9d4308c15127a41a33819dac63e650a,0,16,0,0,1,17
534,1702,2022-10-02 20:37:00,e172f0b5287126baa04e3ea5c7dd9e32,0,13,1,1,0,15
535,1702,2022-10-02 20:43:00,17dbdd738a52fe68e174531509191b82,0,10,0,0,0,10
536,1702,2022-10-02 20:47:00,23d2b53e4bbbc19905362effbed443d4,0,17,1,0,1,19
537,1702,2022-10-02 20:52:00,b0430175ee064c9a4ceb5cfaa66bc8a0,0,15,0,0,0,15
538,1702,2022-10-02 20:57:00,e1d3e82cce1d40f01f8becf7a36fd531,0,19,3,0,2,24
539,1702,2022-10-02 21:03:00,7b6bf58e4b8206d3b48c3a976ac528de,0,15,2,0,0,17
540,1702,2022-10-02 21:07:00,07451e34b6e22017c449f8693a1c44c1,0,14,1,0,2,17
541,1702,2022-10-02 21:13:00,9aaf08acd3f398a51914c947c512b2c1,0,14,1,0,2,17
542,1702,2022-10-02 21:17:00,f2004577c6a71c717db0dab9f2493860,0,21,1,0,0,22
543,1702,2022-10-02 21:21:00,dc2c31eaa2ac5a8cf022065de7489e84,0,25,0,0,0,25
544,1702,2022-10-02 21:28:00,443bb238a4763182fe5d804369ddd225,0,17,0,0,1,18
545,1702,2022-10-02 21:33:00,c494c45288800437c05fbc60de878faa,0,16,0,1,1,18
546,1702,2022-10-02 21:37:00,752c75981546d95d7db2e5793e4c5a4f,0,16,0,0,1,17
547,1702,2022-10-02 21:41:00,f5b9d0c3097ce63c178750b5dfafa7ee,0,11,0,0,0,11
548,1702,2022-10-02 21:47:00,10ad5764309b21d8c4963a32f433a26c,0,16,1,0,0,17
549,1702,2022-10-02 21:52:00,4a535af6c23b38fad8ac604e6b783674,0,17,0,0,0,17
550,1702,2022-10-02 21:57:00,875a87eeaaf8f6da8c6e629678a9b7b5,0,14,0,0,0,14
551,1702,2022-10-02 22:02:00,cbb9cf09494c003dc8dc77df8d18baeb,0,7,0,0,2,9
552,1702,2022-10-02 22:07:00,445c40fe71e472f3bf1bcff3487beeb2,0,15,0,0,0,15
553,1702,2022-10-02 22:12:00,111ce6d86d62080018f2e82270f21a7d,0,7,0,0,0,7
554,1702,2022-10-02 22:17:00,802b6a9ff1f74fd9d041975acec535f2,0,15,0,0,0,15
555,1702,2022-10-02 22:22:00,674c725c6dc10566da596d06cd7cc7e4,0,18,1,0,1,20
556,1702,2022-10-02 22:27:00,81aab116b43b9983fdb8efa79b70f299,0,18,0,1,1,20
557,1702,2022-10-02 22:32:00,129e79e9d4d0926f2281825dcc1da679,0,9,0,0,0,9
558,1702,2022-10-02 22:37:00,9c8e92866c10778abad5267512ecfb8a,0,6,0,0,2,8
559,1702,2022-10-02 22:42:00,c78591652df477870576a71e1f17feba,0,13,0,0,0,13
560,1702,2022-10-02 22:47:00,55e1b778a1614c8b3e830c57548dead0,0,3,1,0,2,6
561,1702,2022-10-02 22:53:00,7d075ca6843e7349ec578bd688042a03,0,10,0,0,1,11
562,1702,2022-10-02 22:57:00,e7434294f9df2d628f3c0d83e67e1123,0,7,1,0,0,8
563,1702,2022-10-02 23:03:00,4837ebb02f28a0ad6aba66714955cb7c,1,7,0,0,0,8
564,1702,2022-10-02 23:07:00,9c4cfdae658208eeac84d6ad9c7aacd7,0,6,3,0,3,12
565,1702,2022-10-02 23:12:00,f0c88326ba978d1ca1e27c61fdc813b1,0,14,0,0,0,14
566,1702,2022-10-02 23:17:00,03196b546d6ba9c2ec5432e0b7539238,0,8,0,0,0,8
567,1702,2022-10-02 23:21:00,48e0f90099f055a74d37d3f663acb61d,0,6,0,1,0,7
568,1702,2022-10-02 23:27:00,6ab72945d9fca75c66ab7b9c3d358dff,0,12,1,0,0,13
569,1702,2022-10-02 23:32:00,4f2b1ba5650192231d567db10662817d,0,8,0,0,1,9
570,1702,2022-10-02 23:38:00,6b864990967ef07ecc3d95e77fb66bb7,0,10,1,0,0,11
571,1702,2022-10-02 23:42:00,2ee43648ba6488ca789d9e9ba987bc43,0,11,1,0,3,15
572,1702,2022-10-02 23:46:00,fb3aeef0a6ba794fca6c7ca1548070e5,0,7,0,0,0,7
573,1702,2022-10-02 23:52:00,a9e0212af9f41574ae144fdb812470a3,0,11,0,0,0,11
574,1702,2022-10-02 23:58:00,10b2fedc9501101e67b1dc79a87c4af9,0,14,0,0,0,14
575,1702,2022-10-03 00:03:00,9b46deb15a47dd405ef89108764c208f,0,16,0,0,0,16
576,1702,2022-10-03 00:08:00,2ea49b21bbe9f60e4fa2954617a12d41,0,5,1,0,1,7
577,1702,2022-10-03 00:12:00,f942d7057b15128805cc0511e376576c,0,8,0,0,1,9
578,1702,2022-10-03 00:18:00,9dec57461e5c8042376a182f897dedd1,0,7,0,1,1,9
579,1702,2022-10-03 00:22:00,6f2e973781cbdb79fa1cab324c9292d8,0,10,0,0,0,10
580,1702,2022-10-03 00:28:00,e0e8da5a1da37635946cd2e7b28893f7,0,9,0,1,1,11
581,1702,2022-10-03 00:32:00,ec080fc47488459f1658666f062e3742,0,4,0,0,0,4
582,1702,2022-10-03 00:37:00,b7e0e566755446984457aea1739b6483,0,10,0,0,1,11
583,1702,2022-10-03 00:42:00,d4db4b7db67d020d38c3704e279ef8b5,0,16,0,0,1,17
584,1702,2022-10-03 00:48:00,477bd9308af8479d4648284073e161b1,0,8,1,0,0,9
585,1702,2022-10-03 00:53:00,451e00fe28cddf6e673cd57c602629a8,0,7,1,1,0,9
586,1702,2022-10-03 00:56:00,c701f8a6373388078e2059e1bd77f497,0,5,2,0,1,8
587,1702,2022-10-03 01:02:00,81b39a7b1443092070a0d23a23d93e2b,0,8,0,0,0,8
588,1702,2022-10-03 01:08:00,d4854b3810ba28323ab2208b7afaa4ab,0,6,0,0,0,6
589,1702,2022-10-03 01:12:00,1a19e87b3ca585320c055a88972f3c63,0,7,0,0,0,7
590,1702,2022-10-03 01:18:00,6935ef2e625617720311a7868868498b,0,12,0,1,0,13
591,1702,2022-10-03 01:22:00,06cf7baaabf8882bf8f5322c68bb55b6,0,9,0,0,0,9
592,1702,2022-10-03 01:27:00,bba594388f7d309490d57f94d8c056d2,0,10,0,0,0,10
593,1702,2022-10-03 01:32:00,fd13d8d31566451c758de222f076fab3,0,8,0,0,1,9
594,1702,2022-10-03 01:37:00,36c8ed49f7a04ac0e8d9ff3adbf8e0af,0,6,0,0,0,6
595,1702,2022-10-03 01:41:00,704173e34cdf65d3abac853e557a360e,0,7,0,0,0,7
596,1702,2022-10-03 01:48:00,7e02d068c5b133f0ab86dddd5b9623d7,0,12,0,0,0,12
597,1702,2022-10-03 01:52:00,137f29f07043fed4089a580ed4fb4674,0,0,0,0,2,2
598,1702,2022-10-03 01:56:00,19962916970641fdab6e85b373628d46,0,7,0,0,1,8
599,1702,2022-10-03 02:02:00,043c4a71167098401e36a46752dba9d5,0,7,1,0,1,9
600,1702,2022-10-03 02:06:00,fb6480283b80bef65d3030183ee8c1bd,0,12,0,0,1,13
601,1702,2022-10-03 02:11:00,f575a89334666c49c472235a207d1fec,0,3,1,0,0,4
602,1702,2022-10-03 02:17:00,c65226d1f0167280ca18f17282a673d2,0,7,0,0,1,8
603,1702,2022-10-03 02:22:00,9603843bf6d1c164ea71c09588fe8c18,0,9,0,0,0,9
604,1702,2022-10-03 02:26:00,df5eeeb9bf6ce4aab899d23c6667078a,0,7,0,0,0,7
605,1702,2022-10-03 02:33:00,e8735ab397355de16660d51dbed1f006,0,7,0,0,1,8
606,1702,2022-10-03 02:37:00,ebc9eae0b1706df1d7c95c58e69244fb,0,7,0,0,0,7
607,1702,2022-10-03 02:42:00,1e5d7a7e38f5227b2977e87ed1b405fc,0,4,0,0,0,4
608,1702,2022-10-03 02:47:00,1ad7065ef234188d3cfb907f94742c42,0,7,0,0,0,7
609,1702,2022-10-03 02:52:00,4ae7463c9d91c3929a2f296c91df9eb8,0,9,0,0,0,9
610,1702,2022-10-03 02:57:00,b0464982e625f7aec04aef0af27e424c,0,7,0,0,0,7
611,1702,2022-10-03 03:02:00,4eb16557af3111681340af2c494972ae,0,2,0,0,0,2
612,1702,2022-10-03 03:07:00,f8ee405e9767537ebf2168d352d85e70,0,5,0,0,0,5
613,1702,2022-10-03 03:11:00,a706558047389a557c66f021e490879a,0,6,0,0,0,6
614,1702,2022-10-03 03:17:00,034e14a4d6f3cd7545076657bcadfab2,0,5,1,0,0,6
615,1702,2022-10-03 03:21:00,6f076a91066acfb530ef058d631fe975,0,8,1,0,0,9
616,1702,2022-10-03 03:26:00,c2c602f2cac256b325144060cd36808d,0,3,0,0,1,4
617,1702,2022-10-03 03:32:00,d2d7ca3d3a0de934312114e36736b89a,0,2,0,0,1,3
618,1702,2022-10-03 03:36:00,c7f18f8a654e39e59662edeed55b42e7,0,3,0,0,1,4
619,1702,2022-10-03 03:41:00,5c7f70c7c84648a215e9d628ea62f861,0,2,0,0,0,2
620,1702,2022-10-03 03:47:00,eb98c4709205e8a755cd199849534e32,0,5,0,0,0,5
621,1702,2022-10-03 03:51:00,24ec4e74f399771bb5ce0a20f7774fc4,0,1,0,0,0,1
622,1702,2022-10-03 03:56:00,2278754601be7a7ce535ad3f815625e2,0,5,0,0,0,5
623,1702,2022-10-03 04:02:00,21f73aebffc1afd78d198d91df814c83,0,2,0,0,0,2
624,1702,2022-10-03 04:06:00,d0aa0b2547e94313108d659af9140bb9,0,5,0,0,0,5
625,1702,2022-10-03 04:12:00,6cd81d2352a08f948728866df792c0c1,0,5,0,0,0,5
626,1702,2022-10-03 04:18:00,f3e5914080ad29c08898cc7983dcb7f4,0,4,0,0,0,4
627,1702,2022-10-03 04:21:00,00c57a9ce25fa93fe0a23d54eb9b9616,0,3,0,0,0,3
628,1702,2022-10-03 04:26:00,f57375d960ef7caf74ab4f5d00be57d7,0,2,0,0,0,2
629,1702,2022-10-03 04:32:00,f3863161986556937dc895b54ba584fe,0,3,0,0,0,3
630,1702,2022-10-03 04:37:00,017e4f07e806de88bce5ef7baa358e0e,0,3,0,0,0,3
631,1702,2022-10-03 04:41:00,20beee4bfb34686e6c4edc9a65a77666,0,3,0,0,0,3
632,1702,2022-10-03 04:47:00,8dc81b77115775519c7764926b0716cf,0,2,0,0,0,2
633,1702,2022-10-03 04:51:00,f96b6123b3b4ed633c74a58184cbce6a,0,7,0,0,0,7
634,1702,2022-10-03 04:56:00,0cdd9053e2f71a6082237c1d446f4cf1,0,7,1,1,1,10
635,1702,2022-10-03 05:03:00,a6f15003d6e649c8e77f67b7022f65af,0,7,0,0,1,8
636,1702,2022-10-03 05:07:00,dbe3e2f92df60d19d70d633fc22837f8,0,2,0,0,0,2
637,1702,2022-10-03 05:11:00,ca31f9051ad978f1a32392e2a7d96953,0,5,0,0,0,5
638,1702,2022-10-03 05:17:00,be407318f11b5e5f13b2b432239c562d,0,4,0,1,0,5
639,1702,2022-10-03 05:22:00,3b095f1f550a103b09f16bd912c9f879,0,8,0,0,1,9
640,1702,2022-10-03 05:26:00,914d8ad09a1df991bd2ebef5f3e8c8cc,0,2,0,0,1,3
641,1702,2022-10-03 05:32:00,93f7e2165e49342430b1b555a0a36c1c,0,9,0,0,0,9
642,1702,2022-10-03 05:37:00,3e3996b0e1da2d4567c1d6669629d6cd,0,5,0,2,0,7
643,1702,2022-10-03 05:43:00,2b098401c64d0b33128e1465bc0d1820,0,1,0,1,0,2
644,1702,2022-10-03 05:47:00,01af9573c3f265759f4075c6c5915aed,0,6,1,0,0,7
645,1702,2022-10-03 05:51:00,433be08c9b943ce2a86cd484e3603058,0,2,0,4,0,6
646,1702,2022-10-03 05:56:00,f9c8f6b58777f3b250d07db2f9119851,0,2,0,0,0,2
647,1702,2022-10-03 06:03:00,bdb9baf68c52d37001bbb848900beab0,0,0,1,0,0,1
648,1702,2022-10-03 06:08:00,6c520465ebe151f0623d694250608e07,0,1,0,0,0,1
649,1702,2022-10-03 06:11:00,c98b8a75f9a2f6f90ae1ec804f547dd6,0,9,0,2,0,11
650,1702,2022-10-03 06:17:00,9064d51383be38a366b9800ff289ac31,0,9,0,0,0,9
651,1702,2022-10-03 06:22:00,df9876eb4e2aabf49ed5860d570a88ad,0,3,1,1,0,5
652,1702,2022-10-03 06:27:00,c3bceb615ce24319992c9573210bb728,0,8,0,0,0,8
653,1702,2022-10-03 06:33:00,d399b68833f61ccbab1c9e6e420067f6,0,13,1,2,0,16
654,1702,2022-10-03 06:36:00,87143adced13c2920e719ccfb6448f85,0,10,3,0,0,13
655,1702,2022-10-03 06:42:00,0cae2cad52693bfb27b196b00790c058,0,11,2,2,1,16
656,1702,2022-10-03 06:48:00,6c52d5658be0f06fbcbdc56f00b6ed18,0,14,2,1,4,21
657,1702,2022-10-03 06:51:00,3cfd80eaaa7ba52b824e86e1976ac742,0,16,0,0,4,20
658,1702,2022-10-03 06:58:00,144f2d93c1a8de2c49baa44c7f25b954,0,11,1,3,8,23
659,1702,2022-10-03 07:02:00,ed48e2ad07ccf47c4a75eaded65b6013,0,19,2,0,6,27
660,1702,2022-10-03 07:07:00,65f1bc4c00aff30d0fe23c02bdbc31d3,0,24,1,1,2,28
661,1702,2022-10-03 07:12:00,2f1277948705f9c34e531e80f30010ed,0,14,0,1,18,33
662,1702,2022-10-03 07:18:00,3d9022d42caac33af56dbbff82105097,0,19,0,0,4,23
663,1702,2022-10-03 07:24:00,d146905e42cc3b7625c1ae5e89609c64,0,19,0,4,6,29
664,1702,2022-10-03 07:27:00,33378c0d236efe2b3d119b9705f5f4b6,0,15,0,1,5,21
665,1702,2022-10-03 07:32:00,07cedd7f9fd02095417f9fcac387aa09,0,12,1,1,15,29
666,1702,2022-10-03 07:37:00,64f3cbf93ed0738d8c4ad8af0e792e2c,1,16,0,0,9,26
667,1702,2022-10-03 07:42:00,1c437e1dab4014b8ca6c1b0f65765320,1,9,0,0,15,25
668,1702,2022-10-03 07:47:00,34f600a705ec487bc0c22ccc958f5e9e,0,8,0,2,7,17
669,1702,2022-10-03 07:54:00,a7a59c72472f8c7ebfb4fca029829f97,0,21,0,0,4,25
670,1702,2022-10-03 07:58:00,6e2f37123adeb95caf5391ef19e42d1e,0,12,0,1,9,22
671,1702,2022-10-03 08:03:00,71f625aee2c73abe88e5fad2b21fd16c,0,10,0,0,9,19
672,1702,2022-10-03 08:09:00,9e9dd25f0ab9fda699908688b2d83f92,0,15,0,4,5,24
673,1702,2022-10-03 08:11:00,d46917f754ec887db633a68c95398a81,0,11,0,2,5,18
674,1702,2022-10-03 08:18:00,9198946bae9117629027952b695b3940,1,12,0,0,10,23
675,1702,2022-10-03 08:24:00,10aad7d2a0549bd8c11a34bbd8c67dc2,1,12,0,3,12,28
676,1702,2022-10-03 08:28:00,55e667a5405ba9a53538e954ab270ba3,2,13,0,3,1,19
677,1702,2022-10-03 08:34:00,60c549fa0cb3c98aea452944e9a6c9bc,0,10,0,0,1,11
678,1702,2022-10-03 08:37:00,ed696a7a5b07f827ab8b6d1051ba0549,0,16,0,1,5,22
679,1702,2022-10-03 08:43:00,1f1bed75da66a8049d061670d244908f,0,22,0,1,5,28
680,1702,2022-10-03 08:49:00,dcf705156c42eff96bdc6a724848a728,0,12,0,3,7,22
681,1702,2022-10-03 08:53:00,a5393f5c993303abb31a3be34a2013a0,0,11,0,3,5,19
682,1702,2022-10-03 08:58:00,9ee819fa09bcb0ca7eefb963d650afd1,0,21,0,1,4,26
683,1702,2022-10-03 09:03:00,b2f669a42605bb8aeb6062d79a9492c9,0,6,0,3,10,19
684,1702,2022-10-03 09:08:00,8407bb31a3f680a35db8cd6148f7f446,0,13,0,3,6,22
685,1702,2022-10-03 09:13:00,2bb79653db1f44942d69e0b5fdb5ac51,0,14,1,0,7,22
686,1702,2022-10-03 09:17:00,79c29c723fb0cf11f8a2d2ca443a1074,0,18,3,1,6,28
687,1702,2022-10-03 09:23:00,d527f6dbeafda04e91acbfbf6a1a0fa9,0,16,0,1,10,27
688,1702,2022-10-03 09:27:00,3240e4fc5eff95664689a7517dd62631,0,10,1,0,8,19
689,1702,2022-10-03 09:33:00,17b5b5bfb9b43bf6308eefb9ef46e6fc,0,13,0,0,5,18
690,1702,2022-10-03 09:39:00,158682933bff0cc7fd797f81d1331663,0,7,0,0,13,20
691,1702,2022-10-03 09:42:00,47c6a5234a6611beffa1b77250abab39,0,13,0,0,8,21
692,1702,2022-10-03 09:48:00,90e81702e468065d786c15514c93ffd8,0,11,0,0,8,19
693,1702,2022-10-03 09:53:00,9653da6d798d547f5ca6128c4d956cfd,0,14,0,4,6,24
694,1702,2022-10-03 09:58:00,a60b88f98f25b01b14f5b424d1a2278a,0,6,0,1,9,16
695,1702,2022-10-03 10:02:00,673d770dd39e2887e8a76052c41ec842,0,12,0,1,7,20
696,1702,2022-10-03 10:08:00,61376560e45e0b8fa6a4817ecff9c0a8,0,20,0,1,8,29
697,1702,2022-10-03 10:14:00,b1fbd6cc5bfd7d46f4667019ad329eef,1,18,0,4,6,29
698,1702,2022-10-03 10:18:00,089896319fab51756226b600598af1a4,1,12,1,1,7,22
699,1702,2022-10-03 10:23:00,33bad862ac53e7de0b4b458f4a3083e4,0,15,0,1,11,27
700,1702,2022-10-03 10:28:00,2c370f160b50b99ac2415007db7ae0b5,0,11,0,2,10,23
701,1702,2022-10-03 10:38:00,3f97d3167532f4687750f6b05139347d,0,14,0,0,12,26
702,1702,2022-10-03 10:43:00,790b436d7a64f785c85f6c671a735648,0,11,1,2,8,22
703,1702,2022-10-03 10:49:00,494aaed72e42cd3ccddc4072b580991a,0,16,0,2,10,28
704,1702,2022-10-03 10:58:00,ab5083a0788055e0f5b4b8e999343b63,0,11,0,5,5,21
705,1702,2022-10-03 11:04:00,6eec30f362706cb5d85775e83182a2ab,0,13,0,3,12,28
706,1702,2022-10-03 11:08:00,77df979d2f8d1a5e849b0c10d598cf07,0,8,2,3,5,18
707,1702,2022-10-03 11:13:00,74954eb17b665bca1bc8ca0406a85f63,0,13,0,3,6,22
708,1702,2022-10-03 11:18:00,c456ea0d3e9eb0725feebe52c97caea9,0,8,0,4,12,24
709,1702,2022-10-03 11:24:00,a4a92680414eda851df315f21c3f86fa,0,10,0,1,7,18
710,1702,2022-10-03 11:28:00,4f56ab71703091a2615c7c70047d9d61,0,13,0,2,8,23
711,1702,2022-10-03 11:34:00,8360e6a22ae7c760f3e333c05ddaa049,0,15,0,2,8,25
712,1702,2022-10-03 11:39:00,237067bf277ac1892642197ec7ec03bd,0,9,0,2,10,21
713,1702,2022-10-03 11:42:00,e5128654a03b5a6a412da8e83a79ba0e,0,17,1,1,7,26
714,1702,2022-10-03 11:49:00,39c61dca2d869fb0892359e63c2963e0,0,10,1,2,7,20
715,1702,2022-10-03 11:54:00,0651a0f7b5a717280b9a667ed278b65c,0,17,0,2,9,28
716,1702,2022-10-03 11:58:00,5347680b32acf18369223ae3faa7bb68,0,14,0,7,10,31
717,1702,2022-10-03 12:03:00,b97ceb407e1c071d185f7086b7fdf51e,0,15,0,1,8,24
718,1702,2022-10-03 12:08:00,4f3d0cb971b3fdc7aa34393fba2e0b11,0,13,0,0,8,21
719,1702,2022-10-03 12:13:00,580141f6029aa73a21889cbdd4b9261d,0,13,0,1,5,19
720,1702,2022-10-03 12:18:00,b62250341ea9a932244f8d3250648e23,0,15,0,1,6,22
721,1702,2022-10-03 12:24:00,abb7d29519fd6fcd7f023c6a6605ec21,0,13,0,1,9,23
722,1702,2022-10-03 12:28:00,5ddffe59e21533baa301a2663c6a4147,3,17,0,2,15,37
723,1702,2022-10-03 12:33:00,3da0f6e1fcce8db510069c47f0af37cc,1,12,0,2,10,25
724,1702,2022-10-03 12:37:00,600caee8316526333a0795fd326b4afa,0,15,1,1,9,26
725,1702,2022-10-03 12:44:00,dea6a2e35696e1ed7c517ad16d7f5cdf,0,15,0,0,9,24
726,1702,2022-10-03 12:47:00,888ceb18f8289b8eefd54c35f24df871,1,15,1,1,11,29
727,1702,2022-10-03 12:53:00,980e6eb0facce8b80ad4f07ca036553e,0,11,0,5,15,31
728,1702,2022-10-03 12:57:00,84146ff91e625cd111306401c79b1be2,0,12,0,3,11,26
729,1702,2022-10-03 13:03:00,3aafc772be02ce2a0304a0ccb87cbd85,0,12,0,2,20,34
730,1702,2022-10-03 13:08:00,9e96df6ef7ca886e1e9d57b7a8db278b,0,13,1,6,3,23
731,1702,2022-10-03 13:12:00,1dcf3051cd2d5ea4fdb95a2b7023bca6,0,15,0,6,7,28
732,1702,2022-10-03 13:17:00,f716cd02b27ce11e433621ef52e9ef16,1,16,0,2,5,24
733,1702,2022-10-03 13:22:00,8b1566e12c02b50e9ef2114643f2da24,0,14,0,2,9,25
734,1702,2022-10-03 13:28:00,213d7c2e5a09ce84d89bcd431b9d08dc,1,13,0,0,9,23
735,1702,2022-10-03 13:37:00,e3031c8e3c8db904809d0945a84c6f1f,0,10,0,1,14,25
736,1702,2022-10-03 13:42:00,2f5e8ae35db90bfe8da431f211b7e4db,1,15,0,3,11,30
737,1702,2022-10-03 13:47:00,2cab27a581e3dbf6d110f56acc2df388,0,24,0,3,4,31
738,1702,2022-10-03 13:53:00,3456d6a311d450f18088477ff45ed8d1,0,18,0,1,12,31
739,1702,2022-10-03 13:57:00,247520e7cc204950e8020e8b4fa6223b,0,20,0,4,4,28
740,1702,2022-10-03 14:02:00,fd70c230f74f6b893d757be7fe96178b,1,15,1,3,11,31
741,1702,2022-10-03 14:07:00,f6d9f3bf39faf131eb26872f5367554f,0,15,0,2,10,27
742,1702,2022-10-03 14:13:00,c0f5cc8db784330a2d764d1d360b7352,0,11,0,2,7,20
743,1702,2022-10-03 14:18:00,17debf24a7647e9f736769cc4d40cbee,0,19,0,1,7,27
744,1702,2022-10-03 14:23:00,bae16944fea54a1af13053e1bc75c722,0,23,0,4,5,32
745,1702,2022-10-03 14:27:00,cdd705db973b044866322c7a7c21db92,0,17,0,1,11,29
746,1702,2022-10-03 14:33:00,e3b6723cfd5fa4df288203b4c223d566,0,22,0,0,10,32
747,1702,2022-10-03 14:38:00,ec209f75576587fdc46760e4be358626,0,18,0,2,3,23
748,1702,2022-10-03 14:42:00,4fab0684cc3a76c205d945631a19bb5e,0,15,0,2,8,25
749,1702,2022-10-03 14:48:00,0bb4a4b30c4182a64b386d0b46c28c68,0,15,0,6,7,28
750,1702,2022-10-03 14:52:00,dacdd1584fc1abc0dc8ac37c550b3015,0,18,1,2,8,29
751,1702,2022-10-03 14:57:00,658c021b8871c4b7a53e9ce48a179564,0,17,1,2,3,23
752,1702,2022-10-03 15:02:00,aba9e3a91cffacc3cc5a545e527db317,0,21,0,0,2,23
753,1702,2022-10-03 15:07:00,03dc42803a9aef4ae2f69303b45ca993,0,19,0,1,3,23
754,1702,2022-10-03 15:12:00,77cf2c9a61f562e65943260d363eb661,0,20,0,0,4,24
755,1702,2022-10-03 15:18:00,aea33e39b1326a695964cbab35dba8a4,0,14,0,0,1,15
756,1702,2022-10-03 15:23:00,4e45711531c51b2c31b41ab986f11d3f,0,21,0,5,0,26
757,1702,2022-10-03 15:27:00,d2c57af9c17e80889fe8c27864f8d199,0,17,0,4,10,31
758,1702,2022-10-03 15:33:00,c167907b532d9e5f052dc4678cc97e9a,0,21,0,0,10,31
759,1702,2022-10-03 15:37:00,e38d771ad08426ea59c2ae30d4ec9d17,0,13,2,4,9,28
760,1702,2022-10-03 15:42:00,65052c604246dfc1161430180f4df005,0,24,0,6,1,31
761,1702,2022-10-03 15:48:00,ed099356bb2da40c13d3c22df2b07314,0,17,0,1,10,28
762,1702,2022-10-03 15:52:00,95973900bb70b14b0b79869ce14b285d,1,18,0,5,2,26
763,1702,2022-10-03 15:57:00,24929e769d6aa23b3b0a0b42f0d11269,0,26,0,1,3,30
764,1702,2022-10-03 16:03:00,dab55e22c59cbd81c5b033dad9a397b3,1,15,0,2,1,19
765,1702,2022-10-03 16:07:00,105ddfb45de3cb4b38bf2a508a8d34fb,0,15,0,4,2,21
766,1702,2022-10-03 16:12:00,e0b1c4a3b89f5b11640014194830d12d,0,18,0,4,1,23
767,1702,2022-10-03 16:19:00,59747542a79b5cdff0c49f6c3ee4193c,0,21,0,1,6,28
768,1702,2022-10-03 16:22:00,b147f3dac418a14cad06e8e452d4c48f,2,18,0,2,4,26
769,1702,2022-10-03 16:28:00,f7bf719e22cc5b76f18c99cc621cdaca,0,14,0,4,7,25
770,1702,2022-10-03 16:32:00,03c68cc1fe1e16a90957b83fa2016290,0,15,0,3,5,23
771,1702,2022-10-03 16:37:00,da812976b50c816cfca260dfc2a59eba,0,12,1,2,9,24
772,1702,2022-10-03 16:43:00,03e892ae340312ea631b3e2fa0ef1e91,1,18,0,3,3,25
773,1702,2022-10-03 16:47:00,c67a1de61a4537965006f177d91b8c6f,0,20,0,0,2,22
774,1702,2022-10-03 16:53:00,b1044750ad3846686228f218e26f6fdf,0,24,0,2,4,30
775,1702,2022-10-03 16:58:00,d6218fb503547e41c97b4578036e5b11,0,17,0,6,6,29
776,1702,2022-10-03 17:03:00,81937964cbd0b96a9b331c71567c1a01,1,18,0,5,5,29
777,1702,2022-10-03 17:07:00,f66a325d26bf71f24f83132ced00f61c,0,23,0,1,6,30
778,1702,2022-10-03 17:11:00,098e7bf275cc5feca0630c53ee6bdd9d,0,17,0,7,3,27
779,1702,2022-10-03 17:18:00,dbae811f574299cf1a2e0aa0d180cce6,2,16,0,5,7,30
780,1702,2022-10-03 17:23:00,995c6b590114fc45475fe24e84f3e767,0,20,0,4,9,33
781,1702,2022-10-03 17:28:00,4136585d88be970363e6e2b4a1eaad53,0,20,2,1,13,36
782,1702,2022-10-03 17:32:00,d8c4b5a014299b502c661746edfd66f5,0,15,1,7,11,34
783,1702,2022-10-03 17:39:00,5be4c0f1f14426f92c44cfb0e2eb0d1a,0,14,0,1,15,30
784,1702,2022-10-03 17:43:00,768d60347608806a5721d288523164d5,0,23,0,4,9,36
785,1702,2022-10-03 17:48:00,bdbc1082557c7d2bab2256e2ee6238ce,0,22,0,7,9,38
786,1702,2022-10-03 17:54:00,4bde25a96a288b0191f5fd839046702f,0,23,2,4,7,36
787,1702,2022-10-03 17:58:00,576b36412c64dcbe88b89c324ec5a87b,0,15,1,4,13,33
788,1702,2022-10-03 18:08:00,99465c2cf4c63262cb4d06a557a1eff9,0,21,0,0,13,34
789,1702,2022-10-03 18:13:00,4d0e53a37fdae78c04e11380bd534923,0,13,0,1,11,25
790,1702,2022-10-03 18:19:00,7eaab870d6413cce956a72ddd458c609,0,16,0,3,9,28
791,1702,2022-10-03 18:22:00,bfbb18eb8088f32c01716b84ae3fd81d,2,14,1,0,10,27
792,1702,2022-10-03 18:27:00,1766d77d3ca9ad480cad3ee3176c7c7f,0,15,0,2,16,33
793,1702,2022-10-03 18:33:00,719dda5c07df4694679ad12f581f996f,0,20,0,0,10,30
794,1702,2022-10-03 18:38:00,1102bbea185e2236c6ff98af59fd8e35,0,11,0,2,16,29
795,1702,2022-10-03 18:42:00,10f55b585e4b4591677eb5d82ca489cc,0,18,0,3,10,31
796,1702,2022-10-03 18:49:00,484ebb6bf23990ee6870934c129c3cd5,0,18,1,1,11,31
797,1702,2022-10-03 18:54:00,10c1867a7bd507054197e2cbf8238e08,0,14,1,0,7,22
798,1702,2022-10-03 18:58:00,cfedfe76867b80e839b6931d2a42b4db,0,16,0,3,4,23
799,1702,2022-10-03 19:04:00,9352a10b80adc934a427cad110ff15a0,0,16,1,1,3,21
800,1702,2022-10-03 19:08:00,d5b238b62f937693783b6105b4af0503,0,23,0,2,2,27
801,1702,2022-10-03 19:12:00,b76bcab46fadcdecfaf933bbb878a399,1,19,1,2,0,23
802,1702,2022-10-03 19:18:00,3b080c4d06d8e20a0be2c77ef44a47ae,0,19,0,1,0,20
803,1702,2022-10-03 19:24:00,0276a0c0600fe0ac040a28ad4ce366b7,0,16,0,0,0,16
804,1702,2022-10-03 19:27:00,ddd5f6f544eba4c2fbfc3fdbcb2317d5,0,10,0,1,0,11
805,1702,2022-10-03 19:32:00,72eec50024b90d3fde4e3411cbd4c5ef,0,3,1,0,0,4
806,1702,2022-10-03 19:38:00,d05a4871773cf73688310ba87da2a1d0,0,12,0,0,0,12
807,1702,2022-10-03 19:42:00,12c125f2dde5f500544a89c257b0bfcb,0,13,2,0,0,15
808,1702,2022-10-03 19:48:00,74e804098605148fd85d9c0c1089e092,0,11,0,2,2,15
809,1702,2022-10-03 19:53:00,1ff43bc1a0a13be06f4237f5c4296a16,0,15,0,1,1,17
810,1702,2022-10-03 19:57:00,eb8e06c1a4b318f2496d1237d9d6eabb,0,18,0,0,0,18
811,1702,2022-10-03 20:02:00,0adbd1a427093046c2d896df936e72ed,0,9,0,0,1,10
812,1702,2022-10-03 20:07:00,d1f493d411a857765adbadcff62b6daa,0,11,0,0,0,11
813,1702,2022-10-03 20:12:00,c4f6e058c1fc81388eda2680b8c456ba,0,16,0,0,1,17
814,1702,2022-10-03 20:18:00,7473f6a0115d5c83910ba959983eae22,0,17,0,0,1,18
815,1702,2022-10-03 20:22:00,a2a918bcd0d0acbd41ce345e6a8ee0e5,0,13,0,2,1,16
816,1702,2022-10-03 20:27:00,e69c5e004558fa08366d20501114149c,0,13,0,0,0,13
817,1702,2022-10-03 20:32:00,d17828b78a251b1847a0e6d7bce7e6d6,0,13,3,3,0,19
818,1702,2022-10-03 20:38:00,56ef65f9258b1e2868891955ec7f5c01,0,14,1,0,6,21
819,1702,2022-10-03 20:41:00,9266433cac12288aa69ede16a5f622d0,0,18,3,0,1,22
820,1702,2022-10-03 20:48:00,b048b4c3992dab5e1b9007560e201088,0,14,2,0,3,19
821,1702,2022-10-03 20:53:00,5aaf0d6e4d8c23eed55a6430aa6e7b16,0,15,1,0,3,19
822,1702,2022-10-03 20:57:00,dc91998867077d0b08149821c9469cac,0,12,0,1,1,14
823,1702,2022-10-03 21:02:00,d8dee77917dc38d18b8b57cb1d800775,0,10,0,0,0,10
824,1702,2022-10-03 21:08:00,bdbdb85aed78202b67eb35635f7e0d8b,0,13,0,0,5,18
825,1702,2022-10-03 21:12:00,0dc748bae767ec0eaadfffa3d6d1ef0a,0,16,0,0,0,16
826,1702,2022-10-03 21:18:00,bdabc1be96af95f4bd5f21ded32a5ea7,0,11,0,0,0,11
827,1702,2022-10-03 21:22:00,e8d29ec836886be64f6d0d63a143149e,0,13,1,3,1,18
828,1702,2022-10-03 21:26:00,b7f00791491c8905b6f9d6a3cc6d4f93,0,19,0,0,2,21
829,1702,2022-10-03 21:32:00,38c9718b3c79fde9e92221c85d09312d,0,19,1,0,0,20
830,1702,2022-10-03 21:37:00,c735986f9aa839ae52f5d48697b5a83c,0,17,0,0,1,18
831,1702,2022-10-03 21:42:00,f247fae0af8ccae79c79e4ca8288ce6d,0,11,0,1,0,12
832,1702,2022-10-03 21:48:00,9734b91225fd82d3a0004c9fbd5d4be1,0,15,2,0,0,17
833,1702,2022-10-03 21:53:00,7963e8d137c9fafa094352fb7c46e4a2,0,13,0,0,2,15
834,1702,2022-10-03 21:57:00,6c68a72e8c0c994e3c0df3dccb46ad0d,0,6,0,1,0,7
835,1702,2022-10-03 22:03:00,90e65f5ee421f67c5fc68364fc3c627c,0,15,1,0,0,16
836,1702,2022-10-03 22:07:00,0621c4b89ec3e274e4e9a7d5c3e12602,0,13,0,0,0,13
837,1702,2022-10-03 22:12:00,fa6b62a4b0bfa66d7b083e828af99f12,0,13,0,0,0,13
838,1702,2022-10-03 22:17:00,ad52f0f52f0a315f13491b64a0301f89,0,12,0,0,1,13
839,1702,2022-10-03 22:22:00,6f637d0dcbebbea74c773698576bc8b2,0,11,0,0,0,11
840,1702,2022-10-03 22:27:00,99ff7b3e37f0d56932eecc25a0fcd571,1,10,0,0,0,11
841,1702,2022-10-03 22:31:00,775684c5e9d1399c19a0b19ab8692813,0,7,0,0,2,9
842,1702,2022-10-03 22:37:00,df96f8993995abde34d3e81968c0335d,0,20,0,0,1,21
843,1702,2022-10-03 22:41:00,41f6db3bba0389db14866b19e75d6387,0,6,0,1,1,8
844,1702,2022-10-03 22:47:00,f404d1310779c2b56ee5dfe9264e8d8b,0,8,0,1,0,9
845,1702,2022-10-03 22:52:00,142d282afaf2c6f3977b397ebdbd4049,0,14,0,0,1,15
846,1702,2022-10-03 22:58:00,d54602da056394270f70e1b29d069cf8,0,10,2,1,1,14
847,1702,2022-10-03 23:03:00,8f4cb90da8ebf0f6b26b23426047e484,0,7,0,1,1,9
848,1702,2022-10-03 23:07:00,8983dd9f0c90c796b06686cb30d5388c,0,14,0,0,2,16
849,1702,2022-10-03 23:11:00,c1bf54f2858e4e32ea03de8a05727f32,0,7,0,0,1,8
850,1702,2022-10-03 23:16:00,e1d227195b60ba152d2b0ba402f0d51c,0,13,0,0,1,14
851,1702,2022-10-03 23:22:00,fa5d62fefba83da30c5de0d64156a346,0,6,0,0,0,6
852,1702,2022-10-03 23:28:00,1bdd2e3f9f854b695ffe6e49c39c3349,0,16,0,0,1,17
853,1702,2022-10-03 23:32:00,284e7e178fb396a80ad845650be639e6,0,11,0,1,0,12
854,1702,2022-10-03 23:37:00,8d403284627d4e6c3c48d5cfcaf0ec9a,0,9,0,0,0,9
855,1702,2022-10-03 23:42:00,164d107816bdb3fe0e6131d681468dbf,0,8,2,0,0,10
856,1702,2022-10-03 23:47:00,da0cd9c8a2264dff5736bb5ced99380e,0,12,0,0,1,13
857,1702,2022-10-03 23:51:00,78694e1250681444470a3dd706da1740,0,5,0,0,0,5
858,1702,2022-10-03 23:56:00,adad33e32b0e929f97a3d49261df4f7a,0,6,1,0,0,7
859,1702,2022-10-04 00:07:00,b71458b914d7841f4dd217f1024a2049,0,6,0,0,1,7
860,1702,2022-10-04 00:11:00,47cccccdf8c67d25d122974fd8211ff5,0,5,1,0,1,7
861,1702,2022-10-04 00:17:00,6e6119e2b4f07d1f4d7212f89211937b,0,6,0,1,1,8
862,1702,2022-10-04 00:22:00,114134d981922dd9a3405f7f32256661,0,7,0,1,1,9
863,1702,2022-10-04 00:26:00,238c54cdf14d55b31393436366b6d39d,0,8,0,0,0,8
864,1702,2022-10-04 00:31:00,6aa1bda0ca14f074ad203b1dae684e36,0,15,0,0,2,17
865,1702,2022-10-04 00:36:00,543ab8f6c5ec1ac5ea7d25091e95c1bc,0,10,0,0,1,11
866,1702,2022-10-04 00:41:00,a4b2264694611d688a63680c7f057c21,0,14,0,0,0,14
867,1702,2022-10-04 00:46:00,9734c9d9ff8d3c13998ee439e8710a3b,0,11,0,2,1,14
868,1702,2022-10-04 00:51:00,36fd4fd004a0a2ba14a686a1423d1059,0,5,1,1,0,7
869,1702,2022-10-04 00:56:00,7e13a43fa4e1b7516ff4d8fa534f1b3f,0,10,0,0,0,10
870,1702,2022-10-04 01:01:00,5519524bdaf539576abffc45ab990a27,0,7,0,0,1,8
871,1702,2022-10-04 01:07:00,af9bea148ad01264c38eac4d09ce5b58,0,1,0,0,0,1
872,1702,2022-10-04 01:11:00,d82eb50884633b369a1c2db1ff18cb49,0,10,1,0,0,11
873,1702,2022-10-04 01:16:00,78d3b4ee277e44fa90e7ff2d1c7c6ef6,0,15,0,0,1,16
874,1702,2022-10-04 01:22:00,d8bda19ed9d7aeefccf0b3e2af68b470,0,3,0,0,1,4
875,1702,2022-10-04 01:26:00,7edf40dabaa85cc9031ecb638885e94a,1,9,0,0,0,10
876,1702,2022-10-04 01:31:00,96946edb4c6ac85a4968bb2e73f3667b,0,5,0,0,0,5
877,1702,2022-10-04 01:36:00,a7b4d890a2471a9346756538b54706e3,0,2,0,0,1,3
878,1702,2022-10-04 01:41:00,0a16d0977bcce1b89198abd6bc7b10df,0,3,0,0,0,3
879,1702,2022-10-04 01:47:00,618b1adb5b81550741b5b23480046e3b,0,2,0,2,1,5
880,1702,2022-10-04 01:51:00,99441b116548cd70185f3d4abc1a6b0f,0,2,0,0,0,2
881,1702,2022-10-04 01:56:00,c4529ed6d71293d2f5243e5e5d57ec17,0,5,0,1,0,6
882,1702,2022-10-04 02:01:00,8ac543ea1b0c4f427fbbcb48284b3f92,0,1,0,0,0,1
883,1702,2022-10-04 02:06:00,a72b87180bc851f2ec0f900c563f099c,0,4,0,0,0,4
884,1702,2022-10-04 02:11:00,31d1d59d83cadbebf2c495f51c87ed60,0,9,1,1,0,11
885,1702,2022-10-04 02:17:00,88c389983ad704030cedc84920ed2335,0,15,0,0,1,16
886,1702,2022-10-04 02:22:00,35b56c891e268b2b421737b15048350d,0,9,0,0,0,9
887,1702,2022-10-04 02:27:00,8dd7f4be71772186a98b5746b9708a74,0,0,0,0,1,1
888,1702,2022-10-04 02:31:00,0d804512f13eff22def932bef7a73902,0,10,0,0,0,10
889,1702,2022-10-04 02:37:00,eedf93c5c5312ca3a69c57f01d2e61da,0,6,0,0,0,6
890,1702,2022-10-04 02:41:00,bbc628ad61b59924a12b2006aefc8365,0,3,0,0,0,3
891,1702,2022-10-04 02:47:00,28ecca27c20f41bb734867dfe0a6eed1,0,3,0,0,0,3
892,1702,2022-10-04 02:52:00,fd0cec01873273ee5c6f1008bc4f24ec,0,3,0,0,0,3
893,1702,2022-10-04 02:56:00,e7b9f95f032baabfe417aab28ccfdc51,0,4,0,0,0,4
894,1702,2022-10-04 03:02:00,5c66d11da75a2414186c9ed23649cb20,0,5,1,0,0,6
895,1702,2022-10-04 03:07:00,984f485e17d6672d4c689465f31bdebe,0,10,1,0,0,11
896,1702,2022-10-04 03:12:00,5175a740283736cd903ea94c3f972cf6,0,3,0,0,0,3
897,1702,2022-10-04 03:17:00,bbe53f7ab9a8a1f9d7b306a088a9e6af,0,5,0,0,0,5
898,1702,2022-10-04 03:21:00,113efec88adcc85956687a23545c704b,0,7,0,0,0,7
899,1702,2022-10-04 03:26:00,d6d1cefa64dbe37e2a076a3e53610c25,0,0,0,0,0,0
900,1702,2022-10-04 03:32:00,3c6f48a81464eeedf98c123613ea8544,0,10,0,0,0,10
901,1702,2022-10-04 03:37:00,5fdf8f41131046908ded20d6d9bc336c,0,5,0,0,0,5
902,1702,2022-10-04 03:41:00,1b2a0cbd688ba0f885a35fbf1626d080,0,3,0,0,0,3
903,1702,2022-10-04 03:47:00,8b59c7d6572925017d440e88ab6d5d66,0,6,0,0,1,7
904,1702,2022-10-04 03:52:00,d2385d35a0207b6c92bc9ae57f5e6218,0,6,0,0,0,6
905,1702,2022-10-04 03:57:00,186ba2f7eaf5833d4a6d983aef239a68,0,9,0,0,0,9
906,1702,2022-10-04 04:02:00,db61416770a98c37c2f0ab9536202b70,0,6,0,0,0,6
907,1702,2022-10-04 04:07:00,9c087d68bf1a2614bc84cf886dfbcc94,0,8,0,0,0,8
908,1702,2022-10-04 04:11:00,9c4fe374d48c95996c7b8c522bbc86f2,0,11,0,0,0,11
909,1702,2022-10-04 04:17:00,6e735e271ccc05db86e4a4f8e211bddf,0,9,0,0,0,9
910,1702,2022-10-04 04:22:00,bebfac890cc4ff30375cafe3212b3931,0,6,0,0,0,6
911,1702,2022-10-04 04:26:00,ed52cd34cd86b35e306b2ea88ec61c49,0,5,0,0,0,5
912,1702,2022-10-04 04:31:00,ef606862923e84e7e7d6809490f7e1bb,0,4,0,0,1,5
913,1702,2022-10-04 04:37:00,c74c7b0af2b68e9b7564678461487ec5,0,9,0,0,2,11
914,1702,2022-10-04 04:42:00,2576d64471d1ddcc87cf42e6bbab0eb8,0,8,0,0,0,8
915,1702,2022-10-04 04:48:00,6bbab6e8b7d3457869419661fd6a6a9e,0,2,0,0,0,2
916,1702,2022-10-04 04:53:00,c52636a53f661dc3fefeee2497a9d21a,0,4,0,0,0,4
917,1702,2022-10-04 04:56:00,15b0c1dcad153878502841503ca0bfcf,0,1,0,0,0,1
918,1702,2022-10-04 05:02:00,c8bfb31f766a9857e8d5b95696494773,0,4,0,0,0,4
919,1702,2022-10-04 05:07:00,b6755184f81e8b8589913a4321dcf5c6,0,7,0,0,0,7
920,1702,2022-10-04 05:11:00,9aff095da58409bbf0d657798ac962e2,0,2,0,0,0,2
921,1702,2022-10-04 05:17:00,f7da9d1063e650ec3932884f22549f08,0,0,0,0,0,0
922,1702,2022-10-04 05:22:00,0f76526b723a8b84787b78ffe95ab7d8,0,5,1,0,0,6
923,1702,2022-10-04 05:26:00,146fa1ad47f465bdd7122953a837322d,0,8,1,0,0,9
924,1702,2022-10-04 05:32:00,c7aee941c8c705207b4cfeaad4821aa1,0,3,0,2,1,6
925,1702,2022-10-04 05:37:00,36c1c1cc44662380b34de66056458bfc,0,10,0,0,0,10
926,1702,2022-10-04 05:42:00,2652ea17355c301ddedc346b1f924760,0,3,0,1,0,4
927,1702,2022-10-04 05:47:00,401da833b8a78f3342fcdf77c8f5f0fb,0,3,1,0,0,4
928,1702,2022-10-04 05:53:00,f3a9565cf66bd0cc1d4816071f2638f2,0,5,0,0,0,5
929,1702,2022-10-04 05:57:00,9dcb2fda1d53f2d9f2b91d2a0d971678,0,9,0,4,1,14
930,1702,2022-10-04 06:01:00,8f755e8a48aa3d0c2f470bafca83f116,0,8,1,0,1,10
931,1702,2022-10-04 06:07:00,b08516948761cc467ce5053d43b528b0,0,1,1,0,1,3
932,1702,2022-10-04 06:11:00,3c0f7f43b64b1c9f9093b8674aec40c2,0,5,0,1,0,6
933,1702,2022-10-04 06:17:00,21d364d2c24a2a26c2899eb5f2b384f2,0,4,2,0,1,7
934,1702,2022-10-04 06:22:00,95633bdafa6f71b701cc5aeb252104c1,0,6,1,0,0,7
935,1702,2022-10-04 06:26:00,8bc5b39937bc64b6755ccc679422a175,0,10,0,1,0,11
936,1702,2022-10-04 06:33:00,79e45d768177f2d8112e80bf36501efb,0,16,0,0,0,16
937,1702,2022-10-04 06:37:00,5c1c5e7213962a7f61f10b266b36069d,0,5,0,2,1,8
938,1702,2022-10-04 06:41:00,a0b1d553f9c791c819af774a774dabce,0,16,0,1,7,24
939,1702,2022-10-04 06:47:00,e2b006b370d3fd914a7d54cbb162dad2,0,13,1,0,4,18
940,1702,2022-10-04 06:52:00,8e1e7a8416b1f0dad2ef627359de301b,0,11,0,3,3,17
941,1702,2022-10-04 06:56:00,5e36623fe5882b58977ac1be99b84996,0,11,0,1,8,20
942,1702,2022-10-04 07:02:00,c0402e523c8c257c67d97addaca0555d,0,12,0,1,12,25
943,1702,2022-10-04 07:06:00,25e2ab91083c81389c70baf2ed4d0b69,1,17,2,0,14,34
944,1702,2022-10-04 07:12:00,67eba207a02eb210a7e6ffb7ea5ae14a,0,13,0,1,9,23
945,1702,2022-10-04 07:17:00,36e96c169f8771ad3f2e0ba56cf0a8bf,0,14,0,2,10,26
946,1702,2022-10-04 07:22:00,98da4970df8c67fee8189d96edc5eb03,0,10,0,2,13,25
947,1702,2022-10-04 07:27:00,6726f02df6c245c8fe94cc650f3384b6,0,15,0,1,14,30
948,1702,2022-10-04 07:33:00,392fc4d9a09bedb8ce56de17ae2196bb,0,19,0,2,8,29
949,1702,2022-10-04 07:36:00,6cce811669eba8a1a7562dc19c5e5cb6,0,14,0,1,14,29
950,1702,2022-10-04 07:41:00,526ecccdf94e0cdb5bc69500464ae6d3,0,14,0,0,7,21
951,1702,2022-10-04 07:46:00,15c0c58e54e70ad9646ac21cd6e48096,1,17,1,0,11,30
952,1702,2022-10-04 07:53:00,d841e6f4c971d1954ad9017007c97e04,0,29,0,2,5,36
953,1702,2022-10-04 07:57:00,f8f82b45554a080da7711a9971f2052d,1,13,0,1,12,27
954,1702,2022-10-04 08:02:00,fc4b4963ad8ea1bd91a033666e5bcfc2,0,14,0,2,15,31
955,1702,2022-10-04 08:07:00,ee176719f5fa109fafb1b4f921a2732e,0,13,0,1,9,23
956,1702,2022-10-04 08:12:00,ee0a9fadaf3ed68b785d411e59757fc3,0,14,1,3,11,29
957,1702,2022-10-04 08:17:00,f518360ec896a9810b82346e7feeb6b8,0,17,1,0,14,32
958,1702,2022-10-04 08:22:00,2b0656baadae0ff8dc0d443fa6a5d663,2,17,1,0,6,26
959,1702,2022-10-04 08:28:00,45560a8a471b67b8354038240e9f6879,0,17,0,4,10,31
960,1702,2022-10-04 08:32:00,e2eba93e9fa7a06e1ded26ef4f4f6d01,0,6,0,0,16,22
961,1702,2022-10-04 08:37:00,9eca5a811b34d6a0699739759bd2b8ac,0,22,0,1,9,32
962,1702,2022-10-04 08:43:00,3d5b074b005dbf417fd5efddd8af36cb,1,27,0,0,8,36
963,1702,2022-10-04 08:47:00,554c12e9d51c3c166f2cb055c3fefb31,1,24,0,5,9,39
964,1702,2022-10-04 08:52:00,052db9f6a528513fc84b37d3c7f3a0a2,1,20,0,5,12,38
965,1702,2022-10-04 08:56:00,26a67382671c628bda887bb8f65a2dc1,0,27,0,0,9,36
966,1702,2022-10-04 09:02:00,ca26bea3547f2a97456369796da2937a,1,18,0,1,9,29
967,1702,2022-10-04 09:07:00,6c38756c9f5ea10ff50800d10d2025f7,0,16,0,5,6,27
968,1702,2022-10-04 09:12:00,ff692720b39059fac4eb88fd69711b6c,0,17,0,3,5,25
969,1702,2022-10-04 09:17:00,b113063f35498e3b9cba203b5687dd54,0,13,0,8,6,27
970,1702,2022-10-04 09:22:00,a21bc474da0e9ef1ae192258b53aae1d,0,21,0,4,4,29
971,1702,2022-10-04 09:26:00,5a734b3a2b92134f3ffb26f641ad287d,0,19,0,0,6,25
972,1702,2022-10-04 09:32:00,643cc331ea4c9f96e2ff2952827e0a51,1,17,0,1,10,29
973,1702,2022-10-04 09:37:00,578705999ffc94fe3795384c17cba5af,0,15,0,0,15,30
974,1702,2022-10-04 09:42:00,bf74def04b3154be9476be7b16d6a5f7,1,21,1,0,9,32
975,1702,2022-10-04 09:48:00,4586afb46c79a1f45ea24d9915486a75,0,13,0,1,9,23
976,1702,2022-10-04 09:53:00,d6b1a8cd423e3dcaf1b4f0a0b0c832f3,0,19,1,2,5,27
977,1702,2022-10-04 09:57:00,77fc228da83f113125ebac5ea814fbba,0,17,0,5,2,24
978,1702,2022-10-04 10:02:00,bc19da3f8c9b0bda69c5d3e3452fff3e,0,9,0,3,2,14
979,1702,2022-10-04 10:07:00,a99df8b5168b6600592569dfbe42704e,0,17,0,0,8,25
980,1702,2022-10-04 10:12:00,3263c23b5c141476a9303f9e0bdba4ae,0,15,0,0,9,24
981,1702,2022-10-04 10:17:00,22127a8c70b13369f1885ddbcaea2acd,0,20,0,2,7,29
982,1702,2022-10-04 10:22:00,76e41a9160a6471f0a697477c0b022ef,1,14,0,0,11,26
983,1702,2022-10-04 10:27:00,a15bb18b3d8c3750890253822d49fe6e,0,22,0,3,8,33
984,1702,2022-10-04 10:32:00,940554c40c07b97de46242d9a961c7d0,1,16,0,1,12,30
985,1702,2022-10-04 10:36:00,0b5a11d779fbc555ec97ae42c47a045b,0,15,0,2,13,30
986,1702,2022-10-04 10:42:00,37600754a6feeb66990726310e53028a,0,12,1,2,14,29
987,1702,2022-10-04 10:47:00,12abd89983bea4388100c3953cc84745,0,9,1,3,16,29
988,1702,2022-10-04 10:52:00,9a0df3ee3c2f39a9497d30b29f3d87c9,0,21,0,3,9,33
989,1702,2022-10-04 10:57:00,799a391569654dd4134835c6dbe0a8bf,0,6,1,2,13,22
990,1702,2022-10-04 11:02:00,568d756af8f01ad5aea24ab13683408a,3,7,0,4,9,23
991,1702,2022-10-04 11:07:00,05660edb3690a2405be0486eef57f2de,0,14,1,1,12,28
992,1702,2022-10-04 11:12:00,ce5040fc93ceb2d3b3b3eef4111aa410,0,14,0,2,9,25
993,1702,2022-10-04 11:17:00,7c7ebd7ccaf92a528168fa4e4ce06fa0,0,14,0,0,5,19
994,1702,2022-10-04 11:22:00,e816ead0fc14e03c312af878152e744b,0,13,1,3,11,28
995,1702,2022-10-04 11:27:00,be2a02bb5c8b1ea3bc6958f99bdf77f9,1,17,0,2,8,28
996,1702,2022-10-04 11:32:00,1c466cb5e0169d9924a6bc8de74bbf60,0,15,1,4,4,24
997,1702,2022-10-04 11:36:00,fc78f3609cda163c55eae2cf67954e62,0,8,1,0,14,23
998,1702,2022-10-04 11:42:00,3e21e77260a46f13acc124281c8025a9,0,14,0,1,13,28
999,1702,2022-10-04 11:46:00,d92fa5dcadbe233dded620f091edee37,0,15,0,2,7,24
1000,1702,2022-10-04 11:52:00,9a3b3cc0586e348ad37c98015a6c7c8b,0,14,1,3,7,25
1001,1702,2022-10-04 11:57:00,6dfbe83a293a03d396a7c20219acc270,0,18,0,0,7,25
1002,1702,2022-10-04 12:01:00,a279b7e01f5deb1dcfeb7dd1efff5e36,0,12,0,0,10,22
1003,1702,2022-10-04 12:06:00,e3a45535cf5a873622ab4d0e98bd32ed,0,16,0,5,9,30
1004,1702,2022-10-04 12:12:00,49877831b7059659340053eb1cf0bf7f,0,15,0,0,9,24
1005,1702,2022-10-04 12:17:00,aa5475c20a66f24c20732bf312449c66,0,9,0,1,11,21
1006,1702,2022-10-04 12:23:00,27b45678cbc050c54ecc1b96cf783768,0,12,2,3,8,25
1007,1702,2022-10-04 12:27:00,2dd431a725df894d215224899a2a8455,0,16,0,1,9,26
1008,1702,2022-10-04 12:32:00,da96c67e438e92708f2afe7f34a1aa3c,0,12,0,0,12,24
1009,1702,2022-10-04 12:37:00,7758e8d74a8e4814b459e6ba67971445,0,10,0,4,6,20
1010,1702,2022-10-04 12:42:00,e653a99087418d9f8aea19e50bcefeef,0,13,0,0,11,24
1011,1702,2022-10-04 12:48:00,5bf4e2304059ea34de6dae0cb71870bb,0,13,1,1,9,24
1012,1702,2022-10-04 12:53:00,04bb2d02ea471d7422fdc975252a1308,0,14,0,1,14,29
1013,1702,2022-10-04 12:57:00,26b4356be9606c14d3171e94577f5522,1,7,0,3,5,16
1014,1702,2022-10-04 13:02:00,c3300b52d6e8e8a78d323b37cbecf427,0,13,1,4,6,24
1015,1702,2022-10-04 13:07:00,4cc7d99feac1a45fdd1de18e508b1c17,0,8,0,3,11,22
1016,1702,2022-10-04 13:12:00,049ceff72f2301bcdf435048fd4f7dc5,0,17,0,2,3,22
1017,1702,2022-10-04 13:17:00,c095246027e9963424025c8cee9af8ca,0,12,0,7,4,23
1018,1702,2022-10-04 13:22:00,2121f54fd14df1e7eebcb97e74319622,0,14,0,2,11,27
1019,1702,2022-10-04 13:27:00,8b0e764cdf39c6d5613d16a9ad12634b,0,13,0,2,8,23
1020,1702,2022-10-04 13:32:00,19758bec1d41ab6ad1ff8eeace2a90ea,3,20,0,1,11,35
1021,1702,2022-10-04 13:37:00,7c9e0aafe11605ff76693738ab2293c2,1,22,0,2,8,33
1022,1702,2022-10-04 13:42:00,f830b048dc95f2eb436900298b3eaba0,1,13,0,5,6,25
1023,1702,2022-10-04 13:47:00,f0162c71274bdf7ed3451c9aa126d63c,0,23,0,1,5,29
1024,1702,2022-10-04 13:53:00,0ffd5227f1c5fc0829a326924e2bb578,0,12,0,2,13,27
1025,1702,2022-10-04 13:57:00,51e16076080e6d70d9ee03e708e3e5b2,0,16,0,4,9,29
1026,1702,2022-10-04 14:03:00,7eed7917ca7090dd9acbfaa903fcebdb,1,15,0,4,9,29
1027,1702,2022-10-04 14:07:00,5dce46802605c6d5195bf251bd023c0a,0,18,0,1,8,27
1028,1702,2022-10-04 14:12:00,e17744baab46aad694cc4605f54e08c1,0,12,0,3,12,27
1029,1702,2022-10-04 14:17:00,fc0e7d16c35c97bea26583957c98193c,0,8,0,1,11,20
1030,1702,2022-10-04 14:23:00,4ade85e21d5c82aba6fd9438a6f9ec7c,0,14,0,9,12,35
1031,1702,2022-10-04 14:27:00,24c512413085144f7e4bc60f1ffc163d,0,12,0,1,11,24
1032,1702,2022-10-04 14:33:00,db88735b5eb45e58821da90a2ef0b9df,2,13,0,2,11,28
1033,1702,2022-10-04 14:37:00,5146e0bb9607ca75f0cde34808837b80,0,10,0,1,14,25
1034,1702,2022-10-04 14:42:00,7c74565914154b11dc44198a190b6549,0,14,1,2,12,29
1035,1702,2022-10-04 14:47:00,9399d0e68e39fdf8930f6bd4408b7f44,0,11,1,3,11,26
1036,1702,2022-10-04 14:53:00,b7339ea4b711f3b07c3e069b30e4b1f5,1,17,0,4,8,30
1037,1702,2022-10-04 14:57:00,fabca0689b3c8022c1fc50aea47b4a66,0,12,0,1,11,24
1038,1702,2022-10-04 15:02:00,41401589fccd5e3c11669d04bb2c4425,0,11,0,2,12,25
1039,1702,2022-10-04 15:08:00,373fe612dbabef73694f154ec76ffca9,0,13,0,3,10,26
1040,1702,2022-10-04 15:12:00,145340a69a81709384b095f9420a649e,0,11,0,3,4,18
1041,1702,2022-10-04 15:17:00,3828204ded7a880f3614a9b1d892f185,0,22,0,2,3,27
1042,1702,2022-10-04 15:22:00,e6cb1007dfc644e02dbcacb5adcbb681,0,17,0,5,4,26
1043,1702,2022-10-04 15:27:00,c0fe48ab4acd60be0cf5fa3b8a156021,0,22,0,4,2,28
1044,1702,2022-10-04 15:32:00,c3bf79edbec64bda3da71a799eab107e,0,26,0,6,10,42
1045,1702,2022-10-04 15:37:00,552de962fd80720bab7fafb8fac4b78f,2,30,0,15,10,57
1046,1702,2022-10-04 15:41:00,fc30f9da1c3a194fa28fecbbb8390f89,0,22,0,11,10,43
1047,1702,2022-10-04 15:47:00,ed0ba6cf54829f0a692018c377f43b54,0,25,0,7,11,43
1048,1702,2022-10-04 15:51:00,a52de07e1e7e24c9d3fa60dc43fd6ab4,0,27,0,10,8,45
1049,1702,2022-10-04 15:57:00,c5227d59cdce5c1a1323cdb5bcf97f64,0,19,0,13,12,44
1050,1702,2022-10-04 16:02:00,94ef15e90bd2bdd64948802972f7660e,0,26,0,9,7,42
1051,1702,2022-10-04 16:08:00,82a8231983e6432ce914d03dbe2097c3,0,27,0,13,6,46
1052,1702,2022-10-04 16:12:00,9ad6192c99430c359d8499256a995a1f,1,28,0,5,4,38
1053,1702,2022-10-04 16:17:00,e8cc2946d6705d2dbabef412a7e4709a,0,29,0,11,5,45
1054,1702,2022-10-04 16:23:00,878bc916d639b012171e704782ce3ab7,1,22,1,5,17,46
1055,1702,2022-10-04 16:27:00,551ce207b3f18db05687ab26888eb25e,0,20,0,11,9,40
1056,1702,2022-10-04 16:33:00,9189570a946ffb55d23bfdaafbfe1ba2,0,14,0,2,7,23
1057,1702,2022-10-04 16:37:00,d9d6b31151d52062fb874ec3c842de93,0,16,1,3,5,25
1058,1702,2022-10-04 16:42:00,c5553714396b42fbee1fe59f4d811c49,1,11,0,1,14,27
1059,1702,2022-10-04 16:46:00,f297282a59d1f785a1b86daa63023661,2,11,0,7,8,28
1060,1702,2022-10-04 16:52:00,c3f2dd7907c96cd3253e4d3d522e8f7e,0,12,0,0,7,19
1061,1702,2022-10-04 16:56:00,ea1148da4e1912bf7c81f29a187d0bda,0,9,0,1,13,23
1062,1702,2022-10-04 17:03:00,20d6f3021b2f130d284398a8a1d4ea65,0,9,0,2,15,26
1063,1702,2022-10-04 17:07:00,75050bb5b0ff9465bb2567cdbd6d2133,0,10,0,9,11,30
1064,1702,2022-10-04 17:12:00,5712bf293b1fafea3e2ce3b1b3cc98f4,0,15,0,4,13,32
1065,1702,2022-10-04 17:18:00,1aaeed9adc1c04bb63bbe1c44e5e9b84,0,14,0,1,16,31
1066,1702,2022-10-04 17:22:00,fb183ab034463a913fb000f648b4cab8,0,17,0,7,8,32
1067,1702,2022-10-04 17:28:00,daeff2052cfdeddab8e1e96870b17719,0,17,0,0,13,30
1068,1702,2022-10-04 17:32:00,dee67a028eb872968438554823bac076,0,18,0,0,13,31
1069,1702,2022-10-04 17:37:00,267e14b98ba1a3770a45b947abe33511,0,17,0,8,9,34
1070,1702,2022-10-04 17:41:00,fba813d22913e9792ef40983fc4d50fa,0,14,0,2,16,32
1071,1702,2022-10-04 17:47:00,3ec636ed3efc50e2445e0484032e7573,0,22,0,3,11,36
1072,1702,2022-10-04 17:52:00,2684dedcdd1b3e04ee430e3b74449d56,0,17,0,3,15,35
1073,1702,2022-10-04 17:57:00,70535a07d7b732eada633ca11c02fc56,0,17,0,3,8,28
1074,1702,2022-10-04 18:02:00,36e01fdbc84ed89bd16026fb07d47473,0,17,0,7,5,29
1075,1702,2022-10-04 18:06:00,0b16bb8d9c2e4b5a71ab8cc999752fdb,0,13,1,2,13,29
1076,1702,2022-10-04 18:12:00,0264352aac1be5e7b2704a2f7ae6670b,0,23,0,2,7,32
1077,1702,2022-10-04 18:18:00,6ccd018d90136750e119b8784404dedf,0,27,0,1,6,34
1078,1702,2022-10-04 18:22:00,5b8ec4332b6ea2fcc90907f287ed290d,0,16,0,2,9,27
1079,1702,2022-10-04 18:27:00,09e19ce7e3cda65f9b81140838964151,0,21,0,0,11,32
1080,1702,2022-10-04 18:32:00,ffee6796457471275e61bf9e71e90d55,0,19,1,1,8,29
1081,1702,2022-10-04 18:37:00,4c113ef6eb987cb0882a6cbd2e98a90d,0,24,0,2,5,31
1082,1702,2022-10-04 18:42:00,bec69c2ac74c74ea6244579a5ac6ad2f,0,21,1,1,9,32
1083,1702,2022-10-04 18:47:00,0db533846ac5a0f3286421ffbf47f0fb,1,21,0,2,9,33
1084,1702,2022-10-04 18:52:00,cc839766eb3f6e34ce3910eb9298dc3e,0,18,0,2,12,32
1085,1702,2022-10-04 18:56:00,53063c7bd4d85ba83586023b5d1fa70c,0,18,0,2,5,25
1086,1702,2022-10-04 19:02:00,acae3847a99e12c62d0117b449458a9d,0,21,1,1,3,26
1087,1702,2022-10-04 19:07:00,58e818453ce65168a621c2587e3741e7,0,29,1,2,3,35
1088,1702,2022-10-04 19:11:00,0d8d2edaaeb70f71b8513cf984c713f8,2,22,0,3,5,32
1089,1702,2022-10-04 19:17:00,5a715a3fafc2c962a668d7c0c0302241,0,22,1,2,0,25
1090,1702,2022-10-04 19:21:00,33cfdf4e09020e96b055022bbb77a864,0,24,1,2,0,27
1091,1702,2022-10-04 19:26:00,42da6158ca17145fdbc787f2bc8f98e6,0,15,0,0,0,15
1092,1702,2022-10-04 19:31:00,87440c69e4d15cbfe0cfbcffa8c703d4,0,21,0,1,1,23
1093,1702,2022-10-04 19:37:00,17f5f6345caa3c14c8eb8881197f7e70,0,34,0,1,0,35
1094,1702,2022-10-04 19:41:00,8817b14b383d5f9dee6eed3bbe8111fd,0,24,0,1,1,26
1095,1702,2022-10-04 19:47:00,ed5a04a503a149d41e3a23051041f811,0,20,0,0,1,21
1096,1702,2022-10-04 19:51:00,2c4ee2e9ec6e8deba4c1143ab3902dc4,0,20,2,2,2,26
1097,1702,2022-10-04 19:56:00,a6911475e8d9969d4621b129df90ceeb,0,23,0,2,0,25
1098,1702,2022-10-04 20:01:00,a880a2fb9c4077dfac1fb027053161c4,0,15,0,1,0,16
1099,1702,2022-10-04 20:07:00,7ca1d697d0f7988d83f740e0d3083582,0,26,0,1,2,29
1100,1702,2022-10-04 20:11:00,29e8f1140abd1abfcd30d93b83bdffab,0,15,2,1,2,20
1101,1702,2022-10-04 20:17:00,c292b87af4bf686923b680a5c0fcf83e,0,18,0,0,1,19
1102,1702,2022-10-04 20:21:00,2e3ada302ae0f80bda89be7faa2bd378,0,18,0,0,0,18
1103,1702,2022-10-04 20:26:00,2461331044fb596678f904e39d4c560b,0,18,1,1,1,21
1104,1702,2022-10-04 20:31:00,1ce9a72b622eb9693d7ace426a2ba8a8,0,13,0,0,1,14
1105,1702,2022-10-04 20:37:00,471f0168f8828aa851c7d3e59afa4eda,0,24,0,0,2,26
1106,1702,2022-10-04 20:41:00,6d99d51ae16cd25d7cd12f5b135f8e93,0,10,0,0,0,10
1107,1702,2022-10-04 20:46:00,32133622013aafa74d5eacedeeed68e6,0,16,2,2,1,21
1108,1702,2022-10-04 20:51:00,c9ff094670f89abb2707044b5ed2fee5,0,24,0,0,0,24
1109,1702,2022-10-04 20:56:00,c1d620a8e66b8f71e0ad137f79686f94,1,19,0,0,1,21
1110,1702,2022-10-04 21:02:00,4a01db6aeb2c77033316734f4a08f4a2,0,17,4,0,1,22
1111,1702,2022-10-04 21:07:00,f28dce755b1552795f81bb12fe2e9534,0,22,0,0,0,22
1112,1702,2022-10-04 21:11:00,7adecc4278093ee1b15f5c67b22a0293,0,17,0,0,1,18
1113,1702,2022-10-04 21:17:00,2e58db6e47824e450ab6d920c73fa6a1,0,19,0,0,1,20
1114,1702,2022-10-04 21:21:00,3a8a61c6a0625d428b0c180a3093bf6f,0,12,0,1,0,13
1115,1702,2022-10-04 21:26:00,cd8d5cff4ccf8d69e14e78251cd08466,0,16,3,0,1,20
1116,1702,2022-10-04 21:31:00,9e2d6d0954d207b2bcd87d3560a90f69,0,12,0,0,1,13
1117,1702,2022-10-04 21:36:00,0bbd5e6c749f1a05eb5f42edac831a12,0,12,1,0,2,15
1118,1702,2022-10-04 21:41:00,8b5498061da97c7995cbfdfedc741a31,0,14,0,0,0,14
1119,1702,2022-10-04 21:47:00,548ce894f73e32187913e2af8391e19f,0,19,0,0,0,19
1120,1702,2022-10-04 21:52:00,61706433ce67109e8ad347c1f2180624,0,16,2,0,2,20
1121,1702,2022-10-04 21:57:00,415440dd6e01091a2ce4a077b091042b,0,16,0,0,0,16
1122,1702,2022-10-04 22:02:00,2e5248834c31f5896e7c80d854d51d7c,0,14,0,0,0,14
1123,1702,2022-10-04 22:08:00,cbe797db9e3d7b8b141166c56aeb8b21,0,16,1,0,0,17
1124,1702,2022-10-04 22:12:00,719ffb4d5806de2051149a152ffe673a,0,3,0,0,2,5
1125,1702,2022-10-04 22:16:00,8d8a98d01390fd1350f6efd706b40197,0,15,0,0,2,17
1126,1702,2022-10-04 22:22:00,78066a2730783519a68fa58c45d1be13,0,17,0,0,0,17
1127,1702,2022-10-04 22:26:00,2a369a91bac04315f0bd666c4915db29,0,22,1,0,1,24
1128,1702,2022-10-04 22:31:00,6ff722b0518a43f25b7614ca14bd1544,0,21,0,0,0,21
1129,1702,2022-10-04 22:37:00,7591c160dfb3393dc577b01a9c0dcaef,0,14,1,0,2,17
1130,1702,2022-10-04 22:41:00,172bb0e7ee85cdb8cb67f36a112e6db5,0,13,0,0,0,13
1131,1702,2022-10-04 22:47:00,bb48fd9f8f8bcb9f383a4eb4666f03df,0,14,0,1,0,15
1132,1702,2022-10-04 22:52:00,3c3a308625b4f4a304fa016391eb0546,0,11,0,0,2,13
1133,1702,2022-10-04 22:57:00,faae302146111322c68cb921e91f679d,0,8,0,1,1,10
1134,1702,2022-10-04 23:02:00,5e7ef9a936965944be1e8cf4913b45a9,0,7,0,0,0,7
1135,1702,2022-10-04 23:07:00,7bb9d9182ff5f93aa52f24e0c78837ef,0,13,0,0,1,14
1136,1702,2022-10-04 23:12:00,64ed54b3e28e74e8f403d8ff9da19425,0,10,0,0,0,10
1137,1702,2022-10-04 23:17:00,15ffc316c61d3d979969f33a4fdee1c7,0,17,0,0,3,20
1138,1702,2022-10-04 23:22:00,ded26f8085dd0b3d4711d39969817415,0,10,0,1,0,11
1139,1702,2022-10-04 23:27:00,561ef57847d8796e20f6a97bb091059b,0,8,0,0,0,8
1140,1702,2022-10-04 23:32:00,63fe91d809a522cd3f3631ab48e8ec7d,0,6,0,0,0,6
1141,1702,2022-10-04 23:37:00,c453ddd516a96927d66b1bff3bc080ac,0,12,0,0,0,12
1142,1702,2022-10-04 23:42:00,d0aae5bca05fc38024dac3f0663ec82b,0,12,0,0,1,13
1143,1702,2022-10-04 23:47:00,2535cd4773d9869714b23442db7573cb,0,10,0,1,1,12
1144,1702,2022-10-04 23:52:00,17143e4a7945b68e38d8d3395def77f9,0,13,0,0,2,15
1145,1702,2022-10-05 00:02:00,f3ea17168d82a9b1ef00479254f75078,0,9,0,0,0,9
1146,1702,2022-10-05 00:08:00,776e0a1278b9e1362813296c97b6d411,0,7,0,0,3,10
1147,1702,2022-10-05 00:11:00,12fde83d417e01ab27cda5f2dd360a48,0,14,0,0,0,14
1148,1702,2022-10-05 00:17:00,e59693525f7a5e172743cc6a875d57a6,0,3,0,0,0,3
1149,1702,2022-10-05 00:21:00,d0f2a471474aad7581796ca22a803e3b,0,8,2,1,0,11
1150,1702,2022-10-05 00:26:00,5ae2559d6f58e6f3aa4ad3b0377e8197,0,14,2,0,0,16
1151,1702,2022-10-05 00:32:00,a22ce177ac01fbf77aae61a88135a20d,0,6,0,0,0,6
1152,1702,2022-10-05 00:36:00,ca04b7d90769dbe71c7b359a4a6c69b5,0,13,0,0,0,13
1153,1702,2022-10-05 00:41:00,6339c2828133907eedb892b922d898d4,0,6,0,0,1,7
1154,1702,2022-10-05 00:47:00,29b5486316c42b32fcc7490f06b67f53,0,5,2,0,2,9
1155,1702,2022-10-05 00:52:00,b60364b517d44801001620e296efc967,0,8,0,0,0,8
1156,1702,2022-10-05 00:56:00,f41e8fe4d24f7e96c0619dab591d30fe,0,7,0,0,0,7
1157,1702,2022-10-05 01:01:00,7b7cad56acca731b3b7450b18da98178,0,2,0,0,1,3
1158,1702,2022-10-05 01:06:00,6b0b7d967542b8fb53bfcde0ea4b14fc,0,12,1,1,1,15
1159,1702,2022-10-05 01:12:00,97937673e864005fa116ff6d83096bbf,0,11,1,0,1,13
1160,1702,2022-10-05 01:17:00,914da00850eb07c3a6a6803f31116ab9,0,2,0,0,0,2
1161,1702,2022-10-05 01:22:00,21a0b4b2ec0089989e4cc09019e893c9,0,12,0,1,1,14
1162,1702,2022-10-05 01:27:00,ef747d4de0c6af9d48eaa968df0183fa,0,10,0,0,0,10
1163,1702,2022-10-05 01:31:00,22fcb8d002e0a322cb4936fbcceb5aa6,0,5,0,0,0,5
1164,1702,2022-10-05 01:37:00,47f5c7533a5cdad7d97d9f17c87dcb5a,0,6,1,0,0,7
1165,1702,2022-10-05 01:41:00,15f544c31f399b3a0cea04663bd2f8b3,0,4,1,0,0,5
1166,1702,2022-10-05 01:47:00,fe41dc7878709a0e445a3a0dc8f7aa46,0,9,0,2,0,11
1167,1702,2022-10-05 01:51:00,cd9fb4d20e5ec2ba56b83648cb35ab1e,0,5,0,1,1,7
1168,1702,2022-10-05 01:56:00,602f2e58981c4f6216f3f305bea648dd,0,3,0,0,0,3
1169,1702,2022-10-05 02:02:00,f82e031cc363448b6f2129085010e3a8,0,11,0,0,1,12
1170,1702,2022-10-05 02:06:00,017215056d7d70aae603092dce353bc3,0,5,1,0,0,6
1171,1702,2022-10-05 02:12:00,11720faaa0ac61c5b13f1a65993a23c5,0,4,0,0,0,4
1172,1702,2022-10-05 02:17:00,99e2e595a6eb8d15e64ae97f07a58d3d,0,6,0,0,0,6
1173,1702,2022-10-05 02:21:00,112c93e38aadf1eb77c7ca9c89a139d2,0,5,0,0,0,5
1174,1702,2022-10-05 02:27:00,2f1241b82424cef535088dcf9801efa0,0,6,0,0,0,6
1175,1702,2022-10-05 02:31:00,a4ef73ddb78aea932282b5b07830a48a,0,5,0,0,0,5
1176,1702,2022-10-05 02:36:00,2f642bd8f0587b26de165e42c176fe75,0,1,0,0,1,2
1177,1702,2022-10-05 02:41:00,91922b9ab7931ecf52a67bc132966187,0,7,1,0,0,8
1178,1702,2022-10-05 02:46:00,c75a200176fb9d379c38043f31c1e5d7,0,7,1,0,0,8
1179,1702,2022-10-05 02:52:00,e502bffd508eadbfd8790e5f37594e80,0,6,0,0,2,8
1180,1702,2022-10-05 02:57:00,42a72acf33fd8fa82fd9fbd0bf47ccba,0,8,0,0,0,8
1181,1702,2022-10-05 03:02:00,84137bebb4aa4b249b457a91fc311768,0,1,0,0,0,1
1182,1702,2022-10-05 03:06:00,0d0a6b217ffb7e5cb06d8116c277ca37,0,2,1,0,0,3
1183,1702,2022-10-05 03:11:00,e874bfae82c6eff05b3e47b04ca99ae7,0,8,1,0,0,9
1184,1702,2022-10-05 03:16:00,539fb1a6c8d325291022348dce5f06a8,0,4,0,0,0,4
1185,1702,2022-10-05 03:21:00,0c67907b406bcfeb954109da93e7643f,0,7,0,0,1,8
1186,1702,2022-10-05 03:26:00,3847ca2459a4d30d36106f94f6d65f56,0,10,0,0,2,12
1187,1702,2022-10-05 03:31:00,44f049f5fd9165d30b635077b46e082b,0,7,0,0,0,7
1188,1702,2022-10-05 03:37:00,bc3703288625cd25c5744dd1ebc4ce63,0,5,0,0,0,5
1189,1702,2022-10-05 03:42:00,b222a76ada22c033c0412ea9acf6eb67,0,3,0,0,0,3
1190,1702,2022-10-05 03:47:00,18dbce11ba196caf0f87bd6bcbc7a434,0,6,1,0,0,7
1191,1702,2022-10-05 03:51:00,36706d2d71554e783a76d5212ddb8e57,0,5,0,0,1,6
1192,1702,2022-10-05 03:57:00,c7a6c2603f4d6405c459a849aaf78597,0,1,0,0,0,1
1193,1702,2022-10-05 04:02:00,b017b58f76440d7821c4bffa5d369d92,0,7,0,0,0,7
1194,1702,2022-10-05 04:06:00,7626d01599b2e75b3dc93a5050f366d6,0,8,0,0,1,9
1195,1702,2022-10-05 04:11:00,0c81a8f3bea425188cf2dc36a8d3a047,0,8,1,0,1,10
1196,1702,2022-10-05 04:16:00,36f0c479f529f1743878a9a91f85737d,0,4,0,0,0,4
1197,1702,2022-10-05 04:20:00,06220f7cdeb0457ce33338eb3d4f5d98,0,7,0,0,1,8
1198,1702,2022-10-05 04:26:00,5fa0ed5412bc249232cc773f6f472d3d,0,3,0,0,0,3
1199,1702,2022-10-05 04:31:00,eff91b949b0bcf4ed11652192d3f3087,0,4,0,0,0,4
1200,1702,2022-10-05 04:36:00,228ecd37c014dd09d0606fb795c743bd,0,6,0,0,1,7
1201,1702,2022-10-05 04:41:00,e32e629c1689077a2e017131d0cd8881,0,7,0,0,0,7
1202,1702,2022-10-05 04:46:00,938f4a50d1954fe6ed5b82b2ce9ec204,0,1,0,0,0,1
1203,1702,2022-10-05 04:51:00,dcda1419b28955d8cbc5ce0116c97d48,0,2,2,0,0,4
1204,1702,2022-10-05 04:56:00,e348a17d0b4b04e1ccc2d43d53d7c207,0,10,0,0,0,10
1205,1702,2022-10-05 05:01:00,89f2b6725dcb5cee76a4378a9666c1ca,0,8,0,0,0,8
1206,1702,2022-10-05 05:06:00,bbf28bd38d83503248a90342aecd310b,0,7,0,0,0,7
1207,1702,2022-10-05 05:11:00,c805253c9633f7c6d33c3ea55879f91b,0,9,0,0,1,10
1208,1702,2022-10-05 05:17:00,ec39187e9da9e68d3d07f420c03cba8e,0,7,0,0,0,7
1209,1702,2022-10-05 05:22:00,0f09dd5362ea7e5440ae560c2b63e8fc,0,1,0,0,1,2
1210,1702,2022-10-05 05:27:00,248af7f071a419b3831a9f2b0025ef94,0,6,0,0,0,6
1211,1702,2022-10-05 05:31:00,5e2a9b60dab312f43ca816dd0bbf52f2,0,5,0,1,1,7
1212,1702,2022-10-05 05:37:00,4e29220f1709cb887eccaed394950329,0,8,1,0,0,9
1213,1702,2022-10-05 05:42:00,245be06a521beda39f2353adb5c11240,0,7,0,1,1,9
1214,1702,2022-10-05 05:48:00,684cf692ac62cad732d96e62a774b7ae,0,7,0,0,0,7
1215,1702,2022-10-05 05:53:00,3c85e072b1dec28435531a18139e20c5,0,1,0,1,0,2
1216,1702,2022-10-05 05:56:00,0763fee4e43e4c3562c791c1de88ddd6,0,6,0,1,0,7
1217,1702,2022-10-05 06:03:00,fb2a3a5524f4d3c9c9e3d768d73aeb28,0,8,0,1,0,9
1218,1702,2022-10-05 06:08:00,7fb107d6ed2d0b946ced1c533787ecd4,0,6,0,0,1,7
1219,1702,2022-10-05 06:12:00,4e8ac4db056c0e623237b0af75c08991,0,4,1,0,3,8
1220,1702,2022-10-05 06:18:00,e09bba6d586ec17bf9ebe77c997b1191,0,3,0,0,2,5
1221,1702,2022-10-05 06:23:00,139ef0738e31831cefd5ce055f17ad78,0,8,0,2,0,10
1222,1702,2022-10-05 06:26:00,2ede058ad8bb1a6476a246b87d58a421,0,5,0,0,0,5
1223,1702,2022-10-05 06:32:00,2b7a1e955bbcf6815fef81693cb68bd3,0,8,0,0,0,8
1224,1702,2022-10-05 06:38:00,755b7808fe8c39602610c86dfde50f06,0,5,1,0,0,6
1225,1702,2022-10-05 06:42:00,eac9320c7fce483dc2f757b14dd94d76,0,14,0,0,0,14
1226,1702,2022-10-05 06:47:00,e34556d9aade813d286f467f9eed175a,0,10,3,1,0,14
1227,1702,2022-10-05 06:51:00,bf6ae24cfbe1917e4e8784ebff1fe3dd,0,7,3,0,1,11
1228,1702,2022-10-05 06:56:00,1443cec28ea4c456255f650086db7db9,0,6,0,0,0,6
1229,1702,2022-10-05 07:02:00,b26ca6e271a3236abaff2400532ecfc8,0,5,0,0,0,5
1230,1702,2022-10-05 07:07:00,c15e276836b4109dc347d3fc34ff9b71,0,7,0,0,0,7
1231,1702,2022-10-05 07:11:00,a4fb3474abffc5849dff40ce67ee727c,0,13,0,1,1,15
1232,1702,2022-10-05 07:16:00,8f0823aac34d6f4cadd8dac5dcd03dfe,0,10,0,1,0,11
1233,1702,2022-10-05 07:22:00,579484c8904d0503657e72379688f0d5,0,11,1,1,0,13
1234,1702,2022-10-05 07:27:00,007ef35d1a663f6185646539658ea310,0,11,0,2,0,13
1235,1702,2022-10-05 07:31:00,64c70ee7aa36d923691cf7cba8420aef,0,21,0,0,0,21
1236,1702,2022-10-05 07:37:00,304bc62e67cc6ff6ae00ef89bc409030,1,19,0,1,2,23
1237,1702,2022-10-05 07:42:00,07d4236d075b04628d71fd92904771d4,0,20,0,2,2,24
1238,1702,2022-10-05 07:47:00,e67af2d52eab2e2467c38d8a2a4d591a,0,19,0,1,1,21
1239,1702,2022-10-05 07:51:00,6298cbbcf49cf8bd62d8c303e40de065,0,13,0,0,2,15
1240,1702,2022-10-05 07:57:00,5d616b52ec40bf657edd2fcd8d69b4f0,0,13,0,3,3,19
1241,1702,2022-10-05 08:03:00,27c226892e7664fabf1aa76610c26ef9,0,25,0,0,1,26
1242,1702,2022-10-05 08:07:00,afa71a16bf7e93ee0e14bf38dfb906dd,0,23,0,3,1,27
1243,1702,2022-10-05 08:11:00,7705cbf9d90ef03e79285941fa75221b,1,25,0,1,0,27
1244,1702,2022-10-05 08:17:00,42b825d1bdc0605662fed43487b2ba06,2,18,0,4,2,26
1245,1702,2022-10-05 08:22:00,b33ac8e4bad1b4e60671964b56dcd068,0,19,0,5,1,25
1246,1702,2022-10-05 08:27:00,cf637c338363128d9eb71837b3a054d7,0,17,0,2,2,21
1247,1702,2022-10-05 08:33:00,a6154534d597e6fa0c22b152cd9c45cf,0,34,0,1,2,37
1248,1702,2022-10-05 08:36:00,12516773cf9448a8f7a5a17aa75aecb8,0,30,0,4,2,36
1249,1702,2022-10-05 08:42:00,61cbb6154036a734d15a8c4285351edd,0,23,0,9,3,35
1250,1702,2022-10-05 08:47:00,90217e0a96dce986cc4c09a6c467567e,1,23,0,4,5,33
1251,1702,2022-10-05 08:53:00,4de7f8e8a0cedf12b3f12cbb7124a56f,1,21,0,5,6,33
1252,1702,2022-10-05 08:57:00,4794ff62b7cc59ce2374ec3963744c1f,0,28,0,7,3,38
1253,1702,2022-10-05 09:02:00,f4cbc90edf9406be7d45c8fd7c70a3ac,1,23,0,3,6,33
1254,1702,2022-10-05 09:07:00,b1c3f54412a674955edc7f26121f9d39,0,23,0,6,5,34
1255,1702,2022-10-05 09:11:00,f279a302158b0b95b1481f08c26e50ca,0,23,0,1,4,28
1256,1702,2022-10-05 09:18:00,4a2e856cf344359a82799c17ff44e749,0,22,0,9,1,32
1257,1702,2022-10-05 09:24:00,da7843a7550387845fc2d055ffa234ec,0,21,0,1,7,29
1258,1702,2022-10-05 09:27:00,ddf5ab27c4429dbd3be5d59e4eff3246,0,25,0,3,9,37
1259,1702,2022-10-05 09:33:00,ed03f5821fa5e0de757149435b882279,4,15,2,1,11,33
1260,1702,2022-10-05 09:37:00,adac9c0bd78cdce747e6141782929c49,0,19,0,2,10,31
1261,1702,2022-10-05 09:42:00,e9cc95c2471fb416a292767a705b2aa1,0,17,0,13,7,37
1262,1702,2022-10-05 09:48:00,e71e43b635b2d42be85b973803ab6904,0,17,1,2,13,33
1263,1702,2022-10-05 09:53:00,acf7e1138eab46301df12b57811ec3fc,0,18,0,3,13,34
1264,1702,2022-10-05 09:57:00,ad9b21ae026358789a226753b469916a,1,13,0,3,12,29
1265,1702,2022-10-05 10:02:00,40fcd9d76056ceebcd9b16953cf238fb,0,14,0,3,6,23
1266,1702,2022-10-05 10:07:00,dbcf82f2d1ca432f29a7c064a119b732,0,20,0,4,15,39
1267,1702,2022-10-05 10:13:00,a7e6f7877fca5e133b5fd81db3a7847f,0,9,0,1,9,19
1268,1702,2022-10-05 10:17:00,622cb788ccd957c9530e366898c63043,0,26,0,4,13,43
1269,1702,2022-10-05 10:23:00,8ed16d489a010e4daa3e9e641f70432c,0,12,0,2,19,33
1270,1702,2022-10-05 10:28:00,7ff374372189997194613d2a0fc27023,0,17,0,0,15,32
1271,1702,2022-10-05 10:33:00,7928108db63f71f6a9daf9d35784cd9a,1,19,0,1,8,29
1272,1702,2022-10-05 10:38:00,9d7d7ff8d8b6e6928025897bc924e2e4,0,17,0,3,15,35
1273,1702,2022-10-05 10:43:00,f5b6e797e9bd23ede11d86768d9ff640,0,12,0,1,12,25
1274,1702,2022-10-05 10:49:00,451afadd36a810745ff029bd1d0a6c0c,0,19,0,2,14,35
1275,1702,2022-10-05 10:53:00,66c93b024c03c60e65bc7fa36d5905d5,0,16,0,0,14,30
1276,1702,2022-10-05 10:57:00,2cfaaae056a3548506810635b8956724,0,23,0,10,11,44
1277,1702,2022-10-05 11:03:00,59f3b7d3b17456bdcb540dd7ba94794a,0,13,0,10,12,35
1278,1702,2022-10-05 11:09:00,cff3a3b8b8b0725881cda2535f88cb1b,0,19,0,2,13,34
1279,1702,2022-10-05 11:13:00,806573b699f7251aa7dc8244b57738ea,0,17,0,4,11,32
1280,1702,2022-10-05 11:18:00,ac0c24896cd1bba2cec13e5316988a79,0,18,0,4,8,30
1281,1702,2022-10-05 11:23:00,68dcf848131aea4669c203e96d62ce63,0,16,0,3,9,28
1282,1702,2022-10-05 11:27:00,0bf2dded4de8fe2d7d331753ac3885a3,0,16,0,1,11,28
1283,1702,2022-10-05 11:33:00,c2a1979ebdb4a7f63f40d5793ffc58e4,0,16,0,1,9,26
1284,1702,2022-10-05 11:37:00,b881350b4b474931c6987bbd2ea9fbf4,1,12,0,4,9,26
1285,1702,2022-10-05 11:42:00,991236d4c01cfa62c3706ec7361bdeae,0,12,0,0,12,24
1286,1702,2022-10-05 11:48:00,976f9eeb15b6cc097806257e2d930ac3,0,17,0,2,8,27
1287,1702,2022-10-05 11:53:00,a509809bb39091a1fc0d46b74bfe4368,0,16,0,2,12,30
1288,1702,2022-10-05 11:58:00,988030c4995c293d12de2907086f469b,0,12,1,2,9,24
1289,1702,2022-10-05 12:02:00,206b4c67cf5ba73fc103d0974651eba5,0,18,0,2,9,29
1290,1702,2022-10-05 12:07:00,b904d6fa5ecfbf60d533a4fdd3b673a3,2,13,0,2,7,24
1291,1702,2022-10-05 12:13:00,1a864e2bf7bab8b09fb9d6eadd729a52,0,11,0,2,9,22
1292,1702,2022-10-05 12:18:00,589a6044626ea015189daca2230f2efe,2,14,0,5,6,27
1293,1702,2022-10-05 12:24:00,21b76307619ce6df53cafc36dff1e572,0,6,0,3,10,19
1294,1702,2022-10-05 12:28:00,c7420debe758b58f0dd2b0feef6b35be,0,9,0,1,7,17
1295,1702,2022-10-05 12:32:00,a50e7b0ea96691eefa96dc8c718f2f0c,0,14,0,0,7,21
1296,1702,2022-10-05 12:38:00,30ad791efdacd7a8d535eaabf23377a0,0,12,0,4,8,24
1297,1702,2022-10-05 12:43:00,fce1e1b9f70e7e312f3657c9157e00d8,0,13,0,0,8,21
1298,1702,2022-10-05 12:48:00,2657d5d79a0a50deb659fba55d0bd4a5,0,11,0,5,10,26
1299,1702,2022-10-05 12:58:00,a2d61644ff73144b73ddfe063d761546,0,9,0,2,15,26
1300,1702,2022-10-05 13:03:00,8e15e713d605a23b059d1f66f6d2b2d4,0,13,0,2,11,26
1301,1702,2022-10-05 13:09:00,3f7c5235ca3cd87190d989c6866b743f,0,10,0,1,19,30
1302,1702,2022-10-05 13:12:00,1d2f3008b2cad2aeb1d1a56d51e6de19,0,13,0,3,8,24
1303,1702,2022-10-05 13:18:00,dc888e88204ee5c4e87acb21e16a034d,0,9,0,3,9,21
1304,1702,2022-10-05 13:22:00,71f81ce29ce90aeab60aafe53e3ff121,0,15,0,2,12,29
1305,1702,2022-10-05 13:28:00,fdc57e5051a77074ad73b9506c3d1c37,0,13,0,4,14,31
1306,1702,2022-10-05 13:32:00,e77eb9a022de47d9832ad77f8691600a,0,11,0,2,10,23
1307,1702,2022-10-05 13:39:00,f87f1a92083c55b376393d457f50aeab,0,17,0,6,7,30
1308,1702,2022-10-05 13:43:00,0be7a42210ddf7e3d2e52de9f188dd39,0,9,0,6,10,25
1309,1702,2022-10-05 13:49:00,1d2888f287145635c8c1f326d0709ef6,0,13,0,5,13,31
1310,1702,2022-10-05 13:53:00,0592b1bc82c94669e6b18ab0210e8b80,0,12,0,6,9,27
1311,1702,2022-10-05 13:58:00,a6b5a295bc707460c50f7c157242e140,0,6,0,8,18,32
1312,1702,2022-10-05 14:04:00,8fa4c9692f2f92712db3fa15f483911c,1,14,0,2,9,26
1313,1702,2022-10-05 14:08:00,3a3c86f7902cacbf8831eacb93c05e29,1,13,0,3,13,30
1314,1702,2022-10-05 14:14:00,e0f98d7075fe7afa9d3748b20f9a22aa,0,12,0,1,10,23
1315,1702,2022-10-05 14:19:00,da0bc32b2c94627a56509251a84af832,0,15,0,0,9,24
1316,1702,2022-10-05 14:23:00,c4b1bb7af9b3552332d433b56d881b10,2,14,0,1,10,27
1317,1702,2022-10-05 14:27:00,1389e6b56ebb89f71742701bea64eb29,0,15,2,2,6,25
1318,1702,2022-10-05 14:34:00,d810bc8e34809909abb3e98ffb98604a,0,14,0,4,10,28
1319,1702,2022-10-05 14:39:00,6d1e2467ea195620448c101ebb53443c,0,14,1,6,7,28
1320,1702,2022-10-05 14:42:00,707f8ebeb777f1fd864f0bd78170e58a,0,16,1,2,11,30
1321,1702,2022-10-05 14:47:00,3022d4f495dbf6c0d1091604e9dfce6d,0,11,1,2,17,31
1322,1702,2022-10-05 14:53:00,b821cbfddb23d3debb6c64550e668b14,0,11,0,2,13,26
1323,1702,2022-10-05 14:58:00,d3445c99b25a60b00bd854e860e4fd77,0,13,0,1,10,24
1324,1702,2022-10-05 15:03:00,f6784d6f54b330f8c57053ec4bb004f3,0,12,1,2,11,26
1325,1702,2022-10-05 15:07:00,dc0877b9faeb617027f2d3e38592dfcf,0,16,5,2,9,32
1326,1702,2022-10-05 15:13:00,a07ca43684d0d448c31fcda525330f70,0,10,0,6,9,25
1327,1702,2022-10-05 15:18:00,b446d3138c7fab8f2ed21c5d7112460d,0,13,1,1,11,26
1328,1702,2022-10-05 15:23:00,bb03541a1d2b61d0a547c74130d6a55d,0,14,0,2,6,22
1329,1702,2022-10-05 15:27:00,d169c05abdaaf6e277c30548af0559ab,0,11,0,9,5,25
1330,1702,2022-10-05 15:32:00,0dad35be670a14689f164c5e43207d52,0,11,1,3,5,20
1331,1702,2022-10-05 15:37:00,09704ed1d4249e7d25608be5081684f6,0,11,0,1,16,28
1332,1702,2022-10-05 15:42:00,794c2ce3fa907ea6f2753214d26d5a89,1,11,0,3,13,28
1333,1702,2022-10-05 15:48:00,d62b8c0f2eba7a27da082f3388c6e112,1,8,0,1,14,24
1334,1702,2022-10-05 15:53:00,cfbc7697be68cb8026935738c0b07502,0,12,0,3,10,25
1335,1702,2022-10-05 15:58:00,1167f59bc1bd22375f989a6fc23425c4,0,11,1,0,12,24
1336,1702,2022-10-05 16:02:00,a9fd66bb96ca646321d397c0dadcfd38,0,14,0,4,5,23
1337,1702,2022-10-05 16:08:00,655becd29fb7f641a3f355ea29b1184a,0,13,0,3,9,25
1338,1702,2022-10-05 16:12:00,9a620953483602b5c9e54a3c02f7c25e,0,10,0,4,8,22
1339,1702,2022-10-05 16:18:00,892ab2543c83fc25284d82b106db1fe8,0,17,1,1,6,25
1340,1702,2022-10-05 16:24:00,736bb26a6b90fd1f67b462753f6c6232,0,16,0,5,3,24
1341,1702,2022-10-05 16:26:00,13fa639bcf78f20fddb29d33adfed994,0,14,0,3,9,26
1342,1702,2022-10-05 16:33:00,d8f00435c247d4a4eefb32f24acfe665,0,12,0,5,12,29
1343,1702,2022-10-05 16:38:00,809ea2a19531021f6b7fc723503a9880,0,13,0,3,8,24
1344,1702,2022-10-05 16:43:00,fe5584c4256c6f8a379467306ead2d20,0,17,0,2,9,28
1345,1702,2022-10-05 16:48:00,844e72691637a3cedfb4e03b3a03d826,0,10,1,3,12,26
1346,1702,2022-10-05 16:53:00,c7784d3636485ac446a8d8380b869a67,6,13,0,2,9,30
1347,1702,2022-10-05 16:58:00,6f296298469c3d7efb2575c1278cbc08,0,8,0,2,11,21
1348,1702,2022-10-05 17:03:00,b7ff92ced31b28b279bdcba203fd801f,0,16,1,1,13,31
1349,1702,2022-10-05 17:08:00,38941d3f29b4dd7728f2862a1e39da7c,0,13,0,3,12,28
1350,1702,2022-10-05 17:12:00,1be546299abedaee421c1046294f3cec,0,20,0,3,17,40
1351,1702,2022-10-05 17:18:00,638980962cdf499c512fab22e6171240,1,18,1,4,11,35
1352,1702,2022-10-05 17:22:00,a0130077c5887debef6ca1b67c4d7d81,0,22,0,2,4,28
1353,1702,2022-10-05 17:28:00,31393f6a987afc85864adc052e2985f2,0,13,0,4,15,32
1354,1702,2022-10-05 17:32:00,3d4a22eaec59fb0dc693cfd0c02ad6ad,0,14,0,0,13,27
1355,1702,2022-10-05 17:38:00,0c455c27cc5a1b86f8a5303805e1716d,0,16,0,9,9,34
1356,1702,2022-10-05 17:44:00,d9553c7caa80414ff7b7bb4d7a1034df,0,18,1,5,9,33
1357,1702,2022-10-05 17:48:00,260e3b5a55adeeecee3c930a688aa15b,0,19,1,4,13,37
1358,1702,2022-10-05 17:53:00,12f3ef68261bed5ea6a8edab496812ac,0,19,0,1,12,32
1359,1702,2022-10-05 17:57:00,476a40d4d6d4655606fe8ab33680d335,0,17,0,2,13,32
1360,1702,2022-10-05 18:02:00,5dee66e2252f8cff45c95aed2c96770e,0,13,0,5,11,29
1361,1702,2022-10-05 18:08:00,3ff19c2de6a696015a9709cbcfc4cece,1,15,0,0,11,27
1362,1702,2022-10-05 18:12:00,cdff32096fae23724c40c57dfee9b031,0,19,1,7,6,33
1363,1702,2022-10-05 18:18:00,c2a8e10209751f29243b3daa1db7cf9b,1,13,0,4,11,29
1364,1702,2022-10-05 18:23:00,9b9632d682790fa4b3128775a924382d,0,16,0,1,13,30
1365,1702,2022-10-05 18:27:00,3e0a090cdffe276500104a0cff7f4332,0,18,1,1,13,33
1366,1702,2022-10-05 18:33:00,7c9f7d2ad084a311a2a0911c9bf5c64c,0,20,1,3,7,31
1367,1702,2022-10-05 18:37:00,6ac36e1cb764ebfac00553b56178e56f,4,16,1,5,9,35
1368,1702,2022-10-05 18:43:00,ee7baa4043f4645ff63c970360a2231e,0,19,0,0,7,26
1369,1702,2022-10-05 18:49:00,7f2a027d53b0c3f6bfe7ab0611097689,0,21,1,3,6,31
1370,1702,2022-10-05 18:53:00,2be836cdad03158c585f738d126741b0,0,25,0,0,6,31
1371,1702,2022-10-05 18:57:00,b04c54014ac47cd04dd5b2b927f03162,0,17,1,1,8,27
1372,1702,2022-10-05 19:03:00,6de87902de36eaa1f8d0383aeb334fa1,0,21,0,2,6,29
1373,1702,2022-10-05 19:07:00,7ac8b1b961502606da2619b532a92116,0,29,2,1,1,33
1374,1702,2022-10-05 19:12:00,878f035d0a05c26fc5b2db109ad13775,0,16,1,0,0,17
1375,1702,2022-10-05 19:17:00,78ca0396396404081fe98138003ea762,0,25,1,0,1,27
1376,1702,2022-10-05 19:22:00,f5d3449bd0b2d145dfc8d901e8c7530e,0,17,1,2,0,20
1377,1702,2022-10-05 19:27:00,b3c0944cdf507092109102aa0d9d8948,0,21,3,0,1,25
1378,1702,2022-10-05 19:33:00,bc7c8623e8d80be6f723eebb118d46d1,0,20,1,0,2,23
1379,1702,2022-10-05 19:38:00,249292f073ef2a016432af31caef53d0,0,21,2,0,1,24
1380,1702,2022-10-05 19:42:00,61d15024ce33908ca518a53a8c0a94ce,2,16,1,2,1,22
1381,1702,2022-10-05 19:47:00,0dd8f269478b73e303d4381db9f7e164,1,25,1,0,3,30
1382,1702,2022-10-05 19:53:00,6ec20f7c4332663814d6a4def077ed3d,0,25,2,0,2,29
1383,1702,2022-10-05 19:57:00,c494cff7dd77d2fd987ae570c9b3fac3,0,22,1,2,2,27
1384,1702,2022-10-05 20:02:00,4a4b0249b26a435631badae68432108e,0,11,0,2,1,14
1385,1702,2022-10-05 20:07:00,aa5890c24744646b735a454d1656de3a,0,14,0,1,1,16
1386,1702,2022-10-05 20:12:00,97784f38e1cfa1d5a275e388ab2c8073,0,11,3,1,1,16
1387,1702,2022-10-05 20:18:00,69cae5f225abe2c79f44c5e96694c21e,1,23,0,0,3,27
1388,1702,2022-10-05 20:23:00,bee6acb3a0f9a6b4a176e68294d3446f,0,18,0,1,0,19
1389,1702,2022-10-05 20:26:00,0d5586957ccb6106250655fa600570ac,0,15,0,1,0,16
1390,1702,2022-10-05 20:32:00,07a1715c3f6ba83763230ead186c3559,1,15,2,0,0,18
1391,1702,2022-10-05 20:38:00,3a12136b20ff78bae437f26a7c4ad16d,0,17,0,1,1,19
1392,1702,2022-10-05 20:42:00,7cca478bada9e70f180cc7d2cdffa3f0,0,14,0,2,0,16
1393,1702,2022-10-05 20:48:00,e83c2062adcbc5c307d8400846ab0d29,0,22,0,1,1,24
1394,1702,2022-10-05 20:53:00,5b7bdf2232a39f2eed048ad4dfe1ba3e,1,17,0,0,0,18
1395,1702,2022-10-05 20:57:00,959fdd8b2bdd331824d08489be95f70f,0,20,0,0,1,21
1396,1702,2022-10-05 21:02:00,ee8355a2dba0d57f50942fdc04f87c6b,0,17,0,0,1,18
1397,1702,2022-10-05 21:07:00,f969898d28f381810d3398bd51e2d963,0,17,0,0,1,18
1398,1702,2022-10-05 21:12:00,e3d2df973c991a72b0708f6da0a5aeb4,0,18,2,0,1,21
1399,1702,2022-10-05 21:18:00,212c8e547300fd9a41771cc61dac7ee2,0,20,0,0,1,21
1400,1702,2022-10-05 21:23:00,2f0555581ac5c450267967d50c0c53c4,0,16,3,1,2,22
1401,1702,2022-10-05 21:27:00,6549634463e024a559df615e0650f5b5,0,18,2,0,1,21
1402,1702,2022-10-05 21:33:00,093cca6c8f561f0a9d777cdb7f46a5cb,0,17,0,2,0,19
1403,1702,2022-10-05 21:38:00,5b442f0e5b12acbcc12c543e56ed0970,0,28,0,1,1,30
1404,1702,2022-10-05 21:42:00,3fc7e27abb0c08ff39c7198a6709d330,0,18,0,0,0,18
1405,1702,2022-10-05 21:47:00,8f69bc9d6e8b7a5ad7100f8d4e66e1ee,0,19,1,1,0,21
1406,1702,2022-10-05 21:52:00,2d384ff36e4c4230fb37df7d967824c7,0,23,0,1,0,24
1407,1702,2022-10-05 21:57:00,82db7a6ebbfae18278fbaabc48f545c6,0,15,0,1,1,17
1408,1702,2022-10-05 22:03:00,258ba7c7d726906dd572df93baecb4b4,0,17,1,1,1,20
1409,1702,2022-10-05 22:07:00,8865a773056f051cb3b1a01aa75da622,0,25,0,2,1,28
1410,1702,2022-10-05 22:12:00,3baa3c202891c3d6af929e83c61c41d5,0,11,0,1,0,12
1411,1702,2022-10-05 22:17:00,864137de1c4a10202d80a656c6b72421,0,17,0,0,2,19
1412,1702,2022-10-05 22:22:00,9357db8b6a76759b1e20a1543e152793,0,17,0,2,0,19
1413,1702,2022-10-05 22:26:00,36aaa8427a2b6885f013d20950f82dbb,0,15,0,0,1,16
1414,1702,2022-10-05 22:32:00,57a3c2e237e97bbd77054bc0f1fe6bd4,0,22,0,0,0,22
1415,1702,2022-10-05 22:37:00,34c332738dceb1f426fc62263228224c,0,17,0,1,0,18
1416,1702,2022-10-05 22:41:00,3213262cb686b3d0df1601a81f39c44c,0,13,0,0,2,15
1417,1702,2022-10-05 22:47:00,5328e4e40bb76219a7a076be05f1228b,0,14,0,0,1,15
1418,1702,2022-10-05 22:52:00,82a1ce656de9675ea8aa71d3f17e3497,0,9,0,0,0,9
1419,1702,2022-10-05 22:56:00,e9d608cbe3ff72bec84b9a6db6594fce,0,17,1,0,1,19
1420,1702,2022-10-05 23:01:00,91e50c15086b7874985e6f084ecabe93,0,18,2,0,1,21
1421,1702,2022-10-05 23:07:00,481ff953bbe4b599a9e054423e32233f,0,9,0,1,1,11
1422,1702,2022-10-05 23:12:00,f9d33569431bb277337d6b825a347c4b,0,15,0,0,1,16
1423,1702,2022-10-05 23:17:00,1bcf75dcfeccfc0fc8aeb7dd1e34af28,0,5,0,3,0,8
1424,1702,2022-10-05 23:22:00,f2ab2a84bee5b9dd2df1df57d7c01b0a,0,10,0,0,0,10
1425,1702,2022-10-05 23:27:00,fe9284e45cdbc4bc86bb74b307cc7f9d,0,9,0,1,0,10
1426,1702,2022-10-05 23:32:00,caa2e6f8fcb10effad52592939d665f2,0,6,0,0,0,6
1427,1702,2022-10-05 23:37:00,42d70507d40984ab64114fa54e955385,0,2,0,0,0,2
1428,1702,2022-10-05 23:41:00,221176b0bebefbfe0e588771e99999f8,0,16,0,0,0,16
1429,1702,2022-10-05 23:47:00,e8951bb0cda0d5e37fb8d5f98ca97f60,0,9,0,0,0,9
1430,1702,2022-10-05 23:52:00,670ca5fa1b362d2f1bba95b19b1f7fbb,0,9,1,0,2,12
1431,1702,2022-10-05 23:56:00,6c967db3799e6e9870e38de8ab1c7532,0,3,0,0,1,4
1432,1702,2022-10-06 00:03:00,306f9cabc208dffff1174c5f9c61cc35,0,10,0,0,1,11
1433,1702,2022-10-06 00:08:00,753a6562dcd3dd4599dcb8179ac7080d,0,11,0,3,0,14
1434,1702,2022-10-06 00:11:00,7144a325099625649561bc2b2d94761b,0,5,0,0,1,6
1435,1702,2022-10-06 00:18:00,38da5d88db3ac23685d4143e90831b07,0,8,1,0,0,9
1436,1702,2022-10-06 00:23:00,2116dd4aa2483f858c9bd94b19c9e32f,0,5,0,0,0,5
1437,1702,2022-10-06 00:27:00,ca5f79caf220d2dc538546cccfdd6d8f,0,8,0,1,0,9
1438,1702,2022-10-06 00:32:00,2301cfeda1b8da31cb11ffe7a59874e2,0,9,0,0,1,10
1439,1702,2022-10-06 00:37:00,fea0977e322820a1602f8724ed59ed9f,0,7,1,0,1,9
1440,1702,2022-10-06 00:42:00,3acb40f0c283cd4bddb5268bf388f4b3,0,11,0,0,0,11
1441,1702,2022-10-06 00:47:00,ca9b2bb69553113313fc9c3587d30aac,0,9,0,1,0,10
1442,1702,2022-10-06 00:52:00,04e2a4b8d05d2d9ddc37adc80434f83f,0,6,1,0,0,7
1443,1702,2022-10-06 00:57:00,fcb3f4c2d7d4bc92c1def5462ca2cbe7,0,10,1,1,0,12
1444,1702,2022-10-06 01:02:00,9eef7e336c0a700a591ccb138f019c45,0,8,0,0,0,8
1445,1702,2022-10-06 01:08:00,0241e5e7e5bb2110071b1d02c2174dc1,0,4,0,0,0,4
1446,1702,2022-10-06 01:13:00,e532c4c9b10b598a5a0c7ca235445711,0,9,0,0,1,10
1447,1702,2022-10-06 01:18:00,5bd1991cbf94a0062440f9d5eafe17ae,0,5,0,1,0,6
1448,1702,2022-10-06 01:22:00,eaa481a41c5f37c479e325bf7bc3b569,0,16,0,0,0,16
1449,1702,2022-10-06 01:27:00,26d4a79e06822c4adcdd8931329c45bf,0,10,0,0,1,11
1450,1702,2022-10-06 01:32:00,1ecf9e936ab869ff658e74b3969c0ca1,0,5,1,0,0,6
1451,1702,2022-10-06 01:38:00,79dcbfb5c7fa0215ff050958d28a5908,0,8,0,0,1,9
1452,1702,2022-10-06 01:41:00,bc3d79763625cbd9003b5601c2d67336,0,5,2,0,0,7
1453,1702,2022-10-06 01:46:00,8daf186a8bde987fe04174028731ae3a,0,7,0,0,0,7
1454,1702,2022-10-06 01:52:00,6809f34a52f524a62689d586cd6d4da9,0,11,0,0,0,11
1455,1702,2022-10-06 01:58:00,288031e9abfda6d4158ae911dddfcd99,0,8,0,0,1,9
1456,1702,2022-10-06 02:03:00,d7627c5cd71b89d7ee1d02ecbafbabd8,0,8,0,0,0,8
1457,1702,2022-10-06 02:07:00,45dc17a7edd6ce46bcb2e659cfda8071,0,7,1,0,0,8
1458,1702,2022-10-06 02:12:00,a8d2aa3c78a0fd93ab53f0656efa9da0,0,6,0,0,0,6
1459,1702,2022-10-06 02:17:00,eb47297d8818a2f10d8970918971f45a,0,3,0,0,0,3
1460,1702,2022-10-06 02:22:00,dc50cb5517054ba417d48581fc86d165,0,11,0,0,0,11
1461,1702,2022-10-06 02:27:00,e2992101b93b2b2ab27f773175f7f51d,0,10,0,1,0,11
1462,1702,2022-10-06 02:32:00,74203db9af8cafaf079827a119bb290e,0,10,2,0,0,12
1463,1702,2022-10-06 02:38:00,81b14015e239253ce42935db988f10e7,0,8,0,1,1,10
1464,1702,2022-10-06 02:42:00,93621ea31a497875edf680294615150d,0,10,0,0,0,10
1465,1702,2022-10-06 02:47:00,d655a2e95d02603cd0c600baa31a1116,0,13,1,0,0,14
1466,1702,2022-10-06 02:53:00,9057fdc1028c9c4c6e27b7c20a1f1a7e,0,6,0,0,0,6
1467,1702,2022-10-06 02:56:00,05c1adc291dc40575fad714abef57a34,0,7,0,0,1,8
1468,1702,2022-10-06 03:03:00,36ef6cfb85b26dca08ff0c4c70d8685c,0,6,0,0,0,6
1469,1702,2022-10-06 03:08:00,b64ac22f3af231cbf15861f82fd691c4,0,1,0,0,0,1
1470,1702,2022-10-06 03:12:00,5842742d4a2c31eac6fc67ac31f9114c,0,10,0,0,0,10
1471,1702,2022-10-06 03:18:00,d101c06744a629183a1207768ee95d9b,0,9,0,0,1,10
1472,1702,2022-10-06 03:22:00,71c013dfdd91cfe924922ded1dd2e36a,0,5,0,0,0,5
1473,1702,2022-10-06 03:26:00,e30ae14495095308160194505c8ac57f,0,4,0,0,0,4
1474,1702,2022-10-06 03:33:00,6824b4d53fbe2c16c0aa7eb649b57505,0,7,0,0,0,7
1475,1702,2022-10-06 03:38:00,7a9cdb2ba174ef6066b49cabfdf9ebab,0,5,0,0,1,6
1476,1702,2022-10-06 03:42:00,e45bd4eb5a8fab0cf5d8ed784539fc44,0,8,0,0,0,8
1477,1702,2022-10-06 03:48:00,0a6111fc10f8bc1e5e3589c10367418c,0,4,1,0,0,5
1478,1702,2022-10-06 03:51:00,35f957f0164d11af87a65105ae5f4302,0,9,0,0,1,10
1479,1702,2022-10-06 03:57:00,40cbd3b109f49d0cb7028839cb4f4eac,0,0,0,0,1,1
1480,1702,2022-10-06 04:01:00,a1f8bc43b6fe9110f0d87483bc93c4cc,0,9,0,0,1,10
1481,1702,2022-10-06 04:08:00,15ddf8dced0bf1ff788b5bf4254dc4f5,0,1,0,0,0,1
1482,1702,2022-10-06 04:13:00,16ee12b48198d7770f1751197fc0aa52,0,3,0,0,0,3
1483,1702,2022-10-06 04:17:00,a7d291b14d7546c0d5364e9d54721e29,0,2,0,0,0,2
1484,1702,2022-10-06 04:22:00,a1d654a4f3c11941def77911135d10fc,0,7,0,0,0,7
1485,1702,2022-10-06 04:26:00,d02109a039de0b3a411402a9e7e838fd,0,6,0,0,0,6
1486,1702,2022-10-06 04:31:00,ec1f5ed502298336bc57c63b924242f0,0,11,0,0,0,11
1487,1702,2022-10-06 04:36:00,e2051b5f8b842e9e50519fd8e09ddbda,0,4,0,0,0,4
1488,1702,2022-10-06 04:42:00,64dc0ed429b6d217aefc3250292a0d0e,0,1,0,0,0,1
1489,1702,2022-10-06 04:46:00,7a0412df0613785507438e79af5c1f6a,0,8,0,0,0,8
1490,1702,2022-10-06 04:53:00,b93277d3ef676c150e80dc707a2a5ab9,0,6,1,0,0,7
1491,1702,2022-10-06 04:56:00,0d926b4b19805a0d7e61755552fed2b6,0,3,0,0,0,3
1492,1702,2022-10-06 05:02:00,46f8bc4400c6bd2e6037b465f1a636fa,0,7,0,0,1,8
1493,1702,2022-10-06 05:07:00,2d2da831b42d75499d9c0a9754bf9ad5,0,7,2,0,1,10
1494,1702,2022-10-06 05:11:00,ed482b44048602b87159a2f83e2c8b0f,0,8,0,0,0,8
1495,1702,2022-10-06 05:17:00,beb24fdec593350a6e9a05e95169c902,0,3,0,1,0,4
1496,1702,2022-10-06 05:23:00,a8ab95b16eb88b5139f1d79635a028bb,0,4,0,0,0,4
1497,1702,2022-10-06 05:26:00,93615e9a3d39e6ba48b036aee6cbc1a0,0,6,1,0,0,7
1498,1702,2022-10-06 05:31:00,72d93e3c2b1efc88e2facd29db67941d,0,10,0,0,1,11
1499,1702,2022-10-06 05:38:00,2815084f7e909de3e0929f2f9a4b5f79,0,10,0,0,1,11
1500,1702,2022-10-06 05:42:00,f7507b33eec20abff5fddcc014963ad7,0,4,0,0,0,4
1501,1702,2022-10-06 05:47:00,5f078900f3190020420b55e52cf9873b,0,4,0,0,1,5
1502,1702,2022-10-06 05:53:00,2f33329ee69e0d282805cd5cc119a849,0,7,0,1,1,9
1503,1702,2022-10-06 05:57:00,3d9ffce3462cc3af0ba3d5b241338480,0,12,0,0,0,12
1504,1702,2022-10-06 06:03:00,92695e925c6114147111d8ceb9670cab,0,6,0,1,2,9
1505,1702,2022-10-06 06:08:00,639957c281bf68f8d00e3b49b0769f1d,0,6,2,3,0,11
1506,1702,2022-10-06 06:13:00,5c048ff7f5233c8a847819af23c5e657,0,12,1,0,1,14
1507,1702,2022-10-06 06:17:00,eebdca1cb543fe4822df7120adc9e93f,0,0,0,1,1,2
1508,1702,2022-10-06 06:23:00,9be767b0e4912ac7e83dfb2c6b2be910,0,4,1,1,0,6
1509,1702,2022-10-06 06:28:00,b61a4386373ad105736b2dcde5c450f5,0,6,0,0,0,6
1510,1702,2022-10-06 06:34:00,2e0870289ee25e8dd129f36620d1089d,0,7,0,0,0,7
1511,1702,2022-10-06 06:37:00,4502969dcf1b34746946a57a161f34f9,0,14,1,1,2,18
1512,1702,2022-10-06 06:41:00,645c30ad82ce4baa51f02355d0507cad,1,11,0,3,1,16
1513,1702,2022-10-06 06:47:00,a82852c94520292b411f50649964718a,0,15,0,0,2,17
1514,1702,2022-10-06 06:53:00,c5ae005d8600024943369e63c6e05f52,0,20,0,1,6,27
1515,1702,2022-10-06 06:57:00,6f9e36333f7657ad4d52445ab3f5d0a0,0,18,1,1,7,27
1516,1702,2022-10-06 07:01:00,ded4fcbe8da3059fae255f980078f3f2,0,15,1,0,8,24
1517,1702,2022-10-06 07:08:00,49c56b6bf4efc4d3a66a6284322d12d9,0,13,0,5,9,27
1518,1702,2022-10-06 07:11:00,9fe5537007e0f324ee9dc108b0ad8da3,2,21,1,0,6,30
1519,1702,2022-10-06 07:17:00,ec53ea7631b0d0ae2a84ff301f903ef1,0,14,2,0,6,22
1520,1702,2022-10-06 07:22:00,fea0baf2978d76ec53b55ce1db5a76c1,0,12,0,4,12,28
1521,1702,2022-10-06 07:28:00,4a8ef192ab59261a5abff2dd2d7a87bc,1,14,1,2,12,30
1522,1702,2022-10-06 07:33:00,8ed9179fe00eeae70e8a4d0a966a9aaa,0,16,0,2,10,28
1523,1702,2022-10-06 07:38:00,814e54444f91c0a016b8831e58f78fbc,0,20,0,2,7,29
1524,1702,2022-10-06 07:42:00,47703ae862346b5e7807bf05f2c41df6,0,14,0,1,11,26
1525,1702,2022-10-06 07:49:00,e7c247d7ff51ce18125e874fbcb11319,0,16,0,3,10,29
1526,1702,2022-10-06 07:53:00,e772c3b60d02a6e3d60a9acdc7e667fc,1,16,0,2,7,26
1527,1702,2022-10-06 07:57:00,0c93b35c56886db8792eebc75286eeb7,0,16,0,2,9,27
1528,1702,2022-10-06 08:03:00,53a6e1443023ee381a13ea59f20947f0,0,17,0,0,12,29
1529,1702,2022-10-06 08:07:00,12d562c0b5c65bda82613e5dfbd12a2a,0,18,0,4,10,32
1530,1702,2022-10-06 08:12:00,10e049a306e8c1c698bdea1eae2950de,0,21,0,4,10,35
1531,1702,2022-10-06 08:18:00,da83ef2fcb11d9b6984569ca1fb712f7,0,13,0,2,9,24
1532,1702,2022-10-06 08:22:00,087890ad6f26371e3a938631eb119bad,1,14,1,1,12,29
1533,1702,2022-10-06 08:28:00,bbdedff9c092138bb63c675bbd6a20a1,0,13,0,6,14,33
1534,1702,2022-10-06 08:33:00,e483299b153841ec88189fc40781fdcb,0,10,0,0,14,24
1535,1702,2022-10-06 08:37:00,9469fd9d334acd3a961b0fe83d1de25b,1,20,0,3,7,31
1536,1702,2022-10-06 08:43:00,95e549d8bf7dcc960cc263852bbc6c6b,0,12,0,0,9,21
1537,1702,2022-10-06 08:48:00,cfa873357ad0db09d10e32ce05d70062,0,12,0,2,11,25
1538,1702,2022-10-06 08:53:00,90c9c72b174a103a7e48614ffcccf979,0,11,0,3,13,27
1539,1702,2022-10-06 08:58:00,f2375fc7ff413609a9147bea23196cc2,0,15,3,0,10,28
1540,1702,2022-10-06 09:03:00,cf8ed50966e000d7080cbac1a7429144,1,13,0,0,8,22
1541,1702,2022-10-06 09:07:00,008beaaad70f673c448d59feef7c7afc,0,9,0,1,8,18
1542,1702,2022-10-06 09:14:00,2523485a8528264ee93649a7e94495dc,2,8,0,1,6,17
1543,1702,2022-10-06 09:18:00,7c5556772af02113b399dc9c3e8b16d2,0,14,0,0,8,22
1544,1702,2022-10-06 09:22:00,855de492483e1c060805e5c53bba1645,1,9,1,2,15,28
1545,1702,2022-10-06 09:27:00,43759c09ad18c71651cd941bca05e64b,0,5,0,1,13,19
1546,1702,2022-10-06 09:32:00,779e69ab1f2b665de48472f1207cb0e8,0,12,0,0,9,21
1547,1702,2022-10-06 09:38:00,5feb49dcf07aaa295fe68cb200eacfca,0,13,0,0,10,23
1548,1702,2022-10-06 09:43:00,fa3fdd8cb8b4968b21e89c428e53e84f,0,11,0,1,9,21
1549,1702,2022-10-06 09:47:00,e5d36c107848ebe59e62bbdd472b610e,0,17,0,0,7,24
1550,1702,2022-10-06 09:52:00,ba9c12c06db58274fcccc79fd180ccb6,0,14,0,1,12,27
1551,1702,2022-10-06 09:57:00,340e299fb82fa9a068bc34ea171b6002,2,11,0,4,10,27
1552,1702,2022-10-06 10:03:00,06d8a823d57252eef02effdb8bfd7819,0,12,0,0,8,20
1553,1702,2022-10-06 10:08:00,8fdc9cfcde1e9561b8e3ffadb85f3b0f,0,8,0,1,11,20
1554,1702,2022-10-06 10:12:00,a770c8c1ab372ee07ad312073fb85a01,0,13,0,2,11,26
1555,1702,2022-10-06 10:19:00,dece38c773283289c785a3e60be9baed,0,10,1,6,9,26
1556,1702,2022-10-06 10:23:00,8647045961a4c4893fe7419cbdbfb68a,0,10,0,0,13,23
1557,1702,2022-10-06 10:27:00,8c0ccf05562a49f749038d64a2e3805b,0,7,0,1,10,18
1558,1702,2022-10-06 10:32:00,d1f936ed43b33ce7d277736b307d57c9,0,11,0,1,12,24
1559,1702,2022-10-06 10:39:00,2ffef3afddba7ecf6c3ccba08bd81919,0,11,0,1,15,27
1560,1702,2022-10-06 10:42:00,35a5f09554b59fc7b8bd2df2fb818e3d,0,14,0,1,10,25
1561,1702,2022-10-06 10:49:00,0a3af1c5e99ea8ba3fefed258ca39986,0,14,1,2,12,29
1562,1702,2022-10-06 10:54:00,5679deaf5cf1dd24bc380b5bddd55069,0,12,0,1,6,19
1563,1702,2022-10-06 10:58:00,850c7a4001ea89db0c8bfa2247fdf690,0,11,0,0,10,21
1564,1702,2022-10-06 11:03:00,fbaad2808366522cef09b620c7d6aa58,0,10,0,0,10,20
1565,1702,2022-10-06 11:08:00,c14ba6c9eaa0780ef1ad48aa4265463b,0,11,0,0,9,20
1566,1702,2022-10-06 11:12:00,c7638ff286ba757f65055432711a3554,0,14,0,1,4,19
1567,1702,2022-10-06 11:18:00,5332eee010e7ec7c6bbc14a6f729d2f5,1,13,0,0,10,24
1568,1702,2022-10-06 11:23:00,5608e5a405e83ef54966d7055f2b5675,0,20,0,2,10,32
1569,1702,2022-10-06 11:27:00,89982572275081e125c6218829d2c4b6,1,16,0,3,11,31
1570,1702,2022-10-06 11:32:00,8e04ee0f9ae6c8d34bb01177023e17d7,0,10,0,3,4,17
1571,1702,2022-10-06 11:38:00,35efbd8b8f1b3fc779b5ba879faf53b8,0,10,1,3,8,22
1572,1702,2022-10-06 11:43:00,ea8c62dbbffe12836a8da6ccc1b9800f,0,14,0,4,10,28
1573,1702,2022-10-06 11:47:00,82ff35054c3e789c688faaa5a347d1c7,0,15,0,3,6,24
1574,1702,2022-10-06 11:53:00,9d9af55a5e5ab2ef7efc28887cc7d372,0,20,0,1,11,32
1575,1702,2022-10-06 11:57:00,dc6085c7da9108406a77396d4e03e3ff,1,15,0,2,6,24
1576,1702,2022-10-06 12:03:00,3740a4ef3cd9d3fcb130411deb74a9c8,0,15,0,1,8,24
1577,1702,2022-10-06 12:07:00,0013a009268aed2308fd40ae3f9269aa,0,12,0,1,5,18
1578,1702,2022-10-06 12:13:00,9c753bb98105c00e7804e4e9e7739109,0,18,0,2,8,28
1579,1702,2022-10-06 12:18:00,059b95d4987314d2550c914c74a01014,0,10,0,5,10,25
1580,1702,2022-10-06 12:22:00,867c3b79ffbe5011679baf596b1c07c1,2,16,0,1,10,29
1581,1702,2022-10-06 12:28:00,bc578a4d8d1c98cbbf03e389f90edf94,0,11,0,0,11,22
1582,1702,2022-10-06 12:32:00,11812533cbf2ff3aab51c874379f24fb,0,11,0,1,12,24
1583,1702,2022-10-06 12:37:00,572a1463bacc6356a3a113b5a33d8ebb,0,11,0,3,13,27
1584,1702,2022-10-06 12:42:00,6ca99796a2ef18dae28697b3ed019848,0,17,0,1,6,24
1585,1702,2022-10-06 12:48:00,938b57b5aa75b2b31bf3299dfadabbc6,0,12,0,1,10,23
1586,1702,2022-10-06 12:53:00,35ed432372891329fc16102853edb304,0,9,0,1,11,21
1587,1702,2022-10-06 12:58:00,2efaee599ebe3ef4cf361c96907bfaf9,0,12,0,0,6,18
1588,1702,2022-10-06 13:02:00,a94952e838b01ea846763f9fe1b104f1,0,13,0,0,5,18
1589,1702,2022-10-06 13:08:00,efad50f6efbade37926022ce2afe35a1,0,11,0,2,9,22
1590,1702,2022-10-06 13:12:00,b83cdb08243a583557c35ba2052af57e,0,14,0,6,12,32
1591,1702,2022-10-06 13:19:00,79119fba36b4045ae219e9c2b3a7956c,0,13,0,3,8,24
1592,1702,2022-10-06 13:22:00,8b030035164ddc58ce7fb315eb4c034d,1,14,0,5,8,28
1593,1702,2022-10-06 13:28:00,4be891dce550e581802ca5f289787c8b,0,13,0,4,9,26
1594,1702,2022-10-06 13:33:00,0027c39d30e72467aaa885e3a24500d3,0,13,0,1,16,30
1595,1702,2022-10-06 13:38:00,0ae42d5cf3fd1896492784280272e983,0,16,0,4,13,33
1596,1702,2022-10-06 13:42:00,03a9642fc06bfad80b61d1d7e3812803,0,14,0,2,9,25
1597,1702,2022-10-06 13:48:00,cbece7a30c6a7551585f9441886b0d46,0,14,0,5,10,29
1598,1702,2022-10-06 13:52:00,0a0d032ce37fd7122e495cef7d6586d2,0,17,0,0,10,27
1599,1702,2022-10-06 13:57:00,bec12b3ba5085d6cc184182aa0d4eab2,1,14,0,5,8,28
1600,1702,2022-10-06 14:02:00,b7e53544b2e459661dee40095804d581,0,11,0,1,12,24
1601,1702,2022-10-06 14:08:00,a326bc00e76ef3f5b71cf7fe0e3db24e,0,12,0,1,19,32
1602,1702,2022-10-06 14:13:00,e8ee149afcdb1d4be25d827c3bc14b5d,0,10,0,3,13,26
1603,1702,2022-10-06 14:18:00,2920a4bc2a06d5d8177a84dfb27fd40d,0,15,0,0,13,28
1604,1702,2022-10-06 14:22:00,692389e347af50c7572385e1be7a97a8,0,13,0,0,14,27
1605,1702,2022-10-06 14:27:00,3d7a49db16a3bdfcbe6362e3aa09cf27,0,13,1,3,14,31
1606,1702,2022-10-06 14:33:00,d04e6921fa86da519145ec5120dd9af0,0,13,0,9,6,28
1607,1702,2022-10-06 14:38:00,4ae0c3521904b4d10af60883777e47a3,1,19,0,4,11,35
1608,1702,2022-10-06 14:42:00,77423791379aae1633a110d3140491c6,0,10,0,3,10,23
1609,1702,2022-10-06 14:48:00,e95027ac5dafd3e69e131b89d36737ab,0,17,0,0,12,29
1610,1702,2022-10-06 14:53:00,2a5edba513f166a56698566918b424fa,0,19,0,0,9,28
1611,1702,2022-10-06 14:58:00,ba205e5f5ea828f50325126d753a67ef,1,16,0,1,12,30
1612,1702,2022-10-06 15:03:00,1fb077f5c85945837e9d25cbe4297a70,0,12,0,2,7,21
1613,1702,2022-10-06 15:09:00,7b227ab8ab20b2296c1d0c4887296b70,0,11,1,6,7,25
1614,1702,2022-10-06 15:13:00,213783a63362fd0c2949188e799423a2,0,13,1,3,13,30
1615,1702,2022-10-06 15:17:00,fdc5634fa1bab4d219cb51498b2dc757,0,12,1,6,15,34
1616,1702,2022-10-06 15:22:00,49902717da1eb51df5a749de0d10af4f,0,13,1,1,12,27
1617,1702,2022-10-06 15:27:00,67a4d797fc137d0fc6a92ee90d7ebf38,1,11,0,1,15,28
1618,1702,2022-10-06 15:33:00,8c6ce0c20f45efc80389a36510eae1bd,0,18,0,3,9,30
1619,1702,2022-10-06 15:38:00,f39f7b6cc897e53ee1dcc7f34885a94b,0,24,1,2,9,36
1620,1702,2022-10-06 15:42:00,5d9b65693ec685fe9d2e263f5d507ed9,0,13,0,3,11,27
1621,1702,2022-10-06 15:47:00,4ae18392ad78fdef6bd85766040b3ed8,0,12,1,2,15,30
1622,1702,2022-10-06 15:52:00,fd455e15ab20590d8c6cf380716bbc95,0,14,1,1,16,32
1623,1702,2022-10-06 15:58:00,7b1f24e01007590caf8d056ff1d0fddf,0,20,0,0,6,26
1624,1702,2022-10-06 16:03:00,2e799a2cdd93a8d91189725a4ad5ca09,0,15,0,5,7,27
1625,1702,2022-10-06 16:08:00,1476c30ae93a7793ce6910542ff3bfeb,0,19,0,4,9,32
1626,1702,2022-10-06 16:13:00,59ef248286314aef2ee1890306f5602b,0,17,0,4,10,31
1627,1702,2022-10-06 16:23:00,8e11a9f979c9db5f87c36762fb26f1aa,0,19,0,1,4,24
1628,1702,2022-10-06 16:28:00,06dc857c99bd97aa48c1bb790a361d26,1,19,0,1,2,23
1629,1702,2022-10-06 16:32:00,e91ea55c622df51dce0dee35e8d8e609,0,17,0,4,5,26
1630,1702,2022-10-06 16:37:00,e7f963438f5feb819b2b91a1ae2e386f,0,22,0,0,2,24
1631,1702,2022-10-06 16:41:00,b647d5fadfdc6a6594cd0c07507e4ef5,0,22,0,3,9,34
1632,1702,2022-10-06 16:47:00,0b4536d5b33970a10f038e25ff4e7835,2,17,1,3,6,29
1633,1702,2022-10-06 16:52:00,65069e259ec78740c2118f69152ddcbf,0,21,0,3,7,31
1634,1702,2022-10-06 16:58:00,6c5e861a252ad5d65e9f0d96e5bcad0f,0,18,0,3,10,31
1635,1702,2022-10-06 17:02:00,21a5edb51dd8438c0e445b892a275db3,1,21,1,0,11,34
1636,1702,2022-10-06 17:08:00,0ebbfae3d4b545ebc4bcf836d36b8423,0,12,0,1,13,26
1637,1702,2022-10-06 17:13:00,46d866227dcd2b2b36b98612a0a33e5c,0,16,0,4,11,31
1638,1702,2022-10-06 17:17:00,8e5a4e146e5b9ba3ff21d5ce8009c81a,0,18,1,6,7,32
1639,1702,2022-10-06 17:23:00,d19c0c144e52af6f000aff68a99b497c,0,18,0,4,6,28
1640,1702,2022-10-06 17:28:00,506588a47bd4ab91f84f02e89dca8b9e,0,18,0,0,10,28
1641,1702,2022-10-06 17:33:00,bc800c478c123da373d16e839e6d6b44,0,11,1,6,11,29
1642,1702,2022-10-06 17:38:00,f03e78245cdcd8de209105e84c185f5c,0,12,0,2,6,20
1643,1702,2022-10-06 17:42:00,98f0d6562ad7e1cacf56d80869503209,1,16,0,6,8,31
1644,1702,2022-10-06 17:48:00,79253f47fd4333396604db15024b09c2,0,19,0,3,5,27
1645,1702,2022-10-06 17:53:00,52c11e37ee6786b8a3aa346d903d609f,1,19,0,6,8,34
1646,1702,2022-10-06 17:57:00,8e0b3186bc5203f94032dc95d04d16ee,0,20,0,4,9,33
1647,1702,2022-10-06 18:03:00,113cb90250b578b1ceac8d19279badfc,0,24,1,2,9,36
1648,1702,2022-10-06 18:07:00,98b77450d400fc4974fe80e898d48afb,0,15,0,3,14,32
1649,1702,2022-10-06 18:12:00,790c167e1527e8e597c963c9cdabd141,0,11,0,1,12,24
1650,1702,2022-10-06 18:18:00,bca0f37352e24f15c1b6db00d08da1c7,1,14,1,6,8,30
1651,1702,2022-10-06 18:23:00,e32dd8ccdc93ca9c63616906757311a4,5,16,0,1,11,33
1652,1702,2022-10-06 18:27:00,599ec3a845e8ea0ef342905f1abc9e54,0,13,3,1,12,29
1653,1702,2022-10-06 18:32:00,02e3b4568b17e54f267ca4181f4da13b,0,18,0,1,10,29
1654,1702,2022-10-06 18:38:00,7d19a867622a276b3df91c614f09efc5,0,19,1,5,11,36
1655,1702,2022-10-06 18:42:00,b418e8cb22c25e9e3e182170059d6319,0,15,0,0,10,25
1656,1702,2022-10-06 18:48:00,6eb21448a946f5128b6c09a6ca055252,0,23,1,2,5,31
1657,1702,2022-10-06 18:53:00,bb03b4cfda8b70d4f5580744d3a67c34,0,12,0,2,9,23
1658,1702,2022-10-06 18:58:00,93b473b10dc28ebb3077f7efe3891936,0,19,0,2,8,29
1659,1702,2022-10-06 19:03:00,5ca97259cd6cab67d33168db1bd3c2f1,0,17,0,0,4,21
1660,1702,2022-10-06 19:07:00,b2167c0fb7f2f6857011c7da8254d0fa,0,18,0,1,5,24
1661,1702,2022-10-06 19:12:00,4e008b6e6fd69af6cc9c1f84d5717177,0,14,1,1,1,17
1662,1702,2022-10-06 19:18:00,5f41fe625f99f2c933f4fbaa6f3c2cf6,0,17,1,1,1,20
1663,1702,2022-10-06 19:23:00,fdaa6accd81a17c3d2e39761452a14d9,0,18,0,0,1,19
1664,1702,2022-10-06 19:28:00,d3d522e6344724c2503b718ce2dad3b3,0,16,4,2,1,23
1665,1702,2022-10-06 19:32:00,4a4734cd6bd00314e0b410d6b4da364b,0,16,0,0,1,17
1666,1702,2022-10-06 19:38:00,cf9f01a1c3c3b74a0e21548a45f4e77a,0,10,0,1,1,12
1667,1702,2022-10-06 19:42:00,eff214598474af4f8b167dabef4bddcc,0,27,0,0,0,27
1668,1702,2022-10-06 19:47:00,59566742e3143f730583fcb9fe7cba2a,0,13,1,0,0,14
1669,1702,2022-10-06 19:52:00,18a68fac9ca19e039771a4aa1e4e7c0c,0,14,0,0,1,15
1670,1702,2022-10-06 19:58:00,4b164defc873071604a6214e84ec694f,0,11,0,0,0,11
1671,1702,2022-10-06 20:03:00,2696f8f726a1c343e207c55bbc46fab9,0,20,1,0,0,21
1672,1702,2022-10-06 20:07:00,df6487f7ebaadf286bdf2293f4903966,0,12,0,0,0,12
1673,1702,2022-10-06 20:11:00,329f8619d94c5def7d16fec61202fe3c,0,19,0,1,1,21
1674,1702,2022-10-06 20:17:00,126100a176916854ccd639a55098e786,0,17,1,0,0,18
1675,1702,2022-10-06 20:22:00,68aa3b9abb0ae54c11ea1c361843cb6d,0,18,1,0,0,19
1676,1702,2022-10-06 20:27:00,e1112124ae64c9f8a555fa037657912c,0,17,0,0,0,17
1677,1702,2022-10-06 20:32:00,345a4e30c76ab889cd25249b65ec4550,0,20,0,1,2,23
1678,1702,2022-10-06 20:37:00,aed0a803efb3a0c4e3be433abf66c734,0,19,3,1,0,23
1679,1702,2022-10-06 20:41:00,d3d9e3b0da3c73728546701f2bc930f5,0,12,2,1,1,16
1680,1702,2022-10-06 20:47:00,50e12793987a369822a31fc0e3a415ed,0,19,2,0,0,21
1681,1702,2022-10-06 20:53:00,d3e7b3a51444f1cf3c8bac4337988943,0,19,0,1,2,22
1682,1702,2022-10-06 20:57:00,4521baaa16933a12cac3aee1eafc55a7,0,22,0,1,0,23
1683,1702,2022-10-06 21:03:00,3c088c87d84678fe9bf359d5e42d9abe,0,13,0,1,0,14
1684,1702,2022-10-06 21:08:00,98b8b405547b1548af2a7afd184d1aeb,0,13,0,1,1,15
1685,1702,2022-10-06 21:11:00,cf0e48fbe4cdb713bf169a887931e8c9,0,20,0,0,1,21
1686,1702,2022-10-06 21:18:00,18991950513533aa63b5170de743833a,0,10,2,0,1,13
1687,1702,2022-10-06 21:23:00,bbbdf525a98cb48644ab920f8c507766,0,16,0,0,1,17
1688,1702,2022-10-06 21:28:00,ef0f0574880e25689479860ea635e652,0,18,2,2,0,22
1689,1702,2022-10-06 21:32:00,79d5e65e6711f73ad1b3dc6ffe46f6c1,0,16,0,1,1,18
1690,1702,2022-10-06 21:39:00,adad18b100376bb68061d6d24e9cf709,0,17,0,0,0,17
1691,1702,2022-10-06 21:42:00,67b93838a489b5982e0e65f9b287f112,0,16,0,1,1,18
1692,1702,2022-10-06 21:48:00,b7088a41f1b41b48eccbf439ba2f0f41,2,15,1,0,1,19
1693,1702,2022-10-06 21:52:00,123932ef7b283d26d04f07042e4b3370,0,13,0,0,0,13
1694,1702,2022-10-06 21:57:00,21fb5a88c167a63c1a868ae0b5f36d0e,1,13,0,5,1,20
1695,1702,2022-10-06 22:03:00,aa780b0bfbdbb0bc3c57a8a80dc6acb5,0,16,0,0,0,16
1696,1702,2022-10-06 22:08:00,f780b8ede788acd949d505d4591ea2b1,0,21,1,0,2,24
1697,1702,2022-10-06 22:13:00,732cef5eb884819950fb58f62b1d2322,0,16,0,0,0,16
1698,1702,2022-10-06 22:17:00,cfeb54f922086fe85bb2ecb23d127d20,0,17,0,1,0,18
1699,1702,2022-10-06 22:23:00,73ac564287e31d176cd590b484cd0559,0,20,0,0,1,21
1700,1702,2022-10-06 22:27:00,af3d9a4f42c5422d839e01750613693b,0,17,0,0,2,19
1701,1702,2022-10-06 22:33:00,93939e46b6473aacb839b154c01ef56e,0,20,1,0,1,22
1702,1702,2022-10-06 22:38:00,ec822d58ad57cc2d6315aca2c88408e3,0,4,0,0,0,4
1703,1702,2022-10-06 22:42:00,60239e6f4bc4c28ccade8419f53ac276,0,10,0,0,1,11
1704,1702,2022-10-06 22:47:00,2d24e8fb1ecd4717e4c9c8c5cd5fed97,0,17,0,0,0,17
1705,1702,2022-10-06 22:52:00,950cd8811f05700ab9d81ad6dbdb99cf,0,10,0,0,1,11
1706,1702,2022-10-06 22:56:00,ac37f1060cdf38c773e29446300bbab8,0,7,1,1,3,12
1707,1702,2022-10-06 23:02:00,46462be410d7306b5603cd04c2cb12eb,0,10,2,0,1,13
1708,1702,2022-10-06 23:07:00,1693b8be882efbbf796ab7f9e703c027,0,12,0,0,1,13
1709,1702,2022-10-06 23:12:00,9c8aca057776f6e2d4cb38bc3374ff65,0,14,0,0,0,14
1710,1702,2022-10-06 23:17:00,1cea6cf61142eb30fbe14152a1d4e4c6,0,15,0,0,0,15
1711,1702,2022-10-06 23:22:00,70e83ffb4aea84f3a5ca2188cb10311c,0,12,0,2,2,16
1712,1702,2022-10-06 23:27:00,55ec9aabe131aa6d4572e17709c83f54,0,13,3,0,1,17
1713,1702,2022-10-06 23:32:00,5dcee8a742516fd776fd07bef02c5f53,0,11,0,0,0,11
1714,1702,2022-10-06 23:37:00,02c4402639654871e78f9207a958f762,0,16,0,0,0,16
1715,1702,2022-10-06 23:42:00,f7351d2c940620942395f23f463f1af2,0,9,3,1,1,14
1716,1702,2022-10-06 23:48:00,4425d41a22a4445de2c56ad065484296,0,13,0,1,2,16
1717,1702,2022-10-06 23:52:00,b2c49ec64a5e80878a29c6dc8f2126b3,0,7,0,0,0,7
1718,1702,2022-10-06 23:58:00,c03566e863a3dbd34918cd5b5ccb7135,0,11,0,1,0,12
1719,1702,2022-10-07 00:02:00,a00a2f47a0c4f2ad1881caf32770348a,0,13,0,0,1,14
1720,1702,2022-10-07 00:07:00,8459d71178e9faae171224c25d93174f,0,12,0,1,4,17
1721,1702,2022-10-07 00:12:00,8cbbb7a8c6b63cc682d86300b19cbc1b,0,7,0,1,2,10
1722,1702,2022-10-07 00:18:00,5467ccb39491d7e7c9219b767e3692bc,0,8,1,0,1,10
1723,1702,2022-10-07 00:21:00,21f4c6e2974f64b1e89e32ef8e18c786,0,5,3,1,0,9
1724,1702,2022-10-07 00:27:00,1186214f0bc42241a67458d71d03956f,0,11,1,0,0,12
1725,1702,2022-10-07 00:32:00,ce9bfc0563a9708ba14a66eeda8a78c8,0,12,0,0,0,12
1726,1702,2022-10-07 00:37:00,ea42245ad7dfd82065aaa9f4d8b92ad8,0,13,0,0,0,13
1727,1702,2022-10-07 00:41:00,47fbfc6683ed4edd2bf73ad271a705ca,0,7,0,0,0,7
1728,1702,2022-10-07 00:47:00,69c3d9ba928aa01e4d5e56204279f101,0,10,0,0,2,12
1729,1702,2022-10-07 00:52:00,c6c639b05fd6900f961508143a27884f,0,5,0,0,0,5
1730,1702,2022-10-07 00:57:00,23e24081573282fb7653eae163453d81,0,15,0,0,0,15
1731,1702,2022-10-07 01:02:00,e4b1d705ca481d42229b092d6faf0b82,0,11,0,0,0,11
1732,1702,2022-10-07 01:08:00,1acdb2dad2806a756825c757d0516bd4,0,4,0,0,0,4
1733,1702,2022-10-07 01:12:00,40456b69354425ef83134410b2e9b739,0,12,0,0,2,14
1734,1702,2022-10-07 01:17:00,c42fa76c5a8a486c912330747fba1a53,0,8,0,0,0,8
1735,1702,2022-10-07 01:22:00,dad0ec5edcc004030af3d5c4d7f00d99,0,7,0,0,3,10
1736,1702,2022-10-07 01:27:00,595441ddfb6a2281a4585fd5f5c4699b,0,3,0,0,0,3
1737,1702,2022-10-07 01:32:00,245f4130e313a6d0267ae191ae0be2d1,0,8,0,0,0,8
1738,1702,2022-10-07 01:37:00,7c8c3b125c7500854a88685a8625c153,0,11,0,0,0,11
1739,1702,2022-10-07 01:42:00,a3b5fa52af7920370845b4e26865173f,0,6,0,0,0,6
1740,1702,2022-10-07 01:48:00,a162a9934465c423633dec7a10f0f2e4,0,2,1,1,0,4
1741,1702,2022-10-07 01:52:00,bb89864be75368afcfaf5c5a884117eb,0,5,0,0,0,5
1742,1702,2022-10-07 01:57:00,36d5fb726f3f345410cbe08fab3bc4c3,0,10,0,0,0,10
1743,1702,2022-10-07 02:02:00,1393fd96d89ab31a65447cb32ea70a2e,0,8,0,1,1,10
1744,1702,2022-10-07 02:07:00,853975470b54d7b185bd94b68264a7ca,0,11,0,0,0,11
1745,1702,2022-10-07 02:12:00,3cbe4a458da46e65f0618aa9521accb5,0,8,0,0,0,8
1746,1702,2022-10-07 02:17:00,ea0c27034202fc5193c9848618a11a6e,0,5,1,0,1,7
1747,1702,2022-10-07 02:23:00,17987cfb624cc218de5400557f5e3752,0,7,0,0,0,7
1748,1702,2022-10-07 02:27:00,4a3ea7a454789785e3f8b57559f4552b,0,0,0,0,0,0
1749,1702,2022-10-07 02:32:00,884c7a07b0f9273763dbc9561c01fe57,0,5,0,0,0,5
1750,1702,2022-10-07 02:38:00,08c35539f0d449db71e677cc71de8ce4,0,12,0,0,0,12
1751,1702,2022-10-07 02:42:00,ff4b4986667bcc1b43a624a306ab7e75,0,5,1,0,0,6
1752,1702,2022-10-07 02:47:00,208fbc2868439ae4142e26f43f6ecac3,0,1,0,0,0,1
1753,1702,2022-10-07 02:52:00,59f47860e5307611a81b7c16815c2502,0,11,0,0,0,11
1754,1702,2022-10-07 02:58:00,4e1bb2f64c787274ca454dc9ef18039c,0,4,0,0,0,4
1755,1702,2022-10-07 03:04:00,56a905209950d212c710be061818c670,0,8,0,0,0,8
1756,1702,2022-10-07 03:08:00,1c94b1c8742b38a0652db8ff346a3cbd,0,3,0,0,0,3
1757,1702,2022-10-07 03:12:00,4121f91fd6f32719f5de3f0d72e6b17a,0,3,0,0,1,4
1758,1702,2022-10-07 03:18:00,021a300a334f60b21eb9dac3dd54b21f,0,10,1,0,0,11
1759,1702,2022-10-07 03:22:00,17b43ea1742a960c81ab878ea43d38a7,0,8,0,0,0,8
1760,1702,2022-10-07 03:26:00,5d22d3fe76e0d5b21f632d8be72b209b,0,6,0,1,0,7
1761,1702,2022-10-07 03:32:00,1bd0352ca947880e95fe60ea52e76786,0,13,0,0,1,14
1762,1702,2022-10-07 03:38:00,c5186eda6a6ce7b33209fdef39c468e2,0,5,1,0,1,7
1763,1702,2022-10-07 03:41:00,82f2c3c725e1ef3e8bd11492851103d7,0,4,0,0,2,6
1764,1702,2022-10-07 03:48:00,29a01769f9f6c4f9462cf1405b9a91e2,0,8,0,0,0,8
1765,1702,2022-10-07 03:52:00,864a7631a363f24aa6fd2a59a7e5d206,0,6,0,0,0,6
1766,1702,2022-10-07 03:57:00,46f369c70b93098e8ecdc1fa04467caf,0,9,0,1,1,11
1767,1702,2022-10-07 04:03:00,c7c8dcf3a5b65c4a2cd56ea71ef5da75,0,4,0,0,0,4
1768,1702,2022-10-07 04:07:00,25cd9c653aebd3f77b0c102316e52312,0,7,0,0,0,7
1769,1702,2022-10-07 04:12:00,9c0d3c437ce9459da22ff7ed7561ad46,0,3,0,1,0,4
1770,1702,2022-10-07 04:18:00,97b420382b04ce8f7ed070416693ca9a,0,2,0,0,0,2
1771,1702,2022-10-07 04:23:00,895744db3d0235cf215f3c2bcf2f0b1c,0,3,0,0,0,3
1772,1702,2022-10-07 04:27:00,fc363ae2a3cf9b5b85ed556e43457baa,0,4,0,0,0,4
1773,1702,2022-10-07 04:32:00,860c95d62df382ba27f3c58e24a4ecb2,0,5,0,0,0,5
1774,1702,2022-10-07 04:36:00,4c3513823e287d8f8d75fe3aa47720c6,0,8,0,0,0,8
1775,1702,2022-10-07 04:42:00,931f8d583ba6a29248e2097836b230f2,0,3,0,1,0,4
1776,1702,2022-10-07 04:48:00,925439f6db7eeeb6ab0ab1d3612db5e8,0,6,0,0,0,6
1777,1702,2022-10-07 04:53:00,d97f79dbfd351a3f35e662c1f948e6f8,0,7,2,0,0,9
1778,1702,2022-10-07 04:56:00,a17dd880bc0e37fc462472ac631070de,0,8,0,0,0,8
1779,1702,2022-10-07 05:02:00,89e73e669687ce80b9ea17b91b800739,0,5,0,0,0,5
1780,1702,2022-10-07 05:07:00,7e61b56ba8719ba8cf0a34d1b28ec781,0,9,0,0,0,9
1781,1702,2022-10-07 05:12:00,7a9f307de987ac36df5731086f9c23b1,0,5,0,0,1,6
1782,1702,2022-10-07 05:17:00,d061cba86c6e585960cb3da834b848c0,0,0,0,0,0,0
1783,1702,2022-10-07 05:22:00,adef44a3caf604406419665f3141b695,0,1,0,0,0,1
1784,1702,2022-10-07 05:27:00,50eb58daa3e16bf0d9f68cdc5f37792e,0,7,0,0,1,8
1785,1702,2022-10-07 05:32:00,e793ed6bb5305719105413b5e00f5c70,0,4,0,0,1,5
1786,1702,2022-10-07 05:36:00,ff1bbfb36a273823d581a909d6ec083d,0,5,0,1,0,6
1787,1702,2022-10-07 05:42:00,fc8aa5791c8b5b9dc0a3135e94581602,0,3,0,2,0,5
1788,1702,2022-10-07 05:47:00,0658af69139aa29f17e656e55fc5d4d1,0,7,0,0,1,8
1789,1702,2022-10-07 05:52:00,e1c59c9f7680ad1fe026e953821c91d9,0,7,0,1,0,8
1790,1702,2022-10-07 05:57:00,9f1d7195c29448cbf413c63f57d0c000,0,2,0,1,0,3
1791,1702,2022-10-07 06:03:00,2020dc28c6977b72948c463ed9754cdc,0,4,0,2,0,6
1792,1702,2022-10-07 06:07:00,8910156eea640bd67a12994817ad866b,0,3,0,0,0,3
1793,1702,2022-10-07 06:13:00,00073f566e5e28d4073e7849b56ee1a8,0,8,0,1,0,9
1794,1702,2022-10-07 06:17:00,9cbcd0c6ecd97acc1cb54ed5d56839d5,0,8,0,0,0,8
1795,1702,2022-10-07 06:24:00,589a82163188ac600e0b97d3423c4115,0,9,0,3,1,13
1796,1702,2022-10-07 06:26:00,626bbaa27fa587c3099b682cee9ecf79,0,8,0,1,0,9
1797,1702,2022-10-07 06:32:00,b223251d2eeec569487bd8cb74325b71,0,10,3,1,1,15
1798,1702,2022-10-07 06:37:00,b245362bb7c6d41e129d1e2a828ecb48,1,12,1,1,2,17
1799,1702,2022-10-07 06:42:00,3b1fca54b835673efd475eb248087b6d,0,6,0,0,1,7
1800,1702,2022-10-07 06:47:00,fb618e34a0b13d950474ab7683effb12,0,14,1,0,5,20
1801,1702,2022-10-07 06:52:00,0d98fc7fe2971020741d31835aba1bb6,0,13,2,0,4,19
1802,1702,2022-10-07 06:58:00,e49589dabc479292a523f860bb60b22b,0,6,1,2,13,22
1803,1702,2022-10-07 07:03:00,616a37e9b46e3954ba74e5c780c2aa15,0,22,0,1,2,25
1804,1702,2022-10-07 07:07:00,6c261ed024b650dfafa99dd8c6c56746,0,17,0,0,4,21
1805,1702,2022-10-07 07:13:00,f4f35fb5c099a6245b4b4e9d38668b48,1,20,0,0,7,28
1806,1702,2022-10-07 07:18:00,adc43b30088a5398b967f5f85dbc8fe0,1,10,0,3,10,24
1807,1702,2022-10-07 07:23:00,536db6232bf18061185c348b9ce34c32,1,12,0,1,5,19
1808,1702,2022-10-07 07:27:00,3ac0ddbafa7511eb977241a59d678b71,0,13,0,1,9,23
1809,1702,2022-10-07 07:32:00,4f70b5bb8574fd1916f4ad9cb2b04584,0,11,1,0,17,29
1810,1702,2022-10-07 07:38:00,95c26a11d7c1548a39a15821b71936d5,0,13,0,1,12,26
1811,1702,2022-10-07 07:43:00,2a826c860a5bf30b3d14ce3f967ed405,1,10,0,1,10,22
1812,1702,2022-10-07 07:48:00,553cdbe75b8e3f6405cd04c4e7a3c652,2,22,0,1,6,31
1813,1702,2022-10-07 07:53:00,c7d0cbeba3869f2c98123ee3f2071d5c,2,10,0,3,10,25
1814,1702,2022-10-07 07:58:00,56239878a446e87e2552f32216f98db2,3,13,0,1,10,27
1815,1702,2022-10-07 08:02:00,04a9d30b6e77c89f6d4b3078109787a0,2,10,1,3,10,26
1816,1702,2022-10-07 08:08:00,0f6c1698231e01d3164eafd00f29e713,0,23,0,1,3,27
1817,1702,2022-10-07 08:14:00,7df63aba1614cb5387e45f63ac37ede3,1,17,0,3,7,28
1818,1702,2022-10-07 08:18:00,7d7623cad4adea04506cdb560195ff70,0,18,0,1,10,29
1819,1702,2022-10-07 08:23:00,7f2e1ba746aa7f36a105f73675d5a3f3,0,21,0,3,6,30
1820,1702,2022-10-07 08:27:00,3812ec6c031fa2dee799ccb0549d592d,0,19,0,2,13,34
1821,1702,2022-10-07 08:33:00,f41f83c20bcc990c3c94340f858ae3da,0,14,0,2,13,29
1822,1702,2022-10-07 08:38:00,ee29d85a9f0b95bfce8985b3160d0d57,0,18,0,3,8,29
1823,1702,2022-10-07 08:42:00,58ee46674592b3cf8b27d52b53ba9664,0,13,0,3,13,29
1824,1702,2022-10-07 08:48:00,73664da40de6d90a96498be98fca2fb9,1,11,0,2,11,25
1825,1702,2022-10-07 08:52:00,49518dc05d473abdcef3d788dace4ae2,0,18,0,0,8,26
1826,1702,2022-10-07 08:58:00,267e9bd262f39b712a46df8a7ab6da0c,1,13,0,1,6,21
1827,1702,2022-10-07 09:02:00,b5034bfa7117beec59ac79ac1d61040f,0,10,2,1,12,25
1828,1702,2022-10-07 09:08:00,5a4b0799e3bebaf8cd69c9aa3a4cc79e,0,12,0,4,9,25
1829,1702,2022-10-07 09:12:00,c3a54faacc54eaf8335eb5661eb050f3,0,13,1,6,9,29
1830,1702,2022-10-07 09:17:00,943aff0956d6fdb78e1fbec4e0592c3a,0,13,0,0,11,24
1831,1702,2022-10-07 09:24:00,e6437d847771435c9d50600821496d35,0,17,0,1,7,25
1832,1702,2022-10-07 09:28:00,0b11067b821bf3732f370c197b7c0748,0,15,0,4,4,23
1833,1702,2022-10-07 09:32:00,a1a3385a76b1cd8473e386c72368be15,0,11,0,1,8,20
1834,1702,2022-10-07 09:38:00,7d3eae83b2672186f905571c95d88cbd,2,13,0,3,8,26
1835,1702,2022-10-07 09:43:00,74ff2c5f2a8586877afbe14ac8609dc8,0,13,0,5,7,25
1836,1702,2022-10-07 09:48:00,7529195a59b6fa324b475949807376b7,0,9,0,2,8,19
1837,1702,2022-10-07 09:52:00,49a62a1ea4810e4af50fe9b51ef88f31,0,17,0,1,7,25
1838,1702,2022-10-07 09:57:00,55ea17c51069e51bfc2ae3cff7eed013,0,11,0,2,10,23
1839,1702,2022-10-07 10:03:00,6065860f0a65553460c7446fa8693d1d,0,12,0,1,15,28
1840,1702,2022-10-07 10:09:00,89b85d5a990aba8dd1680a0ff7c0fb85,0,17,1,2,9,29
1841,1702,2022-10-07 10:13:00,a96732e6f3325c75a1471e1e4b8e06db,0,14,0,5,7,26
1842,1702,2022-10-07 10:18:00,74f097e21661994734521b7afdb677a5,0,13,1,0,11,25
1843,1702,2022-10-07 10:23:00,22f5f4d424d80c8b6b204ba9222d0d98,0,12,0,5,12,29
1844,1702,2022-10-07 10:28:00,a68634a0cdb66a23de259c41f24cc837,0,13,0,3,11,27
1845,1702,2022-10-07 10:32:00,7eb4c117ebeaab24028d4d5e02f48356,1,17,0,2,6,26
1846,1702,2022-10-07 10:38:00,1fbe1d0bceac013bcc35f587b34ae04d,0,12,1,0,15,28
1847,1702,2022-10-07 10:41:00,0b0610336a60275cacef52d8b846e461,0,11,0,4,13,28
1848,1702,2022-10-07 10:48:00,fc56f4402251e1397f6d63ad16a206ee,0,21,0,2,11,34
1849,1702,2022-10-07 10:53:00,a5b299b737a4559fbfdef9fcb9e12cea,0,21,0,16,4,41
1850,1702,2022-10-07 10:58:00,25d0c57e09a7559e03c360ea9328a1d1,0,29,0,9,8,46
1851,1702,2022-10-07 11:03:00,a82ded1bc4d56d18e03c4856de52c718,0,29,0,7,13,49
1852,1702,2022-10-07 11:09:00,81b640b9be8d3115150c63f612b081de,0,27,0,8,14,49
1853,1702,2022-10-07 11:13:00,ab3dd6f7a5ad2994c259b4809e1be9fc,0,25,0,9,7,41
1854,1702,2022-10-07 11:18:00,f8c8253cbc948334468d373be68b51cd,0,24,1,1,8,34
1855,1702,2022-10-07 11:22:00,6860d7d68f44fa2773806a81a8e01d95,0,9,0,0,13,22
1856,1702,2022-10-07 11:27:00,384bffa43985b8f3e7c053656b1ee8f0,0,14,1,3,11,29
1857,1702,2022-10-07 11:32:00,93e8268edb688b40d782bca12495ff4c,0,19,1,2,6,28
1858,1702,2022-10-07 11:37:00,10d631523f611d3a097060f6d024eecc,2,20,0,2,8,32
1859,1702,2022-10-07 11:42:00,251ed5180bc51eece85d8f194690d263,1,17,1,0,5,24
1860,1702,2022-10-07 11:48:00,5c9c962bd9ecb2458696446252ff9043,0,11,0,0,9,20
1861,1702,2022-10-07 11:53:00,0c543b8d95ad81596d3da02350a925c0,1,14,1,4,7,27
1862,1702,2022-10-07 11:57:00,f05426f1e8ce165c2c0e72934072b142,0,12,0,3,7,22
1863,1702,2022-10-07 12:03:00,0aa28df8b0a7e547395ad195107c1c2e,0,13,0,3,9,25
1864,1702,2022-10-07 12:13:00,9a0501b7f83b8f79d8c25ad8d3b19665,1,14,0,5,7,27
1865,1702,2022-10-07 12:17:00,069244fd246806d3230cd174cd2660cb,1,18,0,0,10,29
1866,1702,2022-10-07 12:23:00,e67c88b354eda34a4b80cba9b4a0b237,0,24,0,3,5,32
1867,1702,2022-10-07 12:28:00,bc88430e60e4c27501d46aafd851af2e,0,17,0,1,0,18
1868,1702,2022-10-07 12:32:00,b745aa8933b3853df09d5b3bd2f1ff6e,0,18,0,1,2,21
1869,1702,2022-10-07 12:38:00,16af011ff8b4ea97fe8191a66ee74f24,0,15,0,2,6,23
1870,1702,2022-10-07 12:42:00,e9ceddb54b7b90395986ddd8dd700314,0,17,0,1,2,20
1871,1702,2022-10-07 12:47:00,4b6459a6e3e7cd10c6df6a9fc6be0297,0,15,0,2,7,24
1872,1702,2022-10-07 12:52:00,a4edab4088e664c00a25ae90434b08aa,0,20,0,3,3,26
1873,1702,2022-10-07 12:58:00,76ec7687ffcad2a63bd84c5107b334e6,0,18,0,0,5,23
1874,1702,2022-10-07 13:03:00,fe307b9844600c07b9e9f77ac86efabf,0,11,0,1,5,17
1875,1702,2022-10-07 13:08:00,38a514e2293e07c036b58174f84df172,1,18,0,0,5,24
1876,1702,2022-10-07 13:12:00,e3d68d02f3f17a39812c5176e1fec130,0,13,0,0,9,22
1877,1702,2022-10-07 13:17:00,75fc4caeec3c35f795d4df7e560aa8b2,0,20,0,0,4,24
1878,1702,2022-10-07 13:23:00,d5d74d582c1501f9d2192b37a087e00c,0,19,0,1,9,29
1879,1702,2022-10-07 13:28:00,e1a9cbe7fc8b6fe3ec2fe1a26f1f522b,0,27,0,1,3,31
1880,1702,2022-10-07 13:33:00,d2e3db24268fa1910534ebd804d68aa2,0,19,0,3,4,26
1881,1702,2022-10-07 13:38:00,0945019f96134eff41cb78b3b2beb04f,0,22,0,1,7,30
1882,1702,2022-10-07 13:42:00,ac8d4bf14c17fc429cd1db1a07ecfb27,0,14,0,2,2,18
1883,1702,2022-10-07 13:47:00,fcf8660edab9fec9fb9554efdb13ca91,0,27,0,5,2,34
1884,1702,2022-10-07 13:53:00,c0c1be2d1960275348a9f6a447e625e7,0,16,0,1,2,19
1885,1702,2022-10-07 13:56:00,6b7910d4903c322e1d4bfee1b1b4e0af,0,15,0,1,2,18
1886,1702,2022-10-07 14:03:00,203c64a35c4488b5e58ecd57d001a7b1,1,19,1,1,9,31
1887,1702,2022-10-07 14:08:00,fd7e042faf675ae00854513a6f6d1555,0,18,0,1,9,28
1888,1702,2022-10-07 14:12:00,6d00c89b317c35da0469898627fb0d8b,0,13,0,1,8,22
1889,1702,2022-10-07 14:17:00,2aa5b46d29a0d4345ceaff664c86a95b,1,19,0,0,8,28
1890,1702,2022-10-07 14:22:00,41bcd3860224ff502b0514d26cd96c72,0,22,0,4,4,30
1891,1702,2022-10-07 14:27:00,6a1c611d6304fc662e30a25aae8fb57c,0,24,0,2,9,35
1892,1702,2022-10-07 14:32:00,de0e4b815b9c13570bd1f286f8b45ea1,0,13,0,1,12,26
1893,1702,2022-10-07 14:38:00,6b528e51170f6169206b6a295c674b3c,0,15,0,1,10,26
1894,1702,2022-10-07 14:43:00,ff3f1f7d84a666a9bafd52a63c19f46b,0,17,1,5,12,35
1895,1702,2022-10-07 14:49:00,489e5f3636e6a4411b6612b543131398,0,14,0,3,8,25
1896,1702,2022-10-07 14:54:00,0f787d4fbb532e6fe9e7a2108e11bc39,0,16,1,2,13,32
1897,1702,2022-10-07 14:58:00,92f2fdc83c4afcf2f455fac2982d80e3,1,17,0,1,14,33
1898,1702,2022-10-07 15:03:00,86926b711cb1914ee86564117f91664c,0,18,1,3,6,28
1899,1702,2022-10-07 15:09:00,4b6d39728cdd002b3271a1b4985829e0,0,16,0,4,8,28
1900,1702,2022-10-07 15:13:00,e111dbdf871834c0b0fb9df94c2adcfd,0,19,0,2,9,30
1901,1702,2022-10-07 15:18:00,9eebdcea5ea174eec50061045cb29c14,2,14,0,1,15,32
1902,1702,2022-10-07 15:22:00,022b27fbfb04a6d754b129fee5fa52d8,0,16,0,2,9,27
1903,1702,2022-10-07 15:28:00,986705cb7ae1ecbbebba5afce10b7e64,0,20,0,3,5,28
1904,1702,2022-10-07 15:33:00,5b182ac146ee65db02477854489997d4,1,20,0,3,7,31
1905,1702,2022-10-07 15:38:00,83b5d36d9c66dc8e081292aa1d9c750b,0,17,0,3,5,25
1906,1702,2022-10-07 15:42:00,b17a7445b3dd6354ee94cba7945f23c0,0,22,0,1,6,29
1907,1702,2022-10-07 15:48:00,9a50e96a0d4fdf3473465ad115f8ab66,1,16,0,3,8,28
1908,1702,2022-10-07 15:53:00,08ed4f3bcd4b25672402be2f822fa8a2,0,14,1,2,5,22
1909,1702,2022-10-07 15:57:00,43b065b590090ed177d5dbf66d487c55,0,19,0,2,4,25
1910,1702,2022-10-07 16:03:00,cac21eb49778a6afe24bcbb8fe9f0b06,0,18,0,0,3,21
1911,1702,2022-10-07 16:07:00,f7395a4c85267ffcb52e2f8f0c26c76e,0,19,0,0,3,22
1912,1702,2022-10-07 16:11:00,e24a3a1409f27b8d4ce87e1b81fba743,1,12,0,1,5,19
1913,1702,2022-10-07 16:19:00,db654947bf75245ef184feafbed9bef1,0,17,0,1,3,21
1914,1702,2022-10-07 16:23:00,56bfae1e267f2e5936518eac5125fc87,0,24,0,3,3,30
1915,1702,2022-10-07 16:28:00,1754489b7c00254a014eff233a6dc88c,0,26,0,2,4,32
1916,1702,2022-10-07 16:32:00,279e5169367678ad9e01cdca6a6fbdc0,3,20,0,3,6,32
1917,1702,2022-10-07 16:37:00,a036ec7b7ceb828c608deee0c398697a,0,18,0,0,9,27
1918,1702,2022-10-07 16:42:00,fc9934ccd81639da52d62312564c8b89,0,20,2,1,5,28
1919,1702,2022-10-07 16:47:00,a31c8d171dc87801e1071a20abf5d257,1,17,0,0,3,21
1920,1702,2022-10-07 16:53:00,3328d1275bd6be507bb3ad285664a2f3,1,14,0,0,10,25
1921,1702,2022-10-07 16:58:00,0e35278e7cd8ef681f9bad22a609b287,1,24,1,0,5,31
1922,1702,2022-10-07 17:03:00,a9957272c272b72503cfa547bd09061b,0,24,0,1,8,33
1923,1702,2022-10-07 17:08:00,cec58f0afaf67633378b482c7f608910,0,18,0,2,5,25
1924,1702,2022-10-07 17:12:00,09ade4182353916ed25839a656912e0c,2,24,0,3,7,36
1925,1702,2022-10-07 17:17:00,a9ee2317c7e1b8ace183f31d731a706e,0,25,0,8,4,37
1926,1702,2022-10-07 17:23:00,374e348e2fad742e8799f2159a4f9205,0,23,0,1,12,36
1927,1702,2022-10-07 17:28:00,4e02d7bf613db3b3ce16c6fc19c5023c,1,22,0,10,5,38
1928,1702,2022-10-07 17:33:00,e9d092c035a4abddf297cc0baea5d168,0,16,0,7,8,31
1929,1702,2022-10-07 17:38:00,9fe05f31b2aaf1ea3e07b9c90928b8ba,0,26,0,2,5,33
1930,1702,2022-10-07 17:43:00,a880ed746655ca1450a06cc09d6ab7e0,0,19,0,5,9,33
1931,1702,2022-10-07 17:47:00,565b8883228ccdb21590ec55e4c6ac09,0,17,0,3,11,31
1932,1702,2022-10-07 17:53:00,6da01a5d4b611c2628601cb190194800,0,20,0,2,8,30
1933,1702,2022-10-07 17:58:00,c8efa65617406f71b11fa05279115869,0,22,0,3,8,33
1934,1702,2022-10-07 18:02:00,05579c4b36528d9ce8787968dfc96083,0,19,0,2,9,30
1935,1702,2022-10-07 18:08:00,0ed567d1cef36a1dd6b38b13d8dc5b0c,0,19,0,2,9,30
1936,1702,2022-10-07 18:12:00,42b4f805113e05d803fefdd2491a13db,1,16,0,1,15,33
1937,1702,2022-10-07 18:18:00,82aca43de9f6017bfa51451fb9966e02,0,18,0,0,16,34
1938,1702,2022-10-07 18:24:00,e6689af196639c87155c39271c743738,0,19,1,1,9,30
1939,1702,2022-10-07 18:27:00,7f72a3d381078f6792150f8916b61c1e,0,30,1,1,6,38
1940,1702,2022-10-07 18:33:00,a5de2f62ce12fc579c4504d605f79ee0,0,17,1,1,14,33
1941,1702,2022-10-07 18:37:00,bcfffa885cea3c44b3e01effa68496b1,0,25,0,3,5,33
1942,1702,2022-10-07 18:42:00,1b28cd1f30a68002627cef1e4ad8e4f9,0,23,0,2,8,33
1943,1702,2022-10-07 18:48:00,844e39245b372963d78384aff02e36db,0,20,0,3,4,27
1944,1702,2022-10-07 18:52:00,6b0b1650cdb2acfa46acbb0bcdb51ebd,0,23,0,0,8,31
1945,1702,2022-10-07 18:58:00,1da53708b5678d0b26f0add9973fbc61,0,22,0,1,4,27
1946,1702,2022-10-07 19:03:00,834ed6e15418723307980a10aad827c9,0,23,0,2,0,25
1947,1702,2022-10-07 19:06:00,a5fa1c48e10c2e8cf78fd287a3c2ca32,0,22,3,0,1,26
1948,1702,2022-10-07 19:12:00,52d793c45e61b327deb24aa2da776a65,0,18,4,0,4,26
1949,1702,2022-10-07 19:17:00,3bb9127a7e9ab9df21929f62828ceacb,0,11,1,0,0,12
1950,1702,2022-10-07 19:22:00,37f38ee6a052c5f68a30236ed07d727c,0,17,0,0,0,17
1951,1702,2022-10-07 19:27:00,2ed4eb84703164ced8c74c02a698272f,0,19,0,0,0,19
1952,1702,2022-10-07 19:33:00,bf2f64be270367b00b24fc7b383afc48,0,17,0,0,0,17
1953,1702,2022-10-07 19:37:00,4bb50523569ead7fb6b40329dbcfcd77,0,19,0,0,0,19
1954,1702,2022-10-07 19:42:00,16ac8c62ae1a0c25f21f53768dfe853f,0,17,0,3,0,20
1955,1702,2022-10-07 19:48:00,9225cb68a62e6db7056ab561c65e3c37,0,21,0,1,0,22
1956,1702,2022-10-07 19:53:00,91792f181cd9f0200fd94704781c3885,0,24,0,0,0,24
1957,1702,2022-10-07 19:56:00,5b8b1049cb93ae67d1cecf60a444ecba,0,18,5,1,0,24
1958,1702,2022-10-07 20:02:00,ef8fc22f7a27d45d10b883caa716d156,0,11,2,0,1,14
1959,1702,2022-10-07 20:07:00,e34cc4fbe1ff8136801057afa75fa6d8,0,27,1,1,0,29
1960,1702,2022-10-07 20:12:00,5e1cc6869b8165afd08e09e3d58f938e,0,14,0,0,0,14
1961,1702,2022-10-07 20:18:00,d430d271670303169745a3006fb571c9,0,20,0,1,0,21
1962,1702,2022-10-07 20:22:00,463bab8e9f1986c5c92ca88a1d6cde87,0,23,1,0,2,26
1963,1702,2022-10-07 20:27:00,13896d829e4a0af9c9655f489ff17a64,0,17,0,0,0,17
1964,1702,2022-10-07 20:32:00,9836e27f93ee0cec121ed642805edd2b,0,23,0,0,0,23
1965,1702,2022-10-07 20:37:00,9c008f8767162e732186a574f891e7e5,0,23,1,1,0,25
1966,1702,2022-10-07 20:42:00,6f3186cee19e1d5bdff7c84a9497d71f,0,24,1,0,0,25
1967,1702,2022-10-07 20:47:00,531b1bbd4c2a4b7ba4c344f7b133a787,0,18,0,0,2,20
1968,1702,2022-10-07 20:52:00,dca3c4d82c8938cb33d686a5a7ae8035,0,19,1,0,1,21
1969,1702,2022-10-07 20:58:00,8f78e32d2214aa22a30dd5bb44e5fa95,1,20,1,0,2,24
1970,1702,2022-10-07 21:02:00,dc9e2f799bc75f35b1c2e30699299f48,0,15,1,1,2,19
1971,1702,2022-10-07 21:07:00,98a5d1977967a0ce9cbea80d5ec4a04e,0,17,0,1,3,21
1972,1702,2022-10-07 21:12:00,7bfb2eb244e6f72da1fda0177109bf7e,0,18,1,0,2,21
1973,1702,2022-10-07 21:17:00,7f15ea36bd3e52f10d7060cfed1f0127,0,19,0,0,0,19
1974,1702,2022-10-07 21:22:00,55a8fc05a6a585e2703a7ac9d020f034,0,16,0,0,0,16
1975,1702,2022-10-07 21:28:00,04c5368f7d5229b78281742835b7dbd6,0,11,0,0,3,14
1976,1702,2022-10-07 21:32:00,583b68dce8d1cb6cde76387515b83676,0,18,2,1,0,21
1977,1702,2022-10-07 21:38:00,398fbe7577008c541937d799b057e699,0,13,1,0,1,15
1978,1702,2022-10-07 21:43:00,fdd39d62516bfd688df3b98e52232434,0,23,0,0,1,24
1979,1702,2022-10-07 21:47:00,5edd32b954db8160157236a98db8ac7a,0,13,0,0,1,14
1980,1702,2022-10-07 21:52:00,953acb6a812b7433fc9f9b4a7a8f4fb6,0,18,0,0,0,18
1981,1702,2022-10-07 21:57:00,43dea47effc71a0b537e51251e02e591,0,22,0,0,2,24
1982,1702,2022-10-07 22:02:00,ded931b19e7951233c6a942c4a1a2990,0,17,0,1,0,18
1983,1702,2022-10-07 22:07:00,c87bfaf634538c53fb0a29de3e4c3549,0,17,1,0,2,20
1984,1702,2022-10-07 22:12:00,b91c075fe3ba3914c9c21311bf01cd50,0,25,1,1,0,27
1985,1702,2022-10-07 22:17:00,498925d1d6aae014d2a60de71caa6fa5,0,17,0,2,0,19
1986,1702,2022-10-07 22:23:00,55b5d960425a98d9640067d019a5e89a,0,18,0,0,0,18
1987,1702,2022-10-07 22:27:00,5c805edc28257ecba9a04a11e8012e19,0,15,0,0,1,16
1988,1702,2022-10-07 22:33:00,6aa96168da686b301d335245909e822b,0,17,0,0,1,18
1989,1702,2022-10-07 22:38:00,273c331c5c3b40045d028b424c48f728,0,21,0,1,1,23
1990,1702,2022-10-07 22:48:00,e31285978cc29f09b9ed92be770da5e0,1,15,0,2,2,20
1991,1702,2022-10-07 22:54:00,c41a19c49b79a62294960713d9954041,0,22,2,0,1,25
1992,1702,2022-10-07 22:57:00,54c1498c4545a568891abf74c066f420,0,11,1,1,0,13
1993,1702,2022-10-07 23:03:00,83022781517975c6a58b89c287e0cbcd,0,21,1,0,1,23
1994,1702,2022-10-07 23:07:00,f0afa191a22a8261a27068543fdb8d0a,0,21,2,0,0,23
1995,1702,2022-10-07 23:18:00,236c0e89835237e088a5f7b104670e6e,0,13,0,0,1,14
1996,1702,2022-10-07 23:22:00,80e105579a51891d96415e6e01d4c53a,0,16,0,0,1,17
1997,1702,2022-10-07 23:28:00,d1b5a185e44940721be82067e53433bc,0,24,0,0,0,24
1998,1702,2022-10-07 23:32:00,c3ca1303dbc5ce2b008e091f151520e4,0,24,0,0,0,24
1999,1702,2022-10-07 23:37:00,aa341138c60366b4e61238087e5b7d7f,0,11,0,2,2,15
2000,1702,2022-10-07 23:42:00,627d89942f656b24de6086014de54535,0,10,0,0,1,11
2001,1702,2022-10-07 23:47:00,570ec0ed1bd5602880f4ace6519bfda7,0,19,1,0,0,20
2002,1702,2022-10-07 23:53:00,857985bbead31a4a7d2852f2706c9f00,0,8,0,0,0,8
2003,1702,2022-10-07 23:57:00,82c2f677dea7b3cba73a9723582b27b9,0,9,0,0,1,10
2004,1702,2022-10-08 00:02:00,4ac4aecec1a74bc1541d5386d3362475,0,8,0,0,0,8
2005,1702,2022-10-08 00:09:00,8cd93e20cce8ee67f8351e05eff8a5f5,0,13,0,0,0,13
2006,1702,2022-10-08 00:12:00,53d3aa83ec73277097839db68bab6952,0,11,0,0,0,11
2007,1702,2022-10-08 00:17:00,45f281fbce378025bf4f5aab9fac4efe,0,12,0,0,2,14
2008,1702,2022-10-08 00:22:00,101504b54cc951bde41a4c06d33fa757,0,12,0,1,1,14
2009,1702,2022-10-08 00:28:00,a5a34359f3a9f7c9afb20de68f15d23e,0,12,1,2,0,15
2010,1702,2022-10-08 00:32:00,6e8fe5a543d0a8401c1756c60a55bddd,0,4,0,0,1,5
2011,1702,2022-10-08 00:38:00,ffaff686e7f8da21ce94d08742c95239,0,11,2,0,2,15
2012,1702,2022-10-08 00:41:00,ae5f3e20a8b537d4911fb9f4cb2d88db,0,11,0,0,1,12
2013,1702,2022-10-08 00:48:00,01ca85a1383cab9167f9ffaf59a7c64c,0,10,0,0,0,10
2014,1702,2022-10-08 00:52:00,383a6fe653afbb37e5aa9ba71a6c5b1a,0,7,1,0,1,9
2015,1702,2022-10-08 00:57:00,dac3d39235820542da20b9b79a44de37,0,6,1,0,0,7
2016,1702,2022-10-08 01:03:00,cf2722390c886356b81d509c4fc3cf31,0,1,0,0,0,1
2017,1702,2022-10-08 01:08:00,25691efee5fcac30c007c8083b5e24e8,0,2,0,0,0,2
2018,1702,2022-10-08 01:12:00,32c4fdf63684f3e3fa4f16900010aaa9,0,15,1,0,0,16
2019,1702,2022-10-08 01:18:00,3fada7eef9847e95c5fd932fc9687ea2,0,3,1,0,1,5
2020,1702,2022-10-08 01:22:00,09b8c82a0a079005077b8e4299bf0d17,0,11,0,0,0,11
2021,1702,2022-10-08 01:27:00,43bc7c7bb4f8b1e34c76a35df1f5d61c,0,7,1,1,0,9
2022,1702,2022-10-08 01:33:00,cffc091cf6f52b89c34d675f594de30a,0,9,0,0,0,9
2023,1702,2022-10-08 01:37:00,e3fa55900e5ba7b9d919068a4bcd795d,0,7,2,0,1,10
2024,1702,2022-10-08 01:42:00,b911660a2b65260d44312b11eeb730eb,0,8,1,1,0,10
2025,1702,2022-10-08 01:47:00,2507f9f2c8980aba060d7bce991cbaf7,0,11,0,0,0,11
2026,1702,2022-10-08 01:53:00,27dad57eaf81a935e2d6866fb6f24403,0,8,2,0,1,11
2027,1702,2022-10-08 01:58:00,367dff448af9c9369a0e79e6ad90cb99,0,11,0,0,0,11
2028,1702,2022-10-08 02:02:00,a1ca76f2b170fc5c3cb081795a68fcdf,0,9,1,0,0,10
2029,1702,2022-10-08 02:08:00,7d6fd9fc19b1a24c47dd25e8252811da,0,10,1,0,0,11
2030,1702,2022-10-08 02:13:00,7a13f06965776de4101bd4c329fe1ec7,0,9,1,0,1,11
2031,1702,2022-10-08 02:18:00,45e3e456af7cccce5c70d0ce96086089,0,9,0,0,1,10
2032,1702,2022-10-08 02:22:00,326c2875ac56d72dc50e55762da8a754,0,11,0,0,0,11
2033,1702,2022-10-08 02:27:00,ca809624eee83c6ce7027886fe5d6fee,0,6,2,0,0,8
2034,1702,2022-10-08 02:32:00,c536a59667598f07ed57ad03a1d9d73b,0,12,0,0,0,12
2035,1702,2022-10-08 02:38:00,151c0c50c7e65e2cb943dcea2e474eef,0,11,1,0,0,12
2036,1702,2022-10-08 02:41:00,c1304d84477dc5a2bf5b35fab7ee0e77,0,10,0,0,0,10
2037,1702,2022-10-08 02:46:00,4fcd32a7ce77afd2951755dd15f3b977,0,4,0,0,0,4
2038,1702,2022-10-08 02:52:00,0dcfdd5659ef75fd1d0480a074327b4e,0,4,0,0,0,4
2039,1702,2022-10-08 02:57:00,8d2c0578739cdfe0a6bd3ba31ee0e413,0,8,1,0,0,9
2040,1702,2022-10-08 03:01:00,5827bcb02c8bce5e52389a906b64744a,0,2,0,0,0,2
2041,1702,2022-10-08 03:08:00,1d48d6146e4d3ce5f21bbe8ba384be4f,0,9,0,1,0,10
2042,1702,2022-10-08 03:12:00,64fcbb37f3d694d3e046bfdeb1221e2b,0,3,0,0,0,3
2043,1702,2022-10-08 03:17:00,54c56f9563d7baed7ca684b9b0f92025,0,3,0,0,0,3
2044,1702,2022-10-08 03:22:00,073343e70800f083d882b8de713b200f,0,7,0,0,1,8
2045,1702,2022-10-08 03:26:00,aeb52349a5f23f6f23b95ea4eddca747,0,2,0,0,0,2
2046,1702,2022-10-08 03:31:00,950aa20f16523f0a8345451018ef2bee,0,6,0,0,1,7
2047,1702,2022-10-08 03:36:00,a4042b8876a02014ec8d81a10f01c9a5,0,4,0,0,0,4
2048,1702,2022-10-08 03:41:00,a47dfdf85590dbf41c902a54c7576454,0,9,0,0,0,9
2049,1702,2022-10-08 03:46:00,937b55f30cde80c40d5c9b95484d6a54,0,4,0,0,2,6
2050,1702,2022-10-08 03:52:00,5d4ca328a994fd8da087aa662203f142,0,4,0,0,0,4
2051,1702,2022-10-08 03:56:00,be1a7c338deb7877da846771a80351b2,0,2,0,0,0,2
2052,1702,2022-10-08 04:02:00,d2a1461ac01591ffb40746dcd900d33a,0,5,0,0,0,5
2053,1702,2022-10-08 04:07:00,ec111a323ecb744663c822b172073f72,0,8,1,0,0,9
2054,1702,2022-10-08 04:11:00,a9af2ea6156ac3240430ba7df3630875,0,5,0,0,0,5
2055,1702,2022-10-08 04:16:00,8562db07e4c0c548e6d5a4b74cd385a6,0,5,1,0,0,6
2056,1702,2022-10-08 04:21:00,22a7a40241cad013d97562e791edcf91,0,2,0,0,0,2
2057,1702,2022-10-08 04:26:00,8b8232b1449e86f10ac7641e5433802f,0,3,0,0,2,5
2058,1702,2022-10-08 04:32:00,509019491079f66fc980079b2a0f7b61,0,3,0,0,0,3
2059,1702,2022-10-08 04:36:00,fdd7014fc0385648a2164b6fa9e8816c,0,6,0,0,1,7
2060,1702,2022-10-08 04:41:00,d74d103ef241d1d1df6a7bb506f47d74,0,3,0,0,0,3
2061,1702,2022-10-08 04:46:00,a4c843a1636967cae317603d234fcec0,0,9,0,0,0,9
2062,1702,2022-10-08 04:51:00,b3607827df74161a140d2bfce8de81eb,0,4,0,0,0,4
2063,1702,2022-10-08 04:56:00,efd384dac60ffb4fe46851144246d286,0,2,2,1,0,5
2064,1702,2022-10-08 05:02:00,f45eb03cb1010dc930ab181bce124682,0,0,0,0,0,0
2065,1702,2022-10-08 05:07:00,10be5e5ab72ba063cde1ebaf420137b9,0,5,0,0,1,6
2066,1702,2022-10-08 05:11:00,25617ef3a4f29bb99a9ca6a80f6efeb4,0,1,0,0,0,1
2067,1702,2022-10-08 05:16:00,829a10a1b635ea45952f2a13fd76a292,0,2,0,0,2,4
2068,1702,2022-10-08 05:22:00,794fe2bd33cdaa3cd67e497dac7b33cc,0,1,0,0,1,2
2069,1702,2022-10-08 05:26:00,c8e6685eee4f1fe8bb5709918aa2daa0,0,7,1,0,0,8
2070,1702,2022-10-08 05:32:00,29e65ac7ce76d10be1f9f862fd14c42f,0,0,0,0,0,0
2071,1702,2022-10-08 05:38:00,16ff666993e062e2feb46211bc07f0b6,0,7,0,0,0,7
2072,1702,2022-10-08 05:41:00,d4fa160b4efcf4dee5a4582690da983e,0,7,0,0,0,7
2073,1702,2022-10-08 05:47:00,f03d6b75ef27d211637e1a0d4644cda2,0,0,1,0,2,3
2074,1702,2022-10-08 05:51:00,90e5edd41165ede5de1221e483066fcc,0,12,0,0,0,12
2075,1702,2022-10-08 05:56:00,6e34d34a7d1aaefa8f69ea8b1c85b989,0,3,0,0,0,3
2076,1702,2022-10-08 06:01:00,d357483de1c48d72a160524e118cc30d,0,10,1,0,0,11
2077,1702,2022-10-08 06:06:00,b2c003bea1fca0172aea4eee24be7581,0,1,0,0,2,3
2078,1702,2022-10-08 06:11:00,3828a36783ca8383b3cedf594d51af45,0,5,0,0,0,5
2079,1702,2022-10-08 06:17:00,30885ce8fa5a228b44f8c7a1572c4812,0,6,0,2,0,8
2080,1702,2022-10-08 06:22:00,f4b505e6044809a602399fc2ef216c41,0,9,0,0,1,10
2081,1702,2022-10-08 06:27:00,5c761239b26c1a46cabb923bed81f35a,0,5,1,0,0,6
2082,1702,2022-10-08 06:32:00,6fdf6f14874f008fe058185ab35a3ff4,0,16,0,0,0,16
2083,1702,2022-10-08 06:36:00,f1a8f4a84d27d0aa6ce2254a4782bc65,0,11,1,0,0,12
2084,1702,2022-10-08 06:41:00,567099135392b580a5a41a337c7b1554,0,13,0,0,1,14
2085,1702,2022-10-08 06:47:00,f626460448041fb7bdab527313f2477e,0,9,0,1,5,15
2086,1702,2022-10-08 06:52:00,c5b155f91a4ecd28f26877d38d6a6371,0,13,0,1,3,17
2087,1702,2022-10-08 06:57:00,048d859f5cded2006fbe6b5bef38d6f0,0,15,0,0,3,18
2088,1702,2022-10-08 07:02:00,7ba2877cbe75db6f26238638016ecf63,0,13,0,2,5,20
2089,1702,2022-10-08 07:07:00,bc18a3757ed0773717d365bada33dd71,1,13,0,1,8,23
2090,1702,2022-10-08 07:12:00,35fd9c5b2e09604843937dd331508996,0,10,0,0,4,14
2091,1702,2022-10-08 07:16:00,bae27eda95886b14db0c562d4b81f55b,0,9,0,2,4,15
2092,1702,2022-10-08 07:21:00,6df83ff7ff8c542b1246ab5db714a485,0,13,0,2,7,22
2093,1702,2022-10-08 07:27:00,e6eb53d2b0e1bac9c43725a58ab7d4c5,0,10,0,1,5,16
2094,1702,2022-10-08 07:32:00,80edfa980b434af49b6b20a7480c624a,0,6,2,0,7,15
2095,1702,2022-10-08 07:37:00,41420ad4d1c5a457ce7183555c3aa572,0,11,0,3,12,26
2096,1702,2022-10-08 07:42:00,e76eed5a88095e09d3afcef5f91963ca,0,13,0,1,7,21
2097,1702,2022-10-08 07:47:00,7ab962786881120882d0374a892fea40,0,7,0,0,8,15
2098,1702,2022-10-08 07:51:00,65cc5150077fd0640d715aba6f1ce64f,3,12,0,3,10,28
2099,1702,2022-10-08 07:56:00,6f8ed5a47f5856e410a0a025d6b33199,1,20,0,0,8,29
2100,1702,2022-10-08 08:02:00,29954b6cd0ebe7ef1f9047c0b9756f4e,1,12,0,2,5,20
2101,1702,2022-10-08 08:07:00,99185fff8d3885f06f59ffee9d7875a1,0,17,0,1,5,23
2102,1702,2022-10-08 08:12:00,fb99e3abb3e2612e0a2001139c415800,0,10,0,0,16,26
2103,1702,2022-10-08 08:17:00,b1d4ab67edb9d2bb6e29bdb4aef90732,1,7,1,1,14,24
2104,1702,2022-10-08 08:22:00,a84da3906d90b0ddb05ba12146f51bde,0,12,0,6,7,25
2105,1702,2022-10-08 08:28:00,89a97c0ef14bb8735939f930f99c3ed6,0,13,0,2,9,24
2106,1702,2022-10-08 08:32:00,d442365c47aeca444eb07635ed5fbd2f,0,6,1,1,19,27
2107,1702,2022-10-08 08:36:00,eab4200dd377624b9bdaf02972287f3c,0,7,0,2,14,23
2108,1702,2022-10-08 08:42:00,8f54e04699cbbb2e7afea7bce2832209,1,14,0,4,9,28
2109,1702,2022-10-08 08:47:00,7b9953c986d7b7fc8ff25c8e034dc41d,0,19,0,2,2,23
2110,1702,2022-10-08 08:52:00,db569c73c58ff51ea48191810c618ba1,0,14,0,3,14,31
2111,1702,2022-10-08 08:57:00,38fc0e81cd86110070d788968844a9af,0,16,0,2,10,28
2112,1702,2022-10-08 09:02:00,ff3e699f657cc8966918d165c5288e24,0,13,0,2,9,24
2113,1702,2022-10-08 09:08:00,bd337dded21693048cfaf95961555c83,0,12,0,0,8,20
2114,1702,2022-10-08 09:12:00,0ed0bcff36cbf8f9e45d217b59278f6b,0,16,1,3,12,32
2115,1702,2022-10-08 09:18:00,5dc59f4222df454aa2efef7361369957,1,15,1,1,12,30
2116,1702,2022-10-08 09:22:00,3b6bac0852cb82ee3a72a53c67f16e5e,1,16,0,2,11,30
2117,1702,2022-10-08 09:27:00,fa9e27e4fbaf018cccb0c53aa1eb2652,0,14,0,1,6,21
2118,1702,2022-10-08 09:32:00,3a70c336abdc4fd9d8998a9afc1df195,2,14,0,1,7,24
2119,1702,2022-10-08 09:37:00,f39117cd799d4ac9ed2317de9b737209,1,19,0,3,12,35
2120,1702,2022-10-08 09:42:00,17bad4c98a9067f189243f2fef735745,1,15,0,1,10,27
2121,1702,2022-10-08 09:47:00,49817c179a771054a27eaeb6035c98ed,0,15,1,0,10,26
2122,1702,2022-10-08 09:52:00,a7b1107f5c68e639e5c185fe73317872,0,18,0,4,4,26
2123,1702,2022-10-08 09:57:00,69c94f2b2767aa63e2d74c1d92ff445a,0,16,0,1,7,24
2124,1702,2022-10-08 10:02:00,1bd394c5d954078ef8dac7faeeef8823,0,15,0,2,14,31
2125,1702,2022-10-08 10:07:00,67c746489d6e03a8940b27ca95ae8dd7,0,13,0,1,13,27
2126,1702,2022-10-08 10:11:00,4dac157087928ed7be4a376e4e545729,0,16,0,3,9,28
2127,1702,2022-10-08 10:17:00,fdc6b141fdaf579c7b9890f6cfbb2077,0,10,0,6,13,29
2128,1702,2022-10-08 10:22:00,41964d254113ea7af51693bd2ef54eb6,0,14,1,5,11,31
2129,1702,2022-10-08 10:27:00,32073e2d3f25635addb6f33a545062d5,2,10,0,4,14,30
2130,1702,2022-10-08 10:33:00,058cb81ccbac6a8ddf472e849b9ecd74,1,12,0,2,11,26
2131,1702,2022-10-08 10:37:00,7b8037d89697717cfdb3e1a71eeac0a4,0,14,0,1,5,20
2132,1702,2022-10-08 10:42:00,c0b44bb3b7abb7086b600e58fb48e119,0,10,0,6,10,26
2133,1702,2022-10-08 10:47:00,c841876288371d751cb47795155a9912,0,15,0,0,11,26
2134,1702,2022-10-08 10:52:00,a634d5d390b89ff86097e602ea9ea517,0,21,0,0,8,29
2135,1702,2022-10-08 10:57:00,b1cc8cec45f58482d5c4100ed3b60f6d,0,17,0,7,8,32
2136,1702,2022-10-08 11:02:00,4e203ecc021750320b37909cd23ea7fc,1,12,0,1,18,32
2137,1702,2022-10-08 11:07:00,935040bf4ab3f15bebf0bfdcbf3ff424,0,18,1,2,10,31
2138,1702,2022-10-08 11:12:00,7c33ec1ad00ff6a97cbfc2013aaa601f,0,11,0,4,12,27
2139,1702,2022-10-08 11:17:00,db1b62a068cf05cb9b63d6157ff1254b,1,20,1,1,9,32
2140,1702,2022-10-08 11:22:00,e009617688b2c8c96ebbc5918e97374c,0,15,0,2,11,28
2141,1702,2022-10-08 11:27:00,5ad67dcff74b89a0d031b94c69cdc7b0,0,17,0,8,10,35
2142,1702,2022-10-08 11:32:00,a68714984f6eda8139876e63046d47cc,0,12,0,4,6,22
2143,1702,2022-10-08 11:37:00,812db887a0adb3c915d488380e3a441e,0,17,0,3,8,28
2144,1702,2022-10-08 11:41:00,dd13d34798fcc0908c95da5ad80200f6,1,15,0,2,9,27
2145,1702,2022-10-08 11:47:00,3c24d4acb3a12a580cfd24ce2c8fb229,0,13,0,5,8,26
2146,1702,2022-10-08 11:52:00,37354b45c4b6f3a99adf91b359300ef2,0,14,0,8,12,34
2147,1702,2022-10-08 11:56:00,5896d8c2fb8796fa74c151431bea2f3b,0,20,0,4,11,35
2148,1702,2022-10-08 12:02:00,44f578cd749d408a411379fb32d20c6e,0,23,0,3,5,31
2149,1702,2022-10-08 12:08:00,aff7c664b4693fffd3f9d3aad4dd3541,0,22,0,1,11,34
2150,1702,2022-10-08 12:11:00,6892a622ec8720db8f82361026d8203c,2,15,0,1,13,31
2151,1702,2022-10-08 12:17:00,e9e57326cff90cc387f186da25083fec,1,15,0,4,7,27
2152,1702,2022-10-08 12:23:00,bdd31d93476a028d5cbe16387450f4de,0,18,1,1,11,31
2153,1702,2022-10-08 12:26:00,b6b907a436eece18854f8e21ec9c7421,0,12,0,4,7,23
2154,1702,2022-10-08 12:31:00,57f0ea37f453986dcc6fac93961dca34,1,15,0,2,5,23
2155,1702,2022-10-08 12:37:00,b674d0fd78e0c86a9d11ddcaa219b450,0,17,0,1,8,26
2156,1702,2022-10-08 12:42:00,b8bd0976bdd7045775fc03534548460d,0,19,0,3,5,27
2157,1702,2022-10-08 12:47:00,ec648a53fb95ee108ca742530871b06b,0,12,0,5,4,21
2158,1702,2022-10-08 12:52:00,3a2420af4e9897b826a4f214d20d04fe,1,15,0,1,10,27
2159,1702,2022-10-08 12:56:00,0fe6262d7e257fd9b0e0a0ed1b81135b,0,17,0,3,8,28
2160,1702,2022-10-08 13:02:00,4ab0c61eec92e937b97c8d58b23cf0db,0,19,1,4,7,31
2161,1702,2022-10-08 13:07:00,639b5059c861fe1ba372d13de6c431ba,0,25,0,3,2,30
2162,1702,2022-10-08 13:11:00,c2ad510d2650ff5379f265fcc96a1083,0,20,0,12,3,35
2163,1702,2022-10-08 13:17:00,689033202f64f21e7a76600dac1f520d,0,17,0,13,5,35
2164,1702,2022-10-08 13:22:00,1ccebd62e8c818dfe6095d7b5dc9b41f,0,24,0,6,3,33
2165,1702,2022-10-08 13:27:00,1b6b7b02d4a73b1cfc1fdc5657aade46,0,24,0,7,11,42
2166,1702,2022-10-08 13:32:00,8234f3eaba3e939d2eda7e7e00fd3ebd,0,20,0,9,16,45
2167,1702,2022-10-08 13:38:00,587f3b7857adece151f4aca4ad93dfd8,0,26,0,9,3,38
2168,1702,2022-10-08 13:42:00,376c80b84772cdf04abde6f42200edb2,0,21,0,5,6,32
2169,1702,2022-10-08 13:47:00,92a8b38bb0694b097df5e7d5900e918a,0,28,0,8,4,40
2170,1702,2022-10-08 13:53:00,d0a1043ed43554e0febeabb2e6326a2e,0,26,0,11,7,44
2171,1702,2022-10-08 13:57:00,19ef8d9e688c4d092ffecddb9353b1af,0,22,0,6,8,36
2172,1702,2022-10-08 14:02:00,3ae0958aaa7f4796b49705dfac04475d,0,20,0,6,8,34
2173,1702,2022-10-08 14:07:00,48c1cd82e13ba8488ab1ce7770280ef6,1,22,0,5,14,42
2174,1702,2022-10-08 14:11:00,1777f262c318c3f13bb1e39614414160,0,25,1,6,4,36
2175,1702,2022-10-08 14:17:00,50ddf1031ce6870120cbda1da317dbb6,0,18,1,3,5,27
2176,1702,2022-10-08 14:22:00,fd1aef92e89675d44eed630779dff772,0,15,0,3,9,27
2177,1702,2022-10-08 14:27:00,639efb2d7fe448125c89eeaacabd586f,0,18,0,2,10,30
2178,1702,2022-10-08 14:32:00,21da567b14a089fa0afe2c66309f2035,0,9,0,3,14,26
2179,1702,2022-10-08 14:36:00,cee31dafd2127387c7574cf667c8b03e,0,22,1,2,6,31
2180,1702,2022-10-08 14:41:00,6eabcf07e5582337cbe5c44cc33e1fba,0,13,0,1,10,24
2181,1702,2022-10-08 14:47:00,67ff5e424c622f91014db15f1e412522,0,11,0,0,16,27
2182,1702,2022-10-08 14:52:00,9ee0af14306e40f0f5862e82cd7456d2,0,15,0,3,9,27
2183,1702,2022-10-08 14:57:00,d0a20b17f92e6fc21e727e3b45de0899,1,13,1,0,11,26
2184,1702,2022-10-08 15:02:00,1f3e8c7c4ef2515d7f0b6515a4611b8a,0,16,1,5,7,29
2185,1702,2022-10-08 15:07:00,95601b9a9c4a27d866ab2a2f9d75eedd,0,16,0,2,12,30
2186,1702,2022-10-08 15:13:00,92c3bec2fbfd4c3e490a57742da3a7de,0,15,0,1,10,26
2187,1702,2022-10-08 15:17:00,ecc93703e572ac2f06cc99fde9d01063,0,20,0,2,9,31
2188,1702,2022-10-08 15:23:00,65526355412efaa2be4134f11a3efae3,3,18,1,4,9,35
2189,1702,2022-10-08 15:26:00,a8360cb4ab2b9e348d1f15d622e188e0,1,22,0,4,4,31
2190,1702,2022-10-08 15:33:00,ade631eaf64524b1e3f88e0ab97aa787,1,19,0,1,9,30
2191,1702,2022-10-08 15:38:00,61d92764cd41e4086ed89ddc262492a5,0,19,0,1,12,32
2192,1702,2022-10-08 15:43:00,dab399480014d08854c904095e87a726,1,16,0,5,13,35
2193,1702,2022-10-08 15:47:00,39c54b91cac4839454659b7972f056e0,0,12,0,1,13,26
2194,1702,2022-10-08 15:52:00,ebe017ebd8e97d5236e7023d1d8d1d60,0,8,0,8,7,23
2195,1702,2022-10-08 15:57:00,ffb29ab03aef9ec9ce0e605be33c0d47,0,15,1,4,5,25
2196,1702,2022-10-08 16:02:00,74be05b8d383529070aef87a514ce661,0,15,0,4,7,26
2197,1702,2022-10-08 16:07:00,62a5267b81fb2eea635c257c2cabec9e,0,15,0,2,9,26
2198,1702,2022-10-08 16:12:00,63aadc09c1418bc08e7fbddb6e714015,0,16,0,2,5,23
2199,1702,2022-10-08 16:16:00,90e58184b34cfcee2f1b0d5dd11f9661,0,22,0,4,9,35
2200,1702,2022-10-08 16:22:00,84af94d1564bc66c304c3efbae38c638,0,10,0,1,12,23
2201,1702,2022-10-08 16:27:00,be6ba63dea6e6630c9f763b85a78dd74,0,9,0,6,8,23
2202,1702,2022-10-08 16:32:00,b4ed472da1cdc4e2d6ed66ffa4449daf,0,12,0,2,10,24
2203,1702,2022-10-08 16:37:00,fbc636da40a1930495d47a4c15a38378,0,14,0,0,7,21
2204,1702,2022-10-08 16:42:00,c695f524ba26e7b15d038e3c2c339c40,1,12,1,2,8,24
2205,1702,2022-10-08 16:47:00,f4b6fc603b587ed46d610d14c376d517,1,17,1,7,7,33
2206,1702,2022-10-08 16:52:00,d966957d314c5024fb40222d4e8e2a19,0,12,0,1,10,23
2207,1702,2022-10-08 16:57:00,3e1848e5b51dc417aa100f60d7c5090e,0,20,0,1,11,32
2208,1702,2022-10-08 17:02:00,76a9156bf620a1a84029a77c8f38ed66,0,25,0,1,8,34
2209,1702,2022-10-08 17:07:00,c462fe31e3d05f2064145a0f10167f01,0,14,0,3,10,27
2210,1702,2022-10-08 17:12:00,f4a43d7c8fc202b0dd47fed0296f6e43,0,20,0,1,5,26
2211,1702,2022-10-08 17:16:00,a06edf1b6acf10773d4413eed6fed970,0,10,0,9,7,26
2212,1702,2022-10-08 17:22:00,7094f2c213cd009b6befb5a8bf960436,0,14,0,1,7,22
2213,1702,2022-10-08 17:27:00,0bebf481f67c21c7b7f357242d0bb412,0,15,0,1,6,22
2214,1702,2022-10-08 17:32:00,6da4f754362f6906af01ef01d5452f43,0,19,2,3,7,31
2215,1702,2022-10-08 17:38:00,5a133c107b396e271ff5607ce7f8a067,0,15,0,2,10,27
2216,1702,2022-10-08 17:42:00,d59ca7d5e5075d30c9b8e04e42399a27,3,14,1,7,12,37
2217,1702,2022-10-08 17:47:00,4707a31bc5d8306a02e5acdee23f8e90,0,14,1,2,9,26
2218,1702,2022-10-08 17:52:00,680bd2b7e4a1411b3abaae44db76c69d,2,16,0,0,12,30
2219,1702,2022-10-08 17:57:00,3672533268de497cb50dfb9f7ceb4015,0,15,0,2,5,22
2220,1702,2022-10-08 18:02:00,52423d9cd3a1131f85e2bed068d9d4d1,0,14,0,0,10,24
2221,1702,2022-10-08 18:07:00,c5ec00ef6f2e4b4dce4077dbeac52648,1,18,0,2,10,31
2222,1702,2022-10-08 18:13:00,ffc41a20a9af96393bf61aabf2ed5adf,0,14,0,2,13,29
2223,1702,2022-10-08 18:17:00,8b5ac93451e50880008a620dab62f241,1,14,0,2,10,27
2224,1702,2022-10-08 18:22:00,808e59c11d475ee7f9f7f3239e318224,0,13,0,0,9,22
2225,1702,2022-10-08 18:26:00,9d75b0ed5293381edbecd86d708750fe,0,21,0,5,11,37
2226,1702,2022-10-08 18:32:00,d4a2ee8bab552579c41f3f41a40a4612,0,19,0,0,12,31
2227,1702,2022-10-08 18:37:00,b25c5eb657646ef018463fefb2c15722,1,18,0,3,10,32
2228,1702,2022-10-08 18:41:00,cebfb4696b6123f4f7abae2b6acac66f,0,25,1,0,10,36
2229,1702,2022-10-08 18:46:00,660af3d8932fd00c8ee435f90c6c13b7,1,22,1,2,5,31
2230,1702,2022-10-08 18:52:00,6403e4af9659f43c20abb7809f435da4,0,14,0,1,10,25
2231,1702,2022-10-08 18:56:00,67a550339660ef49a7741fdbb69b8a6d,1,22,0,1,6,30
2232,1702,2022-10-08 19:01:00,9f13b7568f224b86b142f7e711d544e3,0,28,0,1,5,34
2233,1702,2022-10-08 19:07:00,2ebf2a45815dd66c34a972657c58ffec,0,24,0,1,2,27
2234,1702,2022-10-08 19:12:00,07dadcdb63a243a4dc572bc3f971688c,0,23,0,0,2,25
2235,1702,2022-10-08 19:17:00,3620f4da5a4da5149a3dbf23986d1cff,0,26,1,0,1,28
2236,1702,2022-10-08 19:22:00,ec6729ff45b5a5ed4b59df10e8c89212,0,24,1,0,5,30
2237,1702,2022-10-08 19:27:00,ff1939e7a781bd436e1d434c966ccab5,0,14,1,0,0,15
2238,1702,2022-10-08 19:32:00,f7ac7d8e7a5f7f6128793666b1d2e805,0,16,3,0,0,19
2239,1702,2022-10-08 19:36:00,708c59888467387544713189c30fb69c,0,26,3,0,1,30
2240,1702,2022-10-08 19:42:00,f2bfd84a97dbfe38909768808e1e64a8,0,19,0,0,0,19
2241,1702,2022-10-08 19:46:00,82c8831ddb8d3875e7cc1c2d96239bd1,0,17,0,1,0,18
2242,1702,2022-10-08 19:52:00,f2d43d8f442e9a552a130e47b91198c2,0,13,1,1,0,15
2243,1702,2022-10-08 19:56:00,c3549d2523feb8f6b6d4be53c9cbb5c2,0,15,1,0,2,18
2244,1702,2022-10-08 20:02:00,bf58390c86568fb5d638d3e889a1ded8,0,23,0,1,0,24
2245,1702,2022-10-08 20:07:00,5dd19b76adb0dc426d2c615a0879d6a2,0,17,0,0,1,18
2246,1702,2022-10-08 20:11:00,e9e57aded46356ec1f2c84f13337db0a,1,22,2,0,3,28
2247,1702,2022-10-08 20:17:00,5f8f3ae1e59cf8630994f8ecf482a511,0,22,2,0,3,27
2248,1702,2022-10-08 20:21:00,035bc4923768bc714bd11749a8bde3f8,0,22,0,1,1,24
2249,1702,2022-10-08 20:26:00,64332e957d2c89f6fa634060b5b3425e,0,16,0,0,4,20
2250,1702,2022-10-08 20:31:00,5db7a6c621f89b8fddd07387cf86713b,0,25,0,0,2,27
2251,1702,2022-10-08 20:36:00,ed5f45f54d53ba7afdf4ac26ddf2cb90,0,22,2,1,0,25
2252,1702,2022-10-08 20:41:00,e9d543ff35e0db2f59414a19e31d828a,0,17,4,1,1,23
2253,1702,2022-10-08 20:47:00,51261dd0a4f80f47a2f51f0f7762b77f,0,23,1,0,4,28
2254,1702,2022-10-08 20:52:00,d95243cb632841b0d1a02266065949e3,0,32,0,0,1,33
2255,1702,2022-10-08 20:56:00,503dce3b949a9a2fe01b5ca32b20f925,0,22,0,0,1,23
2256,1702,2022-10-08 21:01:00,928edea24b5e0b1c5d179d5618bca5db,0,22,0,0,1,23
2257,1702,2022-10-08 21:07:00,6a03a8c2c66f6c3a4fc0f01bfe464082,0,25,0,0,0,25
2258,1702,2022-10-08 21:11:00,09c4d74b3582179d8080b018685ca8b5,0,25,2,1,0,28
2259,1702,2022-10-08 21:16:00,626c53622cb81a7bbd6b7f862de301a9,0,22,1,0,1,24
2260,1702,2022-10-08 21:21:00,e3788b17c9c51b7c9e2124f60fa5ab0c,0,16,1,0,0,17
2261,1702,2022-10-08 21:26:00,eb69a82c0aa3ed32a472ec5fb18260ed,0,10,0,0,1,11
2262,1702,2022-10-08 21:32:00,e0adf32f8887fd0b526273ff43bf0d41,0,18,0,3,2,23
2263,1702,2022-10-08 21:36:00,e570e248a9202993ec4b0460cbb5589b,1,17,0,0,1,19
2264,1702,2022-10-08 21:42:00,5c11ab52b89190f98371dac64d670fea,0,18,0,0,0,18
2265,1702,2022-10-08 21:46:00,cd758453f1d62c021d7be8736268c54b,0,19,0,1,1,21
2266,1702,2022-10-08 21:52:00,292cd77fd54b66c8b2b5bd9ea3fa63d6,0,20,0,0,1,21
2267,1702,2022-10-08 21:56:00,dc3c5a706f4214d03d8ced0c5538c24e,0,29,0,0,0,29
2268,1702,2022-10-08 22:02:00,4d970599b28935715b3a0bdfba572bb5,0,20,0,0,1,21
2269,1702,2022-10-08 22:07:00,f1652742f1a877620b98ef77940d781b,0,18,0,0,2,20
2270,1702,2022-10-08 22:11:00,351c1586448ceabc38d748c07940dbce,0,30,0,0,0,30
2271,1702,2022-10-08 22:17:00,3bf358730506274120630124cccf83d7,0,22,0,0,0,22
2272,1702,2022-10-08 22:22:00,8c0562c68206583bd7179af3ad1e6134,0,20,0,0,0,20
2273,1702,2022-10-08 22:26:00,640d5dd1542ead9e8e363baf8d656387,0,19,2,0,0,21
2274,1702,2022-10-08 22:32:00,32460600df86d80bef0edf9a5860ccdf,0,14,1,0,2,17
2275,1702,2022-10-08 22:36:00,1eea2ada611bba714f0ed13333fb36a7,0,18,0,0,2,20
2276,1702,2022-10-08 22:41:00,153a1cf6c85e73293c94d9e1d010ad89,0,16,2,0,1,19
2277,1702,2022-10-08 22:46:00,596d5a76395248cd711bfe04e17e55f1,0,26,1,0,1,28
2278,1702,2022-10-08 22:51:00,592750da3c13ba8f56a9544869b953d7,0,17,0,0,1,18
2279,1702,2022-10-08 22:56:00,8a079740d839547d7a2bcde23ba45bc5,0,16,1,1,0,18
2280,1702,2022-10-08 23:02:00,a9112fb8f8da0e2e91431c7750bb91ff,0,13,1,2,1,17
2281,1702,2022-10-08 23:06:00,cbbd1b9a4fd4340754793be8ba0f6515,0,20,1,0,0,21
2282,1702,2022-10-08 23:12:00,66fdb5a5faf900449674562e8c1fa704,0,10,0,0,1,11
2283,1702,2022-10-08 23:16:00,0c55a94541687d8483d4020ff212568b,0,17,0,0,0,17
2284,1702,2022-10-08 23:22:00,bf045ecdbff47765cdbba29a8733d16c,0,18,1,0,0,19
2285,1702,2022-10-08 23:27:00,a0597dde32a4e272093c0826a4c226b6,0,11,1,0,4,16
2286,1702,2022-10-08 23:32:00,330c8e2d57dc43022414183e60e7d418,0,24,0,0,1,25
2287,1702,2022-10-08 23:37:00,f0c90954df7bd157d6d1c3265f4017d2,0,14,1,0,2,17
2288,1702,2022-10-08 23:41:00,b0d7ec34649d1a4eddfe0156f10b787a,0,22,0,0,3,25
2289,1702,2022-10-08 23:47:00,c0655de49a190c68cc5c079f7034c8e7,0,13,0,0,0,13
2290,1702,2022-10-08 23:52:00,cf900e9834a8e0805101a38471ecd459,0,7,1,0,0,8
2291,1702,2022-10-08 23:57:00,912f6d9bfe1ec5a953a82c9d2a832412,0,2,0,0,0,2
2292,1702,2022-10-09 00:03:00,555cbfc54e4e56f48dc0434a40edac66,0,8,2,0,0,10
2293,1702,2022-10-09 00:07:00,436b1023c1e3872a603e33cce51758c4,0,12,0,0,0,12
2294,1702,2022-10-09 00:11:00,74de69410c37ac249a5992c899d53021,0,7,0,0,0,7
2295,1702,2022-10-09 00:18:00,96698471727d95ad21f8c7df1f9778ca,0,13,1,2,0,16
2296,1702,2022-10-09 01:52:00,cd909143aa4652e637b856fc78bf84d8,0,12,0,1,4,17
2297,1702,2022-10-09 03:02:00,9aa71b6c5ea143d8eeff2935e244a4d3,0,10,0,0,1,11
2298,1702,2022-10-09 03:08:00,8a553429d54133a37bca9556d8374c39,0,5,0,0,0,5
2299,1702,2022-10-09 03:18:00,bbaa6f452eaf756a75295363bffdd6fd,0,3,0,0,0,3
2300,1702,2022-10-09 03:21:00,8dd1e3a52a4373c85335134168770b1c,0,7,0,0,0,7
2301,1702,2022-10-09 03:26:00,baa403948a128a643bb971e5cf9349e7,0,9,1,1,0,11
2302,1702,2022-10-09 03:33:00,57b695a33d1ba73bc1b032b583e9bca7,0,9,0,0,0,9
2303,1702,2022-10-09 03:37:00,bf3b9cd2edfd447555cbb63e239957cc,0,7,0,0,0,7
2304,1702,2022-10-09 03:42:00,3a2da02269a6bd5574aedd79c913abf1,0,5,1,0,2,8
2305,1702,2022-10-09 03:46:00,7da6e99647d033fc128e2ac71e6e6507,0,9,0,0,1,10
2306,1702,2022-10-09 03:52:00,44dbb5b55a21356805e1f80528e4347e,0,7,0,0,0,7
2307,1702,2022-10-09 03:56:00,ed921a41f01d1af0e83d83904a71a454,0,6,0,0,0,6
2308,1702,2022-10-09 04:02:00,9a4fa20652f8d659153a3b93ad6c7fc9,0,11,0,0,1,12
2309,1702,2022-10-09 04:08:00,ef9093a35030eff6ea2cb880e03e9642,0,7,0,1,0,8
2310,1702,2022-10-09 04:12:00,622cabda61d426226428c079eaa05f19,0,2,0,0,1,3
2311,1702,2022-10-09 04:17:00,f921ad38971ec4a323030f94445fd12a,0,3,0,0,0,3
2312,1702,2022-10-09 04:23:00,afb1f73ffb84672613fe50cc67e57f1a,0,10,0,1,1,12
2313,1702,2022-10-09 04:27:00,48eb1a033823d33fe824c5b7870a859d,0,3,0,0,0,3
2314,1702,2022-10-09 04:41:00,d8e4a97253054fd1972b9bb41adf575f,0,2,0,0,0,2
2315,1702,2022-10-09 04:46:00,47b2c7f791cbf760717360a44ac9bd40,0,8,0,0,0,8
2316,1702,2022-10-09 04:52:00,ddea1be417ab86ea1ad2e3bcae8c4296,0,6,0,0,0,6
2317,1702,2022-10-09 04:56:00,b8f0d81383487bce3dc8ae1b01007c64,0,5,0,0,0,5
2318,1702,2022-10-09 05:03:00,390460155e55b518ece8e2bff634d0dd,0,8,0,0,1,9
2319,1702,2022-10-09 05:08:00,2a2a5cfa97d9d4ee1859c2c367ab9966,0,3,0,0,0,3
2320,1702,2022-10-09 05:12:00,cf823d7e09c67a37714b49b1ea2871bf,0,11,0,0,1,12
2321,1702,2022-10-09 05:18:00,95b9cc37828c469bb48e6cbf91ee3931,0,8,0,0,0,8
2322,1702,2022-10-09 05:21:00,a1147053ea14723fbed756b0ff3a979e,0,5,0,0,2,7
2323,1702,2022-10-09 05:27:00,739cf3ce5a26b0a2b23a8130901787d4,0,5,1,0,0,6
2324,1702,2022-10-09 05:32:00,c264bcacfcfc69b9bac0c3536b368589,0,2,0,0,1,3
2325,1702,2022-10-09 05:37:00,98ee9e8058a6ea5d4ec2f44a623bb1e7,0,7,0,2,0,9
2326,1702,2022-10-09 05:42:00,0f1b5536267076c5b298d83571fd5776,0,2,0,0,0,2
2327,1702,2022-10-09 05:47:00,4a0b63916afe9f642dc6c692a8e0d725,0,4,1,0,0,5
2328,1702,2022-10-09 05:52:00,5a5ec015d87a8bff87b94864f13d0766,0,8,0,0,0,8
2329,1702,2022-10-09 05:56:00,8fd91a7d70a55990b694fddd95cf8771,0,7,0,0,0,7
2330,1702,2022-10-09 06:03:00,5a60bc5497776cec46fb3a846107bea6,0,5,0,0,0,5
2331,1702,2022-10-09 06:07:00,c81863ddf065309a2292d52d32d6f145,0,3,1,0,0,4
2332,1702,2022-10-09 06:11:00,3494fea739666ac766a2c943e5655c6b,0,7,0,0,0,7
2333,1702,2022-10-09 06:17:00,3b040fbdaa760180b3eddb3a9f5da1fe,0,8,0,1,2,11
2334,1702,2022-10-09 06:21:00,7b6e00d6a7d655cd25614ca90f2e2fb9,0,7,0,0,1,8
2335,1702,2022-10-09 06:27:00,1b4856f623436ecc5ba40570d93f518b,0,3,0,1,1,5
2336,1702,2022-10-09 06:31:00,a797ebfc3f584168347420afdd9b6746,0,13,0,0,2,15
2337,1702,2022-10-09 06:36:00,6b70cd1a824b059f4fa7400adabc8ee8,0,13,0,0,0,13
2338,1702,2022-10-09 06:41:00,2b12cdfce437e907e44062ea4eccf618,0,11,2,0,0,13
2339,1702,2022-10-09 06:47:00,9991af6bef81f3450705e5b5055d9d3c,0,14,1,0,2,17
2340,1702,2022-10-09 06:52:00,3e1d6a7e350d0e326d90112a1011e13a,0,11,0,0,1,12
2341,1702,2022-10-09 06:57:00,9f1405adde2fdc2b8dbbc94ff87dbafc,1,7,0,0,4,12
2342,1702,2022-10-09 07:02:00,c3ed1dba4442cce570caa243f9b22cda,0,11,0,0,1,12
2343,1702,2022-10-09 07:08:00,00ae3af24084fe13de74a5282c7bf9e8,0,13,0,0,5,18
2344,1702,2022-10-09 07:13:00,733c7b47564ecd61c2bce2662566efb8,0,11,0,0,4,15
2345,1702,2022-10-09 07:17:00,0f68f049faa7bb1d14ccdf47d926712c,0,13,0,0,4,17
2346,1702,2022-10-09 07:23:00,d923fedefb5214571efbf58160174969,0,3,0,0,4,7
2347,1702,2022-10-09 07:27:00,069cc0c39d37f88f7aab0f65e5936f24,0,14,0,0,5,19
2348,1702,2022-10-09 07:33:00,632a101ff8d8a8b464e0efed9f442d9f,0,10,0,0,0,10
2349,1702,2022-10-09 07:37:00,54dd4bc9eec3e76de1485af2267fb7ef,0,2,1,1,0,4
2350,1702,2022-10-09 07:42:00,4da0304bec8e741654bec068929579c6,0,11,0,0,2,13
2351,1702,2022-10-09 07:49:00,e4a7d81c59554beb98545aafeb9e4df9,1,7,0,1,0,9
2352,1702,2022-10-09 07:52:00,6f96fe69b1e329dad2803c7a46c36e33,1,4,0,0,3,8
2353,1702,2022-10-09 07:57:00,ae5adbfcd287d204110715fd593acb20,0,11,0,3,0,14
2354,1702,2022-10-09 08:04:00,f68fe479c8da0273dfd0eb87d84c74e5,0,7,0,0,5,12
2355,1702,2022-10-09 08:08:00,77a6cd638656df3abd113425afea3eb2,0,7,0,1,7,15
2356,1702,2022-10-09 08:14:00,42e0467370adb12840d079a2e4713847,0,13,0,3,6,22
2357,1702,2022-10-09 08:18:00,89950975a83d99f8e44ac0a5ca9af3e0,0,12,0,0,4,16
2358,1702,2022-10-09 08:23:00,822b48543f668ab90c865c94728ab92e,0,13,0,0,8,21
2359,1702,2022-10-09 08:27:00,a90165b289ff370a34a6069b98c974b9,0,15,0,1,7,23
2360,1702,2022-10-09 08:32:00,c6211fe72892c0b7d15380e6c4b6ef48,0,10,0,0,9,19
2361,1702,2022-10-09 08:37:00,1ef025a5d86cbd05f21a12c3469974d5,0,13,0,1,6,20
2362,1702,2022-10-09 08:43:00,3188e215000c9cfb360568c69c871c17,0,10,0,0,11,21
2363,1702,2022-10-09 08:49:00,2a824d3cebdeb47a41016223a5799610,2,19,0,1,6,28
2364,1702,2022-10-09 08:53:00,6d0a469b4bf85b8e1bebd0eaba423a96,0,14,0,1,9,24
2365,1702,2022-10-09 08:59:00,30fae037d800c8abedc7c2f66ef58e7c,0,17,0,0,7,24
2366,1702,2022-10-09 09:03:00,59413aacbcbd75448fb7c161a73b74eb,0,14,0,2,4,20
2367,1702,2022-10-09 09:07:00,f8ebf7b11fa7dab1cfa0e2ff37bac124,0,19,0,1,6,26
2368,1702,2022-10-09 09:12:00,2ffba5dc1e2aa3a024ef7d41008091f8,0,16,0,2,2,20
2369,1702,2022-10-09 09:18:00,88e80acc8b2cb8984ab1c577d2cb276a,0,14,0,0,2,16
2370,1702,2022-10-09 09:23:00,72a8a4635f9fc932bba3b1b244c33ef4,1,12,1,1,5,20
2371,1702,2022-10-09 09:28:00,2a9f48a03380fcdb52f2204873a085d5,1,16,0,1,3,21
2372,1702,2022-10-09 09:32:00,1ecd0fe544a66430c9e9364981b34f92,0,14,0,1,7,22
2373,1702,2022-10-09 09:38:00,874fbc7bb0f06ad26e8d96e60e245300,0,16,1,1,10,28
2374,1702,2022-10-09 09:43:00,98724a9e4ea3ed063b40ec007b595800,0,12,0,2,8,22
2375,1702,2022-10-09 09:47:00,d9d914cb5876db36d1bbb217aa6c91d9,0,12,0,2,5,19
2376,1702,2022-10-09 09:52:00,43175ed3a3264f55643f5fe384c194b0,0,14,0,3,7,24
2377,1702,2022-10-09 09:58:00,9b4c6694b77c0eb7cc90edb85e6586a2,0,12,0,3,7,22
2378,1702,2022-10-09 10:04:00,feb80062fa59046960a68cb519749141,1,16,0,1,11,29
2379,1702,2022-10-09 10:08:00,bf007c0f943c993be7c9f0c7a501b1cf,0,13,0,1,4,18
2380,1702,2022-10-09 10:13:00,8bb7a27968cd1f9a00c79b4d609f9e75,0,10,1,1,12,24
2381,1702,2022-10-09 10:19:00,340fcd927438491f0f237dc1fbc83917,0,13,0,3,4,20
2382,1702,2022-10-09 10:22:00,724baad81a70d3ebd2a1065b9674aafb,0,18,0,1,8,27
2383,1702,2022-10-09 10:27:00,1f3cfd9895610c5c64c695031c119b7f,0,12,0,0,3,15
2384,1702,2022-10-09 10:32:00,7c53a9c5174a29436cf0e8bd4ffd484d,0,15,0,0,9,24
2385,1702,2022-10-09 10:38:00,140eaf018949505d3a81414e7531b4bb,1,14,0,2,9,26
2386,1702,2022-10-09 10:44:00,f02b9815ccd5bec3ce56e82f70dd3905,0,13,0,1,14,28
2387,1702,2022-10-09 10:48:00,823277b49fefaffc08c93d4e64f1d7a6,0,14,0,1,7,22
2388,1702,2022-10-09 10:53:00,3d1257cdf6bd21ac371ba91acf0b6c09,0,11,0,1,11,23
2389,1702,2022-10-09 10:59:00,5c6ff64bef5a0ea5229a965a2d9a89f6,0,15,0,3,5,23
2390,1702,2022-10-09 11:03:00,97e4d053a84b799aaf06711b190c1f14,0,10,1,2,12,25
2391,1702,2022-10-09 11:08:00,a62f8c03886bf8d7862ee875ee2f88aa,2,14,1,1,10,28
2392,1702,2022-10-09 11:13:00,7d4875a31c0448f6151ddcc18dc7beba,0,10,0,1,10,21
2393,1702,2022-10-09 11:17:00,7b14e3f845495f29ef28aef47606cfa5,0,17,0,2,10,29
2394,1702,2022-10-09 11:23:00,7e6aa66b446ec0b81431bf537fcdc277,0,20,0,0,6,26
2395,1702,2022-10-09 11:28:00,5b882e8792ecd4dca0f036665765295c,0,17,1,4,5,27
2396,1702,2022-10-09 11:32:00,cbb838e2f38f7b2b1977c8791158a523,1,16,1,4,3,25
2397,1702,2022-10-09 11:39:00,5393bcb7891d3ce29221e974c41f3132,0,10,0,2,8,20
2398,1702,2022-10-09 11:43:00,65fad2993f75602f178a3d2bf87f5aa9,0,15,0,3,6,24
2399,1702,2022-10-09 11:47:00,fa13734085c670079fe7e57833742704,0,14,0,1,8,23
2400,1702,2022-10-09 11:52:00,3a81541d99ae400089540da90c4c70bf,0,13,0,2,4,19
2401,1702,2022-10-09 11:58:00,6615212ab7e99a7762f53d879e5f99f0,0,20,0,3,5,28
2402,1702,2022-10-09 12:03:00,1b0197b931facbd279a8801cdc1d2cb3,1,15,0,6,2,24
2403,1702,2022-10-09 12:08:00,dac7e4a3cf6813b094e691692a83c8b1,0,10,0,2,12,24
2404,1702,2022-10-09 12:12:00,12b4f7022312d1f3379b563b5e55c87f,0,17,0,1,8,26
2405,1702,2022-10-09 12:18:00,532f02d038c875ce3965f332a9b75bfd,0,13,0,1,10,24
2406,1702,2022-10-09 12:23:00,9b451266b1713bb31d4192efb6dfa427,0,18,0,4,3,25
2407,1702,2022-10-09 12:28:00,6f564e54f67d6f9a116d89ded117f111,1,19,0,3,4,27
2408,1702,2022-10-09 12:31:00,eb5fb01f19e7affd0a9fa52dd6fc988f,0,15,0,0,6,21
2409,1702,2022-10-09 12:38:00,a8dcca764a94fc60696d37635ec22211,0,15,0,1,9,25
2410,1702,2022-10-09 12:42:00,d97a72d5e980971a30df13e39e0560c8,0,16,0,2,5,23
2411,1702,2022-10-09 12:48:00,1479f63bcd01a72de40ba02971bebcea,0,20,0,3,4,27
2412,1702,2022-10-09 12:53:00,3bc3e4ef591d8601a011b87b74f5e1ae,0,15,0,9,1,25
2413,1702,2022-10-09 12:57:00,4b8b79f6cdf35d8df5358a441cef50a6,0,15,0,4,4,23
2414,1702,2022-10-09 13:02:00,f51428591f135918cd5859803e4228f5,1,15,0,2,4,22
2415,1702,2022-10-09 13:08:00,4e946993518a2eb21eb37b4653337ac8,0,21,1,3,2,27
2416,1702,2022-10-09 13:13:00,6bae02535e29c351daded659b94a6ac2,0,18,1,2,6,27
2417,1702,2022-10-09 13:18:00,75d4667ae528fe36cec1eb201f382afa,0,13,0,4,8,25
2418,1702,2022-10-09 13:23:00,71550c76dcf328556259c54d201ab9a9,0,14,0,1,7,22
2419,1702,2022-10-09 13:27:00,ea1d58cf29d18d966b4cb073e6439d1f,0,12,0,4,11,27
2420,1702,2022-10-09 13:32:00,4377709ef7c95720f462cca6d069a3b3,0,12,0,4,8,24
2421,1702,2022-10-09 13:37:00,7454afd1176011200a80d92cdfc1c6c5,3,15,0,2,14,34
2422,1702,2022-10-09 13:42:00,3838f1c4dd101d1e8e7ea048d92cb35d,0,17,0,3,7,27
2423,1702,2022-10-09 13:47:00,353cdc35f7b6a9b04b3d0b58cd2d98cd,0,13,0,1,8,22
2424,1702,2022-10-09 13:53:00,48b9f1623f98ca1dfe71da961a9e877d,0,15,0,1,5,21
2425,1702,2022-10-09 13:57:00,9fbea8e45dbcbe41eb10a4c4335050e0,2,15,0,2,10,29
2426,1702,2022-10-09 14:03:00,21f2fa94181f0532986e3f030e34b682,0,15,0,0,10,25
2427,1702,2022-10-09 14:08:00,9c84c54e21f694ab96efd658ef7fd9ef,0,21,0,1,7,29
2428,1702,2022-10-09 14:12:00,a7e5e5e20345ae46fba4f0ba2b909d28,0,12,0,2,8,22
2429,1702,2022-10-09 14:19:00,49796297531c67addd88d70883074ede,0,6,0,0,17,23
2430,1702,2022-10-09 14:23:00,fa727fca443b704d849508b5cf971d3f,0,17,0,2,9,28
2431,1702,2022-10-09 14:27:00,7c76046b93f62c6ed47a2195d2beced3,0,16,0,1,9,26
2432,1702,2022-10-09 14:33:00,3ccba1ec9fdd98d752f88c4b6d3e1a6c,1,17,0,4,11,33
2433,1702,2022-10-09 14:39:00,875fc1df3b0a8cf597ea990d6132b3e7,0,15,0,2,6,23
2434,1702,2022-10-09 14:42:00,99e3aa53e690b025ec6d9a16dafff459,0,23,0,1,5,29
2435,1702,2022-10-09 14:47:00,faf7f2cc092f781cf0e9e9c31f8d64f7,1,15,0,5,7,28
2436,1702,2022-10-09 14:52:00,590406b45b493a121a15b6b3c5075ff9,0,17,0,2,12,31
2437,1702,2022-10-09 14:58:00,33c0cd44e22462636a7b7116623f2fbc,0,16,0,4,7,27
2438,1702,2022-10-09 15:02:00,693a2b8d8999e07b3f8c6f237bc768ba,0,16,0,5,7,28
2439,1702,2022-10-09 15:08:00,dc74aceb26569aa18117a89147d1f7d4,0,16,0,3,6,25
2440,1702,2022-10-09 15:12:00,b432cd907d0bc1af0569b689bea8aa11,0,12,0,1,9,22
2441,1702,2022-10-09 15:17:00,f4dfc0033cd0d2cf2a102a7183171b26,1,4,0,1,13,19
2442,1702,2022-10-09 15:23:00,a16931ed35d306556a1f8ba121128867,0,16,2,0,7,25
2443,1702,2022-10-09 15:28:00,7c00c825a74a225c49145cd0bd63e25f,1,15,1,2,7,26
2444,1702,2022-10-09 15:32:00,1c220a05e1cbaefb53a4524e7dd157e8,1,14,0,1,10,26
2445,1702,2022-10-09 15:37:00,bf4a6790337607f796b9d49d71430d11,1,20,0,0,7,28
2446,1702,2022-10-09 15:42:00,5a2b0df79ad290bda15d4af07ac59c3c,0,16,0,2,13,31
2447,1702,2022-10-09 15:48:00,430da243b3b9b0f69d9e26fb6084b749,0,20,0,0,7,27
2448,1702,2022-10-09 15:53:00,f7c7476f1c2366817c5f68fdb115c038,2,14,1,4,9,30
2449,1702,2022-10-09 15:56:00,a0545421792c54357b80a13e7307dde7,0,14,0,4,5,23
2450,1702,2022-10-09 16:02:00,4f0621413e46ff71b4db5a6685ce26ab,0,17,0,0,6,23
2451,1702,2022-10-09 16:07:00,94d5b1e47035e215f7a25828211c0754,0,12,0,1,10,23
2452,1702,2022-10-09 16:12:00,0a00791dbd184eadbbbdc75687d5e0db,0,23,0,0,7,30
2453,1702,2022-10-09 16:23:00,e45638c8089e3e1fc8c1bbfa5edae43f,0,13,0,3,9,25
2454,1702,2022-10-09 16:27:00,303dd60c998e93810d02928181e89cc2,0,12,0,1,12,25
2455,1702,2022-10-09 16:33:00,eb1c5ecdba19ae22876d025ce521de16,2,12,1,2,7,24
2456,1702,2022-10-09 16:37:00,291dae61fd67c695643841a9f8f4baa1,0,11,0,5,9,25
2457,1702,2022-10-09 16:43:00,e8bdf0333447c3382de2e6da1b852ccb,0,21,1,3,9,34
2458,1702,2022-10-09 16:48:00,c4c5cfc39e87af715a4bf71711e00dda,0,14,0,4,7,25
2459,1702,2022-10-09 16:53:00,7f67df02b1447f41e1e3a4804938e0f0,0,15,0,1,9,25
2460,1702,2022-10-09 16:57:00,d5472a61702d1fdcf7793c789a762abd,0,11,1,1,9,22
2461,1702,2022-10-09 17:03:00,173e70f8d2ffe6d4d8f03cd7efe8c952,1,16,0,1,9,27
2462,1702,2022-10-09 17:08:00,9587db8fa8c2987e226c41cff668e57b,0,21,0,1,6,28
2463,1702,2022-10-09 17:12:00,76fd97de523525134523ade0c9e1f5cd,0,13,0,2,9,24
2464,1702,2022-10-09 17:18:00,ae6509f4950b5c8f88a9ed25cab4a6d0,0,8,0,1,14,23
2465,1702,2022-10-09 17:22:00,555e27dc464a065a98a1932aade1b31c,0,15,0,1,6,22
2466,1702,2022-10-09 17:28:00,575a518fdfb8e5e4ff9394fdbce31995,0,11,0,4,7,22
2467,1702,2022-10-09 17:33:00,83be18f1b9d853acdd1713b673c3215d,0,18,0,4,5,27
2468,1702,2022-10-09 17:38:00,403b42559d7f92261c10479e4cdade97,0,14,1,0,10,25
2469,1702,2022-10-09 17:42:00,1fd119fa121e07d01f087a0018a12704,1,16,0,1,8,26
2470,1702,2022-10-09 17:47:00,c3fbe8e646cd9d9bf3e0bd832b7e8e22,0,14,0,0,12,26
2471,1702,2022-10-09 17:53:00,0baeb9087c9b9f66a1b8856f884723de,0,14,0,1,10,25
2472,1702,2022-10-09 17:58:00,7ed2079e5fd75bd20138d3da958379e5,1,9,0,1,12,23
2473,1702,2022-10-09 18:02:00,e154fead495aa6469360325d8729e495,1,17,2,0,3,23
2474,1702,2022-10-09 18:07:00,f4b0b2b24a6c128ffac98f530b82182c,3,14,0,2,9,28
2475,1702,2022-10-09 18:13:00,4e460a5f3e17228b0532685c289cfdeb,0,15,0,1,11,27
2476,1702,2022-10-09 18:18:00,bb0fe7b9b7c2f546b0ff19dd52b26305,0,19,0,1,8,28
2477,1702,2022-10-09 18:23:00,35b8220c5d786f17a2019ea88ebbb4d6,0,17,1,0,9,27
2478,1702,2022-10-09 18:27:00,e60bbb40da1c6925e695e90dd424414d,0,14,1,0,9,24
2479,1702,2022-10-09 18:32:00,5648d92917e7c922811cf360884b4d00,0,17,0,0,4,21
2480,1702,2022-10-09 18:37:00,5d3377f626405979fe4bd4c067a732d1,0,15,0,1,9,25
2481,1702,2022-10-09 18:42:00,a1b82c69a0acbbbcb4b30caae84e50eb,0,19,1,3,4,27
2482,1702,2022-10-09 18:47:00,739a31d0f2ab243a5ff503d26eb12807,0,13,0,0,7,20
2483,1702,2022-10-09 18:52:00,19b7eb7482643f1c7d59c23b746a70c7,0,12,1,3,10,26
2484,1702,2022-10-09 18:57:00,02e46f2fce506db9269d4cac7864898e,0,15,0,0,5,20
2485,1702,2022-10-09 19:02:00,cf1d5d571ccbab10010a0bbe191e1261,0,19,1,0,5,25
2486,1702,2022-10-09 19:07:00,e8a45f04d1e9ce3a7dfa12cf9f204f6f,0,22,0,2,3,27
2487,1702,2022-10-09 19:12:00,140c95205dd2ef3c977ccf5dbb9bd5a7,0,17,2,0,0,19
2488,1702,2022-10-09 19:17:00,c0c6ad7c769d34999b803c8f0e6dd38c,0,19,0,0,1,20
2489,1702,2022-10-09 19:22:00,50a497acaa576c82cc3fb20397cdd830,0,14,0,0,0,14
2490,1702,2022-10-09 19:26:00,b3869560071d46c5c6ae88779be75453,0,11,0,0,0,11
2491,1702,2022-10-09 19:33:00,cea784c2310b4e86b8da6d19f0936f30,0,14,1,0,0,15
2492,1702,2022-10-09 19:37:00,aafc3b6da01c3242c447e89c3472c42f,0,19,2,0,0,21
2493,1702,2022-10-09 19:42:00,1ea1f19607101baba59cad651be55b17,0,16,0,1,0,17
2494,1702,2022-10-09 19:47:00,d489c0753ed78b3ada959c1da276b88b,0,15,0,0,3,18
2495,1702,2022-10-09 19:52:00,06b48bc58edc1e6112e69c6f5406ec62,0,22,1,0,0,23
2496,1702,2022-10-09 19:56:00,590993fe6e25758310dfd018e3eb57e2,0,15,0,1,1,17
2497,1702,2022-10-09 20:02:00,dc3f5f53cc23c0601e60e5805d911c76,0,16,0,1,0,17
2498,1702,2022-10-09 20:07:00,c64e567a4389de7aa16a58a71740adb9,0,12,1,1,0,14
2499,1702,2022-10-09 20:12:00,3ca112c663c5bde09ba6d808e4eaa52d,0,25,0,0,2,27
2500,1702,2022-10-09 20:17:00,12e73844628c0d6d8a355e45b5f03f1d,0,17,1,0,0,18
2501,1702,2022-10-09 20:23:00,35cd1ea8e3f83c0d6ce1e467a7a5e74d,0,24,3,2,0,29
2502,1702,2022-10-09 20:28:00,bf6df174118b00162c02943e10e3bb30,0,16,0,0,1,17
2503,1702,2022-10-09 20:33:00,76431404d78f0708cfe13be7c77450ff,1,11,0,1,1,14
2504,1702,2022-10-09 20:38:00,eaafc7be57028bc67d809b8350022589,0,9,2,0,1,12
2505,1702,2022-10-09 20:43:00,2d88bb7f415aac73652b9d5cfe466cf0,0,17,1,0,1,19
2506,1702,2022-10-09 20:47:00,6460800760cadf0487ef663e46f0cbc5,0,20,3,0,0,23
2507,1702,2022-10-09 20:52:00,8e7351394f78bdd05c19fa2babecf95a,0,11,0,0,0,11
2508,1702,2022-10-09 20:57:00,2e0bfcdf3cba308ab7d32724d69fc9fa,0,16,0,0,3,19
2509,1702,2022-10-09 21:02:00,abf16291cb83f6729cb9ec759a794a41,0,20,1,0,0,21
2510,1702,2022-10-09 21:08:00,d9c663398f71fbc1d020cdbc1f22a623,1,14,1,0,1,17
2511,1702,2022-10-09 21:11:00,dadfcebef0ceaef09d4b7ffafc7f8ae1,0,20,0,1,0,21
2512,1702,2022-10-09 21:17:00,8ec5fa47b3c3285c1610a9fddeb90ec8,0,18,0,0,0,18
2513,1702,2022-10-09 21:21:00,0dd4f32a60058b18bef703d73b418a00,0,22,0,0,0,22
2514,1702,2022-10-09 21:27:00,455440f72b064aa08b9d0fb26ade2569,0,13,0,0,2,15
2515,1702,2022-10-09 21:32:00,1162bbf9ce89f2da74da304f99aced7d,0,13,0,0,2,15
2516,1702,2022-10-09 21:37:00,2a75889f5fa57c65465263d8b799f04b,0,25,0,0,0,25
2517,1702,2022-10-09 21:42:00,218c96185e0217ad3d80acb69ec53d46,0,18,3,0,0,21
2518,1702,2022-10-09 21:47:00,72be8c1ecc9e41cf56ebb95db22c47de,0,23,1,1,1,26
2519,1702,2022-10-09 21:53:00,c3956601d1fcbaccd18d8158dc4b0a5f,0,21,0,0,0,21
2520,1702,2022-10-09 21:57:00,8ddc255215efad1d87994b9e5c01ef8e,0,22,1,0,0,23
2521,1702,2022-10-09 22:02:00,a1125664cfd595ccac5b22bf315cb4f4,0,10,0,0,2,12
2522,1702,2022-10-09 22:08:00,67f910787d1fe14382efb7564e7cb685,0,10,0,0,1,11
2523,1702,2022-10-09 22:12:00,e9e193f6dcf415720efc4f22e7d9d37c,0,15,0,3,1,19
2524,1702,2022-10-09 22:17:00,e9744f644269c70bdf64406044301605,0,20,0,0,0,20
2525,1702,2022-10-09 22:22:00,5a8657280e19195045a79f7fa3dfe64c,0,19,0,0,0,19
2526,1702,2022-10-09 22:27:00,b6a6f7b8681d3c94c174be4f0aef1b09,0,18,1,0,1,20
2527,1702,2022-10-09 22:31:00,ba452535cc2179aa98dd44d8cd6f98fe,0,13,2,1,1,17
2528,1702,2022-10-09 22:38:00,97d3b1c53437f256fee87319082e4b5e,0,8,0,0,2,10
2529,1702,2022-10-09 22:41:00,d8ed71e537b4de63c2e24a860371ce98,0,7,2,1,0,10
2530,1702,2022-10-09 22:48:00,3d62a434973ec5907fe16d7d8424a905,0,12,1,0,0,13
2531,1702,2022-10-09 22:51:00,571a6d616eb9dfa31128c6675a494951,0,2,0,0,0,2
2532,1702,2022-10-09 22:56:00,8a370e179966eb50fddd59932c7c2402,0,7,0,0,0,7
2533,1702,2022-10-09 23:01:00,31b876cd3adfadc071d1fafd0bb4bf5f,0,11,1,0,0,12
2534,1702,2022-10-09 23:07:00,f227cf5bc7b1f74a970dbda86fd798d4,0,7,0,0,1,8
2535,1702,2022-10-09 23:12:00,637fca82fa270483984d7a92ce83f7cc,0,7,0,0,1,8
2536,1702,2022-10-09 23:18:00,97931574eb7e785c9c8817ec3c6499e6,0,7,0,1,0,8
2537,1702,2022-10-09 23:23:00,4b631b81834ebb4b25ee31a9f5791b8a,0,3,0,1,2,6
2538,1702,2022-10-09 23:27:00,f6a6bf27d33789510a8f9c4a298482f1,0,8,0,0,1,9
2539,1702,2022-10-09 23:31:00,0ab33b8452a3f935ad1fd13f8a65d0ff,0,11,2,0,0,13
2540,1702,2022-10-09 23:38:00,89a417591be308525db188cd14f55e48,0,10,0,0,2,12
2541,1702,2022-10-09 23:41:00,feb33720d551c220f80f61256cb3ea72,0,6,1,0,0,7
2542,1702,2022-10-09 23:47:00,b15ee2b120d17599cbf1159c5acbb3e8,0,10,0,0,0,10
2543,1702,2022-10-09 23:52:00,9feaf28d8b8141755d3f27a5b9ed1ae0,0,4,2,0,2,8
2544,1702,2022-10-09 23:57:00,f9599be11715c3ddf075f1f4d5bfe764,0,2,0,0,0,2
2545,1702,2022-10-10 00:02:00,a1f12d6c7d6a2bee7015307e5f90150d,0,4,0,0,0,4
2546,1702,2022-10-10 00:07:00,b3f7d00f84a50da2bfdf4081b34105a4,0,1,0,0,0,1
2547,1702,2022-10-10 00:12:00,76a8f63ae972a479a350d08cb392d2cd,0,5,0,0,1,6
2548,1702,2022-10-10 00:17:00,72011b48ec904f4b944f1e755114b3a6,0,7,1,1,0,9
2549,1702,2022-10-10 00:22:00,dba11c481889833b922436af468db4bf,0,13,0,0,0,13
2550,1702,2022-10-10 00:27:00,d94229fa99b94d0db3911ecd67409588,0,6,1,0,1,8
2551,1702,2022-10-10 00:32:00,ac26767d3276892c26001afb3681f86a,0,7,1,0,0,8
2552,1702,2022-10-10 00:37:00,77474554ccb7497425d1c7381f051e8f,0,10,0,0,0,10
2553,1702,2022-10-10 00:41:00,7215638a798a19bc1972349dd2f68933,0,6,1,0,1,8
2554,1702,2022-10-10 00:47:00,9926520cbe122e75b54c94ea35adbb55,0,2,0,0,2,4
2555,1702,2022-10-10 00:53:00,b39a3275564bff4bd6160b28ead1eb63,0,6,0,0,0,6
2556,1702,2022-10-10 00:57:00,f6858e6fb0c6a33a0af262ab6f706b13,0,2,0,0,0,2
2557,1702,2022-10-10 01:03:00,28800ba91e928d0ff0611d944a054c32,0,9,0,0,0,9
2558,1702,2022-10-10 01:06:00,c24cc8dd83f486ba90686316d041f4a2,0,7,1,0,1,9
2559,1702,2022-10-10 01:12:00,69022624b6c9c86db9db7fd7e7361b92,0,6,1,0,0,7
2560,1702,2022-10-10 01:17:00,9a1a2a5e6c76bfffb5449d9c20becf84,0,0,0,0,1,1
2561,1702,2022-10-10 01:22:00,9c0f8e0301cc15e34f21dc7b9ea464e3,0,7,0,0,0,7
2562,1702,2022-10-10 01:27:00,cc4b333e11bbb432ba7cad0957b36ecc,0,8,3,0,0,11
2563,1702,2022-10-10 01:33:00,56c0f371c565035cb1a2b4b8c23a4dff,0,3,0,0,0,3
2564,1702,2022-10-10 01:38:00,7b282ccd079602dc1a721d38ac7e3ac6,0,9,0,0,1,10
2565,1702,2022-10-10 01:42:00,b7026469b8403a688d1b89a97af0194d,0,8,0,0,1,9
2566,1702,2022-10-10 01:47:00,fa91b8531ee19479e7c1f84b0d2a6405,0,6,0,0,0,6
2567,1702,2022-10-10 01:52:00,6c716a7d5b7e43090c371cdb5d262b94,0,1,0,0,0,1
2568,1702,2022-10-10 01:57:00,72d9ecc35f6a66817267b9387e7e9e41,0,7,0,0,0,7
2569,1702,2022-10-10 02:03:00,879ceff66b1f4e9af2550771753e0274,0,10,1,0,0,11
2570,1702,2022-10-10 02:08:00,9a40b940682af461a4e1fdc8e6fcdb0f,0,5,0,0,0,5
2571,1702,2022-10-10 02:12:00,4f36f5b81b7838524b601d6978305b4e,0,10,0,0,2,12
2572,1702,2022-10-10 02:17:00,5aa41abd17983d11b42bf443d1831cd0,0,3,1,0,2,6
2573,1702,2022-10-10 02:23:00,5813f525421c136547425255ea79bc34,0,6,1,0,0,7
2574,1702,2022-10-10 02:28:00,71cb3326831df542466124867a4d6bfe,0,1,0,0,0,1
2575,1702,2022-10-10 02:32:00,9fedb7b40d1cdbd3aeeb7cd436d4c922,0,3,0,0,0,3
2576,1702,2022-10-10 02:37:00,32d6c01ad6f4be2af492df144610ef6b,0,2,0,1,0,3
2577,1702,2022-10-10 02:41:00,e941167ca34b35f126544c16963f8cb0,0,5,0,0,0,5
2578,1702,2022-10-10 02:46:00,42b370057964a0e89295fc05fcea1f2a,0,8,0,0,0,8
2579,1702,2022-10-10 02:52:00,e850a1f901b5caef2ed3ee16ea85fcf8,0,2,0,0,0,2
2580,1702,2022-10-10 02:57:00,7d1f4919d16245d7b9804f84417a3b52,0,9,0,0,1,10
2581,1702,2022-10-10 03:02:00,61a27fc4a54f5f0caee1f85e6a41343d,0,6,0,0,0,6
2582,1702,2022-10-10 03:06:00,6b4ade5aa38b1fa2e19784b6c7cb9fae,0,4,0,0,0,4
2583,1702,2022-10-10 03:11:00,ba041254d5a32d6c714fc5ee57e384c3,0,4,0,0,0,4
2584,1702,2022-10-10 03:17:00,4bf5f584ce07e75092760c4637d2a2ae,0,4,0,0,1,5
2585,1702,2022-10-10 03:22:00,d9fad94b0d8f3d3aa24669c8061da571,0,0,0,0,0,0
2586,1702,2022-10-10 03:26:00,06e573c5c93891705f565f94e4914c6c,0,0,0,0,0,0
2587,1702,2022-10-10 03:32:00,3447ed9d829fe170e5040c584804b9cc,0,5,0,0,0,5
2588,1702,2022-10-10 03:37:00,d54562f434ed513cc210a085a4e7d249,0,6,0,0,0,6
2589,1702,2022-10-10 03:42:00,4c64b70954df6d1cae56a1308528e35d,0,2,0,0,1,3
2590,1702,2022-10-10 03:47:00,b56a7eddeecc80d1372d6beda637257c,0,0,0,0,0,0
2591,1702,2022-10-10 03:52:00,fc6ab6137f50f22a4a448c4e22a21f85,0,0,0,0,0,0
2592,1702,2022-10-10 03:57:00,37e574d2f8967522f9f29338d854150e,0,0,0,0,0,0
2593,1702,2022-10-10 04:01:00,4456aca1768d4ee08d6e25299a7ebbb7,0,0,0,0,0,0
2594,1702,2022-10-10 04:07:00,5f584394a942f3ac421eaf305fb1dd13,0,0,1,0,0,1
2595,1702,2022-10-10 04:12:00,3a97248a8c1def76b089abef23a9527e,0,0,0,0,0,0
2596,1702,2022-10-10 04:17:00,0988c656ef1cbe4be0174d518a31eb7e,0,2,1,0,0,3
2597,1702,2022-10-10 04:23:00,ea2e42f029b82065473706ddde8a9052,0,0,0,0,0,0
2598,1702,2022-10-10 04:27:00,79ca2488757c694c087b7c9bd95bc44a,0,1,0,0,0,1
2599,1702,2022-10-10 04:33:00,baa4d126ec3ab65872d4af0b8eefab07,0,1,0,1,0,2
2600,1702,2022-10-10 04:37:00,3faadb02985f254cac3c0cc6bee15c02,0,2,0,0,0,2
2601,1702,2022-10-10 04:41:00,ce571c6bd02c0f29a8011b48b9f2b8d8,0,0,0,0,0,0
2602,1702,2022-10-10 04:47:00,e4f6afcf6e9dc46d5bb63e68ffba2ba4,0,0,0,0,0,0
2603,1702,2022-10-10 04:53:00,4cbd36fb2acb25cd66c42eec3e91c1b2,0,0,0,0,0,0
2604,1702,2022-10-10 04:57:00,cb521bc7e1bdd377ca6e05df9651f042,0,0,0,0,0,0
2605,1702,2022-10-10 05:03:00,2b438f6fab5072689b596528ba18f2c0,0,2,0,0,0,2
2606,1702,2022-10-10 05:07:00,f7161ae26066f9e037acd59036be68b5,0,4,0,0,0,4
2607,1702,2022-10-10 05:12:00,30d8d322e04acc4043c12247f7729dbe,0,1,0,0,0,1
2608,1702,2022-10-10 05:18:00,c9e4ab7152c96cac5e889afb4b1fed7f,0,4,0,0,1,5
2609,1702,2022-10-10 05:22:00,a2226d7083cbfa400decdd08e343c918,0,0,0,0,0,0
2610,1702,2022-10-10 05:28:00,650349ce01326aa526e187cf0a073c1b,0,4,0,0,2,6
2611,1702,2022-10-10 05:31:00,7d18976f9f22fb88a5d618a503ff740c,0,2,0,0,0,2
2612,1702,2022-10-10 05:37:00,c06475fca863c19d411db65f0713f112,0,1,0,1,0,2
2613,1702,2022-10-10 05:41:00,b9e8c77af78ae6150b50204675850480,0,1,0,0,0,1
2614,1702,2022-10-10 05:47:00,795d39c057dc973c0069e63be6192c07,0,3,0,0,0,3
2615,1702,2022-10-10 05:52:00,d69b91b2880b1f2dd4514949aa940ce0,0,1,1,0,0,2
2616,1702,2022-10-10 05:56:00,af8fd02de1d511c4fbe569df308a61a1,0,0,0,0,0,0
2617,1702,2022-10-10 06:02:00,122e1f0d7ae17d6582f92a0096a863e8,0,2,0,1,0,3
2618,1702,2022-10-10 06:07:00,06ccec2fdeca40114711e49d365431de,0,0,0,0,0,0
2619,1702,2022-10-10 06:12:00,bc4cf6471befbce9f5e4524578f98e6b,0,2,0,0,0,2
2620,1702,2022-10-10 06:17:00,f185717f217d7f1e648a9efa8c22ccf8,0,5,0,0,0,5
2621,1702,2022-10-10 06:21:00,f6bf63c2cde46bf85336ff3534efabd3,0,6,1,0,0,7
2622,1702,2022-10-10 06:26:00,b521cbd26d05c0ca4be36518b47587f7,0,1,0,0,0,1
2623,1702,2022-10-10 06:31:00,4060b67cb0a861f200aaa3749fc78b3a,0,1,0,0,0,1
2624,1702,2022-10-10 06:37:00,072ca06e94ab12da56bf9cc73a281133,0,7,1,0,2,10
2625,1702,2022-10-10 06:41:00,b8b9ea8874f2470ac6b65f6a0af88c71,0,7,0,1,1,9
2626,1702,2022-10-10 06:47:00,94bd3e124da23c80ac1fb6552e1b277c,0,14,3,0,3,20
2627,1702,2022-10-10 06:51:00,d2c0eb9f7990c8c8f3b8553d249d8157,0,14,0,3,1,18
2628,1702,2022-10-10 06:57:00,68a65f5b4229fb6793ba9ec6e12a4e6c,0,15,0,1,1,17
2629,1702,2022-10-10 07:02:00,d4a476a94796dba540d5d767f9c586a6,0,17,0,2,3,22
2630,1702,2022-10-10 07:06:00,99a8ea76160844eace1589d91838bcf8,0,15,0,2,5,22
2631,1702,2022-10-10 07:11:00,20beb88eb3655e4c5cc1f35b3c937965,0,21,0,2,1,24
2632,1702,2022-10-10 07:17:00,fcfd15296116ec140e3fd3ccd3b281b2,0,16,2,2,6,26
2633,1702,2022-10-10 07:22:00,ce7e6208a37f45db213e2b1ac5600a13,0,23,1,1,3,28
2634,1702,2022-10-10 07:27:00,045e3f0463f7f0ac1a51c89390892b40,0,14,0,3,5,22
2635,1702,2022-10-10 07:32:00,94b97e47979d06fe7674e779d38c99f2,1,14,1,0,12,28
2636,1702,2022-10-10 07:36:00,289f6427246ed0b64b6105519be57778,0,18,0,1,8,27
2637,1702,2022-10-10 07:41:00,59ef38960ee9081010f8ba795f9ef9d1,0,14,0,4,11,29
2638,1702,2022-10-10 07:47:00,38925f2205028997ef0095a6f4d85333,0,15,0,1,7,23
2639,1702,2022-10-10 07:52:00,22ae841b87f7516e7321f27a55aaa115,0,10,0,1,15,26
2640,1702,2022-10-10 07:57:00,db735b273f0dd24107ac32724b6d7f92,0,13,0,1,7,21
2641,1702,2022-10-10 08:02:00,fbd8122a19d326859300a2857bb292d3,3,14,0,1,12,30
2642,1702,2022-10-10 08:07:00,b4895d320abc9f370a178646ebfeab84,0,5,0,4,10,19
2643,1702,2022-10-10 08:12:00,773a518c0ed983eed90dc0ec00a08b2a,1,15,2,2,8,28
2644,1702,2022-10-10 08:17:00,7dc3f25bc95ab425f3f900a6d9cc559c,0,18,0,2,9,29
2645,1702,2022-10-10 08:22:00,2cbae56af660929d43d37572c1a029d0,0,13,0,3,10,26
2646,1702,2022-10-10 08:27:00,15e9a7784c3160a1b19581e021f1d587,0,12,0,1,8,21
2647,1702,2022-10-10 08:32:00,d55f04be751eabdd518fd70a8dbc5cc8,0,9,0,3,13,25
2648,1702,2022-10-10 08:37:00,dd950c7dbb50ebb0f7501ad47cc69977,0,11,0,2,11,24
2649,1702,2022-10-10 08:42:00,e70d7690c7b465bb3a884b866dc0aefc,0,19,0,2,9,30
2650,1702,2022-10-10 08:47:00,f68af5d02fd94e6533543b68df328008,2,11,0,4,8,25
2651,1702,2022-10-10 08:53:00,b3398ad49c0b19253da4032369d08578,1,19,1,2,9,32
2652,1702,2022-10-10 08:57:00,867572bebead48e6dd7caa7f1ee717de,0,4,0,1,9,14
2653,1702,2022-10-10 09:02:00,f13d983cc9cd98bea09a4e62b5b30a53,0,12,1,1,8,22
2654,1702,2022-10-10 09:07:00,3ae648f2467bddd76169b2d4f1738820,0,16,0,3,8,27
2655,1702,2022-10-10 09:11:00,28cf301fb913e78a4ac82317795c9c23,0,13,0,1,8,22
2656,1702,2022-10-10 09:17:00,b24e840a7af38d8049afe276b606ac40,0,11,0,0,13,24
2657,1702,2022-10-10 09:22:00,4c7db8ca94b092caa2c33c23006f1ea9,0,9,0,1,11,21
2658,1702,2022-10-10 09:26:00,4dc52c339f14dc6eb4ecbf5e00e6fedb,0,11,0,0,9,20
2659,1702,2022-10-10 09:32:00,c8986d452981c671ef6a1f04075fe082,0,9,0,0,9,18
2660,1702,2022-10-10 09:37:00,7580c253e0051c9ac4cc13906f7dee82,0,14,0,2,8,24
2661,1702,2022-10-10 09:42:00,dd072d4992a1492ea5c60959fb813961,0,15,0,2,8,25
2662,1702,2022-10-10 09:47:00,13343095320fc4670a71272b69e9c307,0,12,0,2,11,25
2663,1702,2022-10-10 09:51:00,9666307a32b7d25669a9408b9510162a,0,10,0,3,7,20
2664,1702,2022-10-10 09:57:00,19bbe7ebf9237311f99080b68a54098a,0,15,0,2,9,26
2665,1702,2022-10-10 10:03:00,a66bc33de6798d1a0e268422620963ca,0,9,0,2,13,24
2666,1702,2022-10-10 10:07:00,beed31f2a3608d06a221748163a6440c,0,15,0,1,12,28
2667,1702,2022-10-10 10:12:00,69d8961d17988059aaa4c50a74e849dd,0,20,0,1,10,31
2668,1702,2022-10-10 10:17:00,bad28e611964438a5b181361cc538151,0,20,0,0,14,34
2669,1702,2022-10-10 10:23:00,f715c878707ffeb6f9d1eee006ecaa83,0,22,0,0,10,32
2670,1702,2022-10-10 10:27:00,e9bdadc928810a27b30b7b3da0d35463,0,16,0,0,12,28
2671,1702,2022-10-10 10:32:00,0bf380cd8a6f7d3816293f2ae02e5b14,0,12,0,2,15,29
2672,1702,2022-10-10 10:37:00,55f4b41b0ffaea9e51bcd0ed65560e55,0,10,0,0,13,23
2673,1702,2022-10-10 10:42:00,344313e2b171630d4d45a5452d8f2742,3,18,1,3,12,37
2674,1702,2022-10-10 10:48:00,642786e30f70ec50edf2bd00974d4c4e,2,14,0,0,10,26
2675,1702,2022-10-10 10:53:00,7d57f290fd57171c5ad250b7559222c9,0,15,0,2,11,28
2676,1702,2022-10-10 10:57:00,f021e351b9931c04a491fad92925932f,0,18,1,2,9,30
2677,1702,2022-10-10 11:02:00,c456b9d61e70bfec7353934bc4ff0249,0,12,1,3,10,26
2678,1702,2022-10-10 11:07:00,8db9dfdc071ae7c079a71c18263c7d07,0,9,0,0,15,24
2679,1702,2022-10-10 11:12:00,1194a23efdc6424886d69c3903fd21e7,0,22,1,0,3,26
2680,1702,2022-10-10 11:18:00,673ef76d9bf1c00274a1fdcdecdb8a87,0,8,0,7,8,23
2681,1702,2022-10-10 11:22:00,ed4fbb267a8c60c024ffd21a2cc0d65f,0,14,0,2,10,26
2682,1702,2022-10-10 11:27:00,e2a6ab358bf23f9550c29e4f0e83c582,0,10,0,6,12,28
2683,1702,2022-10-10 11:32:00,6205d72073e6fb71ab9c356d0cd9b10a,0,12,0,4,11,27
2684,1702,2022-10-10 11:37:00,5da8dc66fe74c618c261dcdda24f1831,0,9,1,2,8,20
2685,1702,2022-10-10 11:42:00,4089eb9689b2109f526f2e5cd5cb810d,0,5,0,0,11,16
2686,1702,2022-10-10 11:48:00,f3cd5ca366ac5a69e96c82660f792753,1,10,0,3,11,25
2687,1702,2022-10-10 11:58:00,164f837a985f9dbdd85e4ee4a6f5e51b,0,12,0,0,6,18
2688,1702,2022-10-10 12:02:00,a5b8b3dc4018af7271daccb516f8e1dd,1,14,0,1,10,26
2689,1702,2022-10-10 12:08:00,5cd22e84fd7124d8fbc7952c1564d030,0,11,0,2,10,23
2690,1702,2022-10-10 12:12:00,3820d048989df5ea4dcc0620f433a366,0,14,0,3,4,21
2691,1702,2022-10-10 12:17:00,d4d813569b5b43793b703c8b614b2ffe,0,14,0,1,10,25
2692,1702,2022-10-10 12:22:00,6a0ea485556617f5ae53852a40f0b3ac,0,7,0,5,7,19
2693,1702,2022-10-10 12:26:00,b9b7756dbc49a8ab99e511ca52d20d03,0,4,1,3,12,20
2694,1702,2022-10-10 12:32:00,45baa45c7dddcbf1cdea692695b25e11,0,19,3,1,5,28
2695,1702,2022-10-10 12:37:00,2e338dc99532cff7e784ece46791bd57,0,12,0,3,10,25
2696,1702,2022-10-10 12:41:00,c562d872fee9855ef722b522f1da0599,0,15,1,2,8,26
2697,1702,2022-10-10 12:48:00,ba976eb09e79f00def710ae6ee1800fd,0,14,0,2,8,24
2698,1702,2022-10-10 12:52:00,450b1b22ecfe2b7056b005d3d45ac981,0,8,0,3,11,22
2699,1702,2022-10-10 12:57:00,488ca1225d5c31e9a3e4e60c825ce878,0,13,0,5,7,25
2700,1702,2022-10-10 13:02:00,6119ddc5a9aad67f757ca2e4c3b382e7,1,14,0,2,9,26
2701,1702,2022-10-10 13:07:00,e8a80aeff58f9508614d1fd6938a175e,0,16,1,1,8,26
2702,1702,2022-10-10 13:12:00,1d817fde0bcc03bb3a23b1c95fd658e1,0,13,0,1,7,21
2703,1702,2022-10-10 13:18:00,75f6b77a12c4d436ccd3b1447e01c512,0,9,0,0,12,21
2704,1702,2022-10-10 13:22:00,a030fc1ec350855c33f39a31d041942c,1,12,1,2,5,21
2705,1702,2022-10-10 13:26:00,4c79bb9dd3994f24f79e67473900ff57,0,15,1,1,12,29
2706,1702,2022-10-10 13:33:00,fc283f275b03dce579c86aa5bd637b27,0,14,0,1,12,27
2707,1702,2022-10-10 13:38:00,c5e1b3ccb288afbdaf45232e5589609e,0,6,2,7,7,22
2708,1702,2022-10-10 13:42:00,9310cd5828311e236f9f80bc8a0edc79,0,10,0,1,15,26
2709,1702,2022-10-10 13:47:00,80637206c1977fe7306080137755c804,0,9,0,3,12,24
2710,1702,2022-10-10 13:51:00,7033fe77f14a19bcdd912902072e3ae9,0,15,0,4,8,27
2711,1702,2022-10-10 13:56:00,c0dfae218c636211f17b6bf7bc979775,0,11,0,3,14,28
2712,1702,2022-10-10 14:02:00,dd32d61be530a3fa00f3c153501ac5e6,0,17,0,4,10,31
2713,1702,2022-10-10 14:06:00,b5fa511392557b4d25905c256d1adc25,0,13,0,5,8,26
2714,1702,2022-10-10 14:11:00,f73774cd54362e8893efcae095461fdb,0,12,0,3,14,29
2715,1702,2022-10-10 14:16:00,ca3636928b5c57259a43ad617e435199,0,14,0,3,12,29
2716,1702,2022-10-10 14:23:00,6336911f913cdc3d16fae172b8fc1238,1,10,0,3,7,21
2717,1702,2022-10-10 14:26:00,56af3663aaec7dbc7046d042927911b4,2,18,0,0,11,31
2718,1702,2022-10-10 14:32:00,5c30e975b71ce61866ed8c4b7404feb2,0,8,0,1,10,19
2719,1702,2022-10-10 14:38:00,e93f3acfe37919a5404c4589e7927178,0,12,2,2,12,28
2720,1702,2022-10-10 14:42:00,1d99211da4d79073710142c5e6999755,0,15,2,1,9,27
2721,1702,2022-10-10 14:47:00,7a68b46bd3d95ce0f938f29b69b8708e,0,12,0,3,10,25
2722,1702,2022-10-10 14:52:00,2b5db36d6b85980d0a003178637c3736,0,9,1,6,7,23
2723,1702,2022-10-10 14:58:00,c1cf2acbb53b0445a5d5e236bab03f25,0,11,0,2,14,27
2724,1702,2022-10-10 15:02:00,be076c9e836e4b1b46b6dc47eaebe487,1,9,0,1,11,22
2725,1702,2022-10-10 15:06:00,4c688b466a806e8393369ff5711a1619,0,11,3,2,8,24
2726,1702,2022-10-10 15:12:00,f35e0360cff9f7d44839a016a0d72cf1,0,15,0,0,14,29
2727,1702,2022-10-10 15:17:00,fd67a84ff56321655b977c56fb575e54,0,16,1,4,6,27
2728,1702,2022-10-10 15:22:00,70bdb239117d830785e521833a6d3f28,0,12,0,2,8,22
2729,1702,2022-10-10 15:26:00,b9174a831e97133d91485297561c2bef,0,11,0,6,12,29
2730,1702,2022-10-10 15:31:00,f9850fc20b2cbb79b23b6391b0b9c0bd,0,12,0,3,9,24
2731,1702,2022-10-10 15:36:00,f896cc8d857d574568065457534f6bdc,0,17,0,2,6,25
2732,1702,2022-10-10 15:41:00,f7e0e27da56d0adaebcb8ebf07014c5e,0,15,0,3,8,26
2733,1702,2022-10-10 15:48:00,c1d43cef7d6a8d0b206a5d528e245076,0,12,1,3,13,29
2734,1702,2022-10-10 15:52:00,4a663a318c58087462222c3ddb8c7224,1,10,0,1,17,29
2735,1702,2022-10-10 15:56:00,b987f24f04b6ddfbcbee730d74c78886,0,12,0,3,7,22
2736,1702,2022-10-10 16:02:00,99c96a8ab76589f72b95fb4f3dbcfc94,0,15,0,2,2,19
2737,1702,2022-10-10 16:11:00,3ba7f0166efe36d20bf5870e735f0107,0,13,0,4,6,23
2738,1702,2022-10-10 16:18:00,95b0e7d3d14679fa96822bc69f42f554,0,14,0,1,11,26
2739,1702,2022-10-10 16:22:00,038ded1d473cf6fcc4dd7dd2469b5bc8,0,15,0,0,8,23
2740,1702,2022-10-10 16:27:00,8b8295b38188d54703a2f91b6eb18da7,0,8,0,5,12,25
2741,1702,2022-10-10 16:32:00,2fec5a45d0b7ab19ea07264eed2a8f2d,0,17,0,2,7,26
2742,1702,2022-10-10 16:37:00,943ac0b1cae424cf4047911ae26e88d2,0,9,2,6,7,24
2743,1702,2022-10-10 16:43:00,d5f8955fb22aad54d46de00775fc054d,1,12,0,0,7,20
2744,1702,2022-10-10 16:46:00,d5d19391d1dcbca70f4f6f2937f94f87,0,12,1,2,9,24
2745,1702,2022-10-10 16:52:00,811a7ae59eabe9bef86a1d386c785501,0,20,0,2,4,26
2746,1702,2022-10-10 16:56:00,d7694dca890c2990a6f16327b276757e,0,12,1,4,9,26
2747,1702,2022-10-10 17:02:00,51128300dbe1065f31bad64381df94d5,0,13,0,4,6,23
2748,1702,2022-10-10 17:07:00,51f61914fa7e1bfa2effcc7b2b470399,0,13,0,3,9,25
2749,1702,2022-10-10 17:11:00,ae566dc88e570e4d6610b8f4332bd4d7,1,7,2,0,14,24
2750,1702,2022-10-10 17:17:00,352f979ae7f22ce0b1a4e53072acb179,0,15,1,4,9,29
2751,1702,2022-10-10 17:22:00,5f4d8332a4c332adb663916c7ad3933f,0,11,0,7,13,31
2752,1702,2022-10-10 17:26:00,60c706e191f1b940e36b021536a03e3d,0,11,0,3,18,32
2753,1702,2022-10-10 17:32:00,3ec2a4e98eacf9f42573704d17514d6a,1,23,0,1,8,33
2754,1702,2022-10-10 17:36:00,08695d78cdb9ca0cdafd3944f94aaf8c,2,19,0,5,6,32
2755,1702,2022-10-10 17:42:00,46c6c198f7bb58bb1b9e0e787204a2e8,0,16,0,1,10,27
2756,1702,2022-10-10 17:47:00,20f6fb0554e9e19755019fc0e2366fee,0,16,0,1,14,31
2757,1702,2022-10-10 17:53:00,68a7da78bff02736ecf96582b06c8b56,0,17,0,4,7,28
2758,1702,2022-10-10 17:57:00,88e825f841dfc1346073dc5b319aec0f,0,18,2,3,11,34
2759,1702,2022-10-10 18:02:00,e135d9448b40be3e18df8f46c5524b03,0,22,0,3,4,29
2760,1702,2022-10-10 18:07:00,09f698ae5508583ac11fda03dc28f082,1,15,2,2,7,27
2761,1702,2022-10-10 18:12:00,562ccb7652fc00bd6aa72bb33d52693d,0,12,0,4,9,25
2762,1702,2022-10-10 18:17:00,98c14a72a561a964bfa6469dcadc35f3,0,10,1,0,6,17
2763,1702,2022-10-10 18:22:00,5d9de1e489a3d5c3379308bab883035d,1,15,0,1,8,25
2764,1702,2022-10-10 18:26:00,9949b7aab35909d2954629f5843b1201,0,17,1,3,10,31
2765,1702,2022-10-10 18:32:00,21dc3411d884d7a3a3caa2a818630048,0,14,0,4,14,32
2766,1702,2022-10-10 18:37:00,3ca7c43eae71bec444cb5b955790fa4c,0,24,0,1,6,31
2767,1702,2022-10-10 18:41:00,597e8f8141979ffec3295ddd42537481,0,16,0,4,11,31
2768,1702,2022-10-10 18:47:00,914d419ada8067a6866a0753bdacc3ac,0,17,0,3,9,29
2769,1702,2022-10-10 18:51:00,1fa42c45ea342179d3c5a1ce47d44e35,0,23,0,2,2,27
2770,1702,2022-10-10 18:56:00,f03cc523e5a3caa0debc6ddf14b71a38,0,21,0,2,11,34
2771,1702,2022-10-10 19:02:00,d846b435ae45bd44026a50b9a39d4427,0,16,1,2,4,23
2772,1702,2022-10-10 19:07:00,33bedd0249fa044b2029a06958e7ba84,0,28,2,1,3,34
2773,1702,2022-10-10 19:11:00,e260635e7bd30f152e873cbb75355148,1,24,2,0,2,29
2774,1702,2022-10-10 19:17:00,cd285f5c29f91cbf9364a69b5a09a41d,0,18,0,0,2,20
2775,1702,2022-10-10 19:22:00,6c6661291d7a62d98f0cd34ed8bca1b6,0,25,0,2,0,27
2776,1702,2022-10-10 19:26:00,a90ea761cd1bb784069789d353847046,1,27,2,5,2,37
2777,1702,2022-10-10 19:32:00,564eb641ec484aae7f9fd792a8f91b62,0,18,0,0,0,18
2778,1702,2022-10-10 19:36:00,8532a5738490498e513f7094ea03d202,0,25,0,0,1,26
2779,1702,2022-10-10 19:41:00,90b04ffa71c0172e70ddd6c8c571e060,0,23,2,2,1,28
2780,1702,2022-10-10 19:46:00,0f414ea3923d3b79fb9803073abbe706,0,16,1,1,1,19
2781,1702,2022-10-10 19:52:00,face6c2b28b991c9afaf843fbc92d41b,0,22,1,0,1,24
2782,1702,2022-10-10 19:57:00,b4d73dbfd4846ca09ce06e4c46a871ea,0,15,1,0,0,16
2783,1702,2022-10-10 20:02:00,50c84ed2d611dbf1187da3b29268120e,0,26,0,0,0,26
2784,1702,2022-10-10 20:06:00,67cb58228d9c9a2639e0bf51fe50d70c,0,25,0,0,1,26
2785,1702,2022-10-10 20:11:00,4614744c02e048e9cb792fbf16bf5a62,0,26,0,1,2,29
2786,1702,2022-10-10 20:17:00,2faf69142c2c2c6a7e4094841742cc77,0,14,2,0,0,16
2787,1702,2022-10-10 20:22:00,9fd40064386a8af560ee93f9f87cb295,0,24,2,1,0,27
2788,1702,2022-10-10 20:27:00,7aa3443cbd167aefbab235f234de9220,0,21,0,0,0,21
2789,1702,2022-10-10 20:32:00,1a9e7170af6b775f9094deb34d3a2f2e,1,14,0,4,0,19
2790,1702,2022-10-10 20:37:00,e25eaf23bd164b236793424e8f982b80,0,16,0,0,1,17
2791,1702,2022-10-10 20:41:00,24a9a5148a7bb631643bb7a10e18a283,1,13,2,0,1,17
2792,1702,2022-10-10 20:47:00,817f93b249ce0f3b04bdb2c5b1880326,0,18,0,0,0,18
2793,1702,2022-10-10 20:52:00,621793a9367d61553ba436022eb611cf,0,21,0,0,2,23
2794,1702,2022-10-10 20:57:00,c09e3eabfc5e963a539ee59aab8321c6,0,14,1,0,0,15
2795,1702,2022-10-10 21:02:00,09824088e0269012720eb28eebdba65b,0,22,1,0,3,26
2796,1702,2022-10-10 21:07:00,3bdf63b816e4d4ceea18347714ee7818,0,12,3,0,2,17
2797,1702,2022-10-10 21:11:00,d363fb728f363b497a321db154efc3df,0,14,0,0,1,15
2798,1702,2022-10-10 21:16:00,629b7c57bff282725536eb4758174340,0,19,0,0,0,19
2799,1702,2022-10-10 21:22:00,166e590e00a9f1a77983d73a7c2a5704,0,18,0,1,0,19
2800,1702,2022-10-10 21:27:00,69878fc6a7f66061862d6454b430b774,0,14,0,3,2,19
2801,1702,2022-10-10 21:31:00,989c779354d88e6a0518e64c8a1b61c6,0,16,0,0,0,16
2802,1702,2022-10-10 21:37:00,c8d35d67dbcdf295fde2a5a664d1c416,0,11,2,0,3,16
2803,1702,2022-10-10 21:41:00,16d64af66f4b1d2b04a5443c2000ca17,0,15,1,0,0,16
2804,1702,2022-10-10 21:47:00,acaffa995bd74847eed5129348f76f68,1,10,2,1,1,15
2805,1702,2022-10-10 21:53:00,4cbb777081478ff5da0ba7847b472681,0,11,2,0,1,14
2806,1702,2022-10-10 21:56:00,ecfc66be7b5a71481bde6c52cfee76bd,0,18,1,0,1,20
2807,1702,2022-10-10 22:02:00,bcdf710da9c90b5a01231f35c650364d,0,7,0,0,1,8
2808,1702,2022-10-10 22:07:00,471b14c2e9a57edd6de705099f35d27d,0,11,0,1,0,12
2809,1702,2022-10-10 22:12:00,0780a1008e20497993538e622a381d38,0,14,0,1,0,15
2810,1702,2022-10-10 22:17:00,567b8998655203e16654ae4572a77943,0,11,1,0,1,13
2811,1702,2022-10-10 22:21:00,3af765da0248f6ba3e6adfa527a2f1f5,0,15,0,1,0,16
2812,1702,2022-10-10 22:26:00,8630e28fcc072d21ff8b8c0e4cd3d4b7,0,12,0,0,0,12
2813,1702,2022-10-10 22:31:00,7ecb4eb8e7563a773fbf508c29ec0b87,0,17,2,0,2,21
2814,1702,2022-10-10 22:37:00,70ce1d7f52110bdc0bd74122af2f7b33,0,15,0,0,1,16
2815,1702,2022-10-10 22:41:00,dfb80080bdbe4781b623676dbd84699d,0,12,0,0,1,13
2816,1702,2022-10-10 22:46:00,8e944e6e7189b9aba74c0dcf2add518e,0,10,0,0,0,10
2817,1702,2022-10-10 22:51:00,7bf10441f77fe0a2bf6bb77ea6cf1db0,0,15,0,0,2,17
2818,1702,2022-10-10 22:56:00,b5447a8e8d347a27f308e1f0d30974a7,0,9,0,0,1,10
2819,1702,2022-10-10 23:01:00,d227e8fdca8b0c911a6d216cef14585d,0,10,0,1,0,11
2820,1702,2022-10-10 23:07:00,44018cc367ecffe871a77101b59f0c89,0,10,1,0,0,11
2821,1702,2022-10-10 23:11:00,cccc311144679bfe9d6b84a9db0d60b2,0,20,0,0,0,20
2822,1702,2022-10-10 23:16:00,f85b20c4b12e72b68e164067c3234da6,0,8,0,0,1,9
2823,1702,2022-10-10 23:22:00,8456755a968b792711488f6cd508421f,0,16,0,0,1,17
2824,1702,2022-10-10 23:26:00,288c21baf95353224ec707d9a66267d3,0,15,2,0,0,17
2825,1702,2022-10-10 23:31:00,f83a622c593f45df93f93bf3af4ac388,0,14,1,0,2,17
2826,1702,2022-10-10 23:36:00,b2713c58ea57221697801096bfd706d3,0,11,0,0,0,11
2827,1702,2022-10-10 23:41:00,6252d4b4f2e4cf4f2ca2e527ca334818,0,15,2,0,1,18
2828,1702,2022-10-10 23:46:00,5365e77f9b1a288ba751115e9e8fc8ee,0,5,0,0,0,5
2829,1702,2022-10-10 23:51:00,be1c465a0b148e2d324dcb80bd24a832,0,12,0,1,0,13
2830,1702,2022-10-10 23:57:00,e6a910effc5b64992aa9ab7f8d0817bf,0,9,0,1,0,10
2831,1702,2022-10-11 00:01:00,32da0f615d4287bf5ea168ccd63fe0a9,0,8,0,0,1,9
2832,1702,2022-10-11 00:06:00,9cbbd23c77bd52a900722a16a555b5f3,0,8,0,0,0,8
2833,1702,2022-10-11 00:11:00,a626ff932b364016dbb507d53713de4d,0,8,0,0,0,8
2834,1702,2022-10-11 00:17:00,3dbe9f74bd205406a2faf029c56c8366,0,9,0,0,1,10
2835,1702,2022-10-11 00:21:00,06f54979f78b24eab0ac199820604611,0,3,0,0,1,4
2836,1702,2022-10-11 00:26:00,bb7f6942d09dccc88682a041b1b8651d,0,12,1,0,0,13
2837,1702,2022-10-11 00:32:00,3547f88267edfe9765cf409fd765037a,0,5,1,0,0,6
2838,1702,2022-10-11 00:37:00,87f3c717671a9d31a63ef6cc8c5c1fd2,0,6,0,0,0,6
2839,1702,2022-10-11 00:42:00,0f2f3f52c3576f24116ed4306f3e42ec,1,10,0,0,0,11
2840,1702,2022-10-11 00:46:00,6ea9bf76d5d5ae93431787774b813bf3,0,11,0,0,2,13
2841,1702,2022-10-11 00:52:00,bb9b3dce4759e2678d773a56fd44489c,0,4,0,0,1,5
2842,1702,2022-10-11 00:56:00,f7c8ca798ee7fed63c6d39c9815d3d84,0,10,0,0,0,10
2843,1702,2022-10-11 01:01:00,1b79d7e111b6b1591e949b355620f3a0,0,4,0,0,0,4
2844,1702,2022-10-11 01:07:00,546431227c1267d901c2ce727001a810,0,4,0,1,0,5
2845,1702,2022-10-11 01:11:00,00d5732da1e7c700ed45711ab66799f0,2,4,0,0,0,6
2846,1702,2022-10-11 01:16:00,7d93c59fa389de05891f8f377637b5ea,0,8,0,0,0,8
2847,1702,2022-10-11 01:22:00,56bb0127058da95623c7ed8135d5f6fc,0,8,0,1,1,10
2848,1702,2022-10-11 01:27:00,ee2ab876b59a66ad72dc384bc01d504a,0,10,0,0,0,10
2849,1702,2022-10-11 01:31:00,c3820e0e156b9a2ae7c073adbe01bfd9,0,2,0,0,1,3
2850,1702,2022-10-11 01:36:00,83b6f761c3fbe221ef13e67a6842a2fe,0,5,0,1,2,8
2851,1702,2022-10-11 01:41:00,72ec0a6dc35eabdc4ec96bf488c7e1c5,0,4,1,0,0,5
2852,1702,2022-10-11 01:47:00,359d0512766763ecb0224a2127891de2,0,7,0,0,0,7
2853,1702,2022-10-11 01:51:00,1dbde66c9e3773d86501f83457b0ef30,0,6,1,0,1,8
2854,1702,2022-10-11 01:56:00,61889cf0a5a102c1c8d8559b32aaa29b,0,9,0,0,0,9
2855,1702,2022-10-11 02:01:00,069cd1021b8c6cdf4a63c026b4108091,0,1,0,0,0,1
2856,1702,2022-10-11 02:06:00,4ef0404bca5b7f289758781cf7213366,0,8,1,0,0,9
2857,1702,2022-10-11 02:11:00,2be07ba7c2d29380947e76aeebed190f,0,7,0,0,0,7
2858,1702,2022-10-11 02:16:00,50f184bb63781b6aba3f2b4953fd0c58,0,3,0,0,0,3
2859,1702,2022-10-11 02:21:00,4fedd32532c0205eba375395588b4ed0,0,10,0,0,0,10
2860,1702,2022-10-11 02:27:00,de418f4cedac674930a77de8d037fcff,0,11,0,0,0,11
2861,1702,2022-10-11 02:33:00,eb34858da3a59f3812b80eedbe83a929,0,0,0,0,0,0
2862,1702,2022-10-11 02:36:00,f5aa661ca7d0d6093a2ca57a39c3aa8a,0,7,1,0,0,8
2863,1702,2022-10-11 02:41:00,6717c9d4ded74600ee4809d3acb641bf,0,4,0,0,1,5
2864,1702,2022-10-11 02:46:00,b1e2a37e844642f5b484e103eacbc5b3,0,1,1,0,0,2
2865,1702,2022-10-11 02:51:00,c29d051858fed4331cfc8946b7c960b6,0,6,0,0,0,6
2866,1702,2022-10-11 02:57:00,2454f707069694dec25a9f596e2c928f,0,3,0,0,0,3
2867,1702,2022-10-11 03:02:00,6a9a29ee2b47e07f716b49452d0fef0d,0,6,1,0,0,7
2868,1702,2022-10-11 03:07:00,041a5514c2ff33c4615f62e4539f5d6c,0,6,0,1,0,7
2869,1702,2022-10-11 03:12:00,12c0493e28717c0d33f1a465569bfe4a,0,3,0,0,0,3
2870,1702,2022-10-11 03:18:00,4d3547df4cf3b99f909fe930a0b96d64,0,1,0,0,0,1
2871,1702,2022-10-11 03:22:00,8611fb254cf6e7b655c1fdcbd2c84438,0,5,0,0,0,5
2872,1702,2022-10-11 03:26:00,6bad69b7cc189ebe27ce5d654e5a590c,0,1,0,0,0,1
2873,1702,2022-10-11 03:32:00,f1bf54bac79126e13b524843e1d3b47d,0,7,1,0,1,9
2874,1702,2022-10-11 03:36:00,2f9c4225b5272185e5b3e2bc8246966d,0,3,0,0,1,4
2875,1702,2022-10-11 03:41:00,8374f272f2f0cd6ab249677a2dd4cdf3,0,4,0,0,2,6
2876,1702,2022-10-11 03:46:00,5381e07b0c34b6d95707a7ab99a2571e,0,2,0,0,0,2
2877,1702,2022-10-11 03:52:00,c9a1d110165ff8c919c80da4ae05d0d1,0,3,0,0,1,4
2878,1702,2022-10-11 03:56:00,f342cc89e62e7fcc270ff94fc8d200e4,0,3,0,0,0,3
2879,1702,2022-10-11 04:02:00,a2ab4f0b63c41342aa1a27ffcbd04cc9,0,4,1,0,0,5
2880,1702,2022-10-11 04:06:00,6a29580249d0f733f8c70fd7ba36f54c,0,6,0,0,1,7
2881,1702,2022-10-11 04:11:00,a45e0d1187c0e37eb508c74f984e0bb3,0,3,1,0,1,5
2882,1702,2022-10-11 04:16:00,a668e33186a1bfb84ee16ece8b5d20cc,0,7,0,0,0,7
2883,1702,2022-10-11 04:22:00,d3d0d26bd509d5edc798a1dfd5fff408,0,3,0,0,1,4
2884,1702,2022-10-11 04:26:00,2237a5c3bc850dcb86d24a9c02dd7b17,0,5,0,0,0,5
2885,1702,2022-10-11 04:32:00,95da9a780bf28f18c2548350e25518c2,0,7,0,0,0,7
2886,1702,2022-10-11 04:37:00,55ba512640ebdd24f0dee36d3056e235,0,6,0,0,0,6
2887,1702,2022-10-11 04:42:00,c30170ed190f9adcabceb007eee20d10,0,3,0,0,1,4
2888,1702,2022-10-11 04:46:00,0d2f5515f11ec4d527dc0aab46f4f02f,0,1,0,0,0,1
2889,1702,2022-10-11 04:52:00,00c803cc02335b07d5b92ea271f366bc,0,2,0,0,0,2
2890,1702,2022-10-11 04:57:00,bab73da00b66e6a24ca29303df3ca0fc,0,6,0,1,0,7
2891,1702,2022-10-11 05:02:00,4981eff4d10a95af515d9414886c39f4,0,5,0,0,1,6
2892,1702,2022-10-11 05:07:00,e50b470a698333de22d2934751c0f55f,0,3,0,0,0,3
2893,1702,2022-10-11 05:12:00,bbe08ccab3ddaed7fe3dcce134be3002,0,1,0,0,0,1
2894,1702,2022-10-11 05:16:00,961f99656940dcce643676eeccfa0111,0,3,0,0,1,4
2895,1702,2022-10-11 05:22:00,4b11fce8cc753828c01389bec629f79f,0,11,0,0,0,11
2896,1702,2022-10-11 05:27:00,c8f2f9ab8a3bc09873db5ef85c0bc348,0,5,0,0,0,5
2897,1702,2022-10-11 05:32:00,06bff851c4c73584efaa71fcee9adcd3,0,10,0,0,1,11
2898,1702,2022-10-11 05:37:00,9b0a42635088d3dd441213bb0afb81bb,0,2,0,2,0,4
2899,1702,2022-10-11 05:42:00,865dacee4e9231da6758e99a7577d54d,0,0,1,1,0,2
2900,1702,2022-10-11 05:52:00,99a5c287db62ae5193660071ae458408,0,4,0,0,0,4
2901,1702,2022-10-11 05:56:00,eb0d0b7e847e074fdf3256af85a29d9e,0,5,0,0,1,6
2902,1702,2022-10-11 06:02:00,bb4e44ab8b4bd3d37ef9cc6fe773c413,0,7,1,0,0,8
2903,1702,2022-10-11 06:07:00,8d72c740ccff78132b8951f80f4f8a49,0,2,0,0,0,2
2904,1702,2022-10-11 06:11:00,2e48a03d2ba7c2fd4bda2080131d27cd,0,11,0,0,0,11
2905,1702,2022-10-11 06:17:00,aec71bc7d6d22b29804dfe0fe0c27afa,0,4,2,1,0,7
2906,1702,2022-10-11 06:21:00,1b837a11e1a77b6f4455411213b32d9b,0,3,0,0,0,3
2907,1702,2022-10-11 06:26:00,2e2960be723adeca4966da29d2ae507d,0,5,0,0,2,7
2908,1702,2022-10-11 06:32:00,93a7057cc6449b19e9ed55064fd68af8,0,4,0,0,0,4
2909,1702,2022-10-11 06:38:00,c5920dd4026758ba77206c8d69e7d61a,0,10,3,0,0,13
2910,1702,2022-10-11 06:41:00,ce497d3aaf971511e759f25b45ec5a18,0,13,0,2,3,18
2911,1702,2022-10-11 06:48:00,601f6c8084cc1d27b3fdb9e56b5a94c2,0,19,0,1,4,24
2912,1702,2022-10-11 06:53:00,65911cbdf336918823d3be0a3a438046,0,16,0,1,3,20
2913,1702,2022-10-11 06:57:00,ca0aefc160f60315bba9ec4b9d5ca1ba,0,14,0,0,15,29
2914,1702,2022-10-11 07:03:00,ef41c01e763e5e89b2324108c874c85f,0,12,0,1,7,20
2915,1702,2022-10-11 07:08:00,f45f1eb9f580608cf21387be2c948dc9,0,19,0,1,3,23
2916,1702,2022-10-11 07:12:00,4fdb394ecf4d18d700c9088956855912,0,13,1,2,14,30
2917,1702,2022-10-11 07:17:00,5e9331cdde98aa1fa71c7a46ab9816e0,0,10,0,3,11,24
2918,1702,2022-10-11 07:23:00,9d7568dc7b13f28456404f0da160d2c7,0,17,0,3,7,27
2919,1702,2022-10-11 07:27:00,56b35fcbeeff132cc119d932f16a7609,0,16,1,1,8,26
2920,1702,2022-10-11 07:32:00,2a9de69ed5b5bbecebc9a8c1c24879e7,1,13,2,0,10,26
2921,1702,2022-10-11 07:37:00,479c14f44c434de7c47e30f1c5fc7739,0,13,0,2,10,25
2922,1702,2022-10-11 07:42:00,43309d6cbad7d587f41c1f65bff24144,1,19,0,0,13,33
2923,1702,2022-10-11 07:48:00,037356d82a994a7a1adf9ce4060ab540,1,12,1,3,8,25
2924,1702,2022-10-11 07:53:00,7207e677f3a04eba9b19b10c39e96a87,0,15,0,2,6,23
2925,1702,2022-10-11 07:58:00,7e2f7e238edf9cf6134dfc8a3633afb5,1,13,0,1,9,24
2926,1702,2022-10-11 08:03:00,d51d558d666663152558023dbc5350ac,1,13,0,2,9,25
2927,1702,2022-10-11 08:08:00,8cec273ba5d5671f9dad39802cfedd1b,2,20,0,2,3,27
2928,1702,2022-10-11 08:12:00,896bec6beb5aff7aee4d3cf61160678d,0,19,0,1,6,26
2929,1702,2022-10-11 08:18:00,d855963775e90bb1bbb2dda4404a9db3,0,12,0,0,13,25
2930,1702,2022-10-11 08:23:00,ed08dc5f3914110da1590b28e5f7ba34,0,10,0,3,9,22
2931,1702,2022-10-11 08:28:00,b19e9429caa76d825c46a5ea914715de,0,23,0,1,5,29
2932,1702,2022-10-11 08:34:00,75b5164534510adb63fc2d306b8ec7eb,0,14,0,1,10,25
2933,1702,2022-10-11 08:37:00,b5b53e01f7af2c6fcf6fc2819197053a,2,10,1,4,10,27
2934,1702,2022-10-11 08:43:00,08d516012cc6060ac7356afdb4ab8ca9,0,10,0,2,10,22
2935,1702,2022-10-11 08:48:00,f7f73b23c43fbbb3e48427b627c4c7f0,0,12,0,2,6,20
2936,1702,2022-10-11 08:53:00,b50353233c246276b5b753e4b4f85e9c,0,18,1,1,7,27
2937,1702,2022-10-11 08:58:00,400f5de65601047d7c9c489cabb55310,0,11,0,2,8,21
2938,1702,2022-10-11 09:03:00,6098168cace81748ee288e3ef0634528,1,19,3,0,5,28
2939,1702,2022-10-11 09:08:00,c5799f0ff465aa7b24655e777abbcdfd,0,11,0,1,5,17
2940,1702,2022-10-11 09:12:00,85c3a3ffebf45791ea9c2e1b7bcffdd4,0,16,0,0,6,22
2941,1702,2022-10-11 09:19:00,f606b082d1b2da1787cdfd31b1eb9438,0,15,0,3,3,21
2942,1702,2022-10-11 09:22:00,1994d7d9b8c5ff5b198152891c617539,0,16,0,0,11,27
2943,1702,2022-10-11 09:28:00,0a5fd7ac580c2a536a0f94eea7e4a8a5,0,11,1,1,5,18
2944,1702,2022-10-11 09:33:00,97278f22a3d095bf02de925c91ae1ddd,0,13,0,1,3,17
2945,1702,2022-10-11 09:38:00,478c0e98ba7c4eba1f38939237bfbc41,0,8,0,2,6,16
2946,1702,2022-10-11 09:43:00,b1a1a304e0afd9b840135922e2f65a20,0,7,1,2,3,13
2947,1702,2022-10-11 09:48:00,626d9acf8ddb053c491d5878b3be2ca2,0,13,0,0,4,17
2948,1702,2022-10-11 09:52:00,a85e67ba7b0f51931afcde1c5bdfc6c5,1,17,0,0,2,20
2949,1702,2022-10-11 09:58:00,9dce505f41262a659e24460bbad8ddf6,0,10,0,2,5,17
2950,1702,2022-10-11 10:02:00,f34f367b34f143c2ff28951f3f7f4f21,0,11,0,0,13,24
2951,1702,2022-10-11 10:07:00,36899ad6f1cbe0c27e8d553a40a6e63d,1,17,0,2,3,23
2952,1702,2022-10-11 10:13:00,7bfd828f65b4ece3ed5dbb9b783f9928,0,15,0,2,5,22
2953,1702,2022-10-11 10:17:00,f58b054ae8a778b596b8f6aea050ddd6,0,8,0,0,10,18
2954,1702,2022-10-11 10:23:00,18cf71eaf78c38ea554a927ee0218482,1,15,0,2,6,24
2955,1702,2022-10-11 10:28:00,4f42206adb57efe70c3d5744179ce042,0,17,1,1,7,26
2956,1702,2022-10-11 10:34:00,04cdbf51df62cc4689b07f252798d9ce,0,14,0,3,7,24
2957,1702,2022-10-11 10:38:00,55b296f84d6bd6e5f0390f81342b67a2,0,9,0,0,11,20
2958,1702,2022-10-11 10:42:00,31c1761d95cd4d5a068ed476a5130729,0,25,0,2,2,29
2959,1702,2022-10-11 10:48:00,dcb403b171f02ac7f3e9727abd9cfbc9,0,15,0,5,6,26
2960,1702,2022-10-11 10:52:00,2053f281070d3893a236275c8579e2dd,1,10,1,2,5,19
2961,1702,2022-10-11 10:57:00,4a51268ed0349cf2720884b0673c7cad,1,15,0,5,6,27
2962,1702,2022-10-11 11:08:00,8ad05f92736c2e2cd862d40ff3787b31,0,17,0,1,5,23
2963,1702,2022-10-11 11:13:00,f5ca8a9e2ef0a0bbcb7b753a4b40e694,2,13,0,4,8,27
2964,1702,2022-10-11 11:17:00,bbf5c7dbb6caa660a827aa4ceb6662b8,0,8,0,4,11,23
2965,1702,2022-10-11 11:23:00,ada991dc86af18c90e2e23d539d91e05,0,7,0,2,13,22
2966,1702,2022-10-11 11:29:00,bfeefff6058dc80b7cb898052a0dc7ca,0,22,0,1,6,29
2967,1702,2022-10-11 11:32:00,413a44c30fe459b5401f0c01772b081b,0,16,0,2,6,24
2968,1702,2022-10-11 11:38:00,58d396d67d3dcf32bc504afc9a42e89b,0,12,0,1,7,20
2969,1702,2022-10-11 11:42:00,62df373b6fd3f287f0f12438a9813df3,0,13,0,3,8,24
2970,1702,2022-10-11 11:47:00,29752eb8d3a798c1f280422cee15cfa3,0,12,0,2,10,24
2971,1702,2022-10-11 11:54:00,bc68be93eca3826cd825467a40e2b0ec,0,18,0,4,6,28
2972,1702,2022-10-11 11:57:00,6b0c8516f542875ea21139f911eebda2,0,15,0,1,7,23
2973,1702,2022-10-11 12:03:00,7278657f49b52227ebf7cf324a5d3e59,0,13,0,2,2,17
2974,1702,2022-10-11 12:07:00,b9e9f326ba0a02f2d488c809ca6f18f9,0,11,0,3,6,20
2975,1702,2022-10-11 12:12:00,bea83999f01ef54a0421aec1934fefa1,0,15,1,4,6,26
2976,1702,2022-10-11 12:18:00,7b114a6b0d76c07ea27a9ccd92e3862a,0,16,1,7,1,25
2977,1702,2022-10-11 12:23:00,e34086cdf5f539ec17448276d47352ce,0,20,0,0,11,31
2978,1702,2022-10-11 12:28:00,51844f821cdbb783817e7b48a3daa078,0,17,0,2,3,22
2979,1702,2022-10-11 12:33:00,c3920c1c7e0c7e33b3efc25e4406ea04,0,20,0,1,8,29
2980,1702,2022-10-11 12:37:00,2613fffba4e8766fa097b1e3ef994895,0,16,0,0,6,22
2981,1702,2022-10-11 12:42:00,69ecb0153307867f0d61d0c997892e65,0,11,0,6,10,27
2982,1702,2022-10-11 12:48:00,95f570310d9a72968f278e02c3e3310a,1,16,0,1,6,24
2983,1702,2022-10-11 12:53:00,1eb07d2821de7fb7eff4de835db45c20,0,11,1,1,8,21
2984,1702,2022-10-11 12:57:00,afc011d0a41efbfde9fff5bdec4671ab,0,15,0,6,6,27
2985,1702,2022-10-11 13:03:00,b39aa797ac5e0766a78016c985d0e458,1,13,0,5,8,27
2986,1702,2022-10-11 13:07:00,efff3702e17b13814e519865ce0b8347,0,14,0,2,11,27
2987,1702,2022-10-11 13:13:00,cd2486feb3e7198680a9448d0692dcbd,0,7,0,4,15,26
2988,1702,2022-10-11 13:18:00,f1cacad8d697af3714a0e382885bd529,0,16,0,3,7,26
2989,1702,2022-10-11 13:24:00,4556a370862ca3771423b049982ee2cf,1,17,1,1,9,29
2990,1702,2022-10-11 13:28:00,18076a4f4b5e44a3ee889b86ca5153e2,0,18,0,3,6,27
2991,1702,2022-10-11 13:32:00,ba5c9dbe6792ce30da0dd8b13098917f,0,20,0,1,3,24
2992,1702,2022-10-11 13:39:00,d313bd428078bef2ddc17a42d58e9fb5,0,13,0,5,7,25
2993,1702,2022-10-11 13:43:00,4df3cec205b826ad0a867231ad7e919e,1,16,0,3,7,27
2994,1702,2022-10-11 13:47:00,0d3a69c557233958ec4227b2da96238d,1,12,0,0,17,30
2995,1702,2022-10-11 13:53:00,35df396eb2877303c715ff65d12adbe4,0,12,0,2,12,26
2996,1702,2022-10-11 13:57:00,7a91c018651dc88f099de1d591e1bd08,0,13,0,9,6,28
2997,1702,2022-10-11 14:02:00,6d55a7130b06e03ce1b688f1b17bbe3b,0,16,0,3,13,32
2998,1702,2022-10-11 14:08:00,13de64fb8410b2fc8b5d110f7e82e501,0,15,1,7,7,30
2999,1702,2022-10-11 14:13:00,0e06588b870d86b416bae0a538fe411f,0,15,0,5,7,27
3000,1702,2022-10-11 14:18:00,df743960515caca324184feee80c2f2e,1,19,0,6,6,32
3001,1702,2022-10-11 14:22:00,1dd8a5435fb1e2cc529606db8d380979,1,11,1,2,8,23
3002,1702,2022-10-11 14:27:00,212b3fdbc781bfea62c18b2039f2c512,0,16,0,8,8,32
3003,1702,2022-10-11 14:33:00,64b564b9e058087c16e82888e0ca290e,0,20,0,4,15,39
3004,1702,2022-10-11 14:38:00,7af3012ecc1f49655a576f7584e5a1dc,0,13,0,5,11,29
3005,1702,2022-10-11 14:43:00,41b082444d3363752b4c709cd440f751,0,21,0,1,5,27
3006,1702,2022-10-11 14:49:00,056b9d8587481e70445c5ddfe0089d82,0,19,0,2,10,31
3007,1702,2022-10-11 14:53:00,69a59dde8c686c484ed37a9e6fd2f812,0,15,0,5,6,26
3008,1702,2022-10-11 14:58:00,db31216d7cf6c7b3e7be6e330d888a91,0,13,0,4,3,20
3009,1702,2022-10-11 15:03:00,051472d3bab474281e58690525b885d5,0,16,0,1,13,30
3010,1702,2022-10-11 15:09:00,7474f066deb3da4d369eda911e19e435,0,15,0,3,14,32
3011,1702,2022-10-11 15:14:00,eb3defd47dbc136e3bf7fc43fe188c15,1,9,0,4,10,24
3012,1702,2022-10-11 15:18:00,58324cb4dc8df7ad9da3dc644e7af7a9,0,14,0,2,8,24
3013,1702,2022-10-11 15:24:00,ef541dcdf2a85dd579bbecbe5bf819d0,0,13,1,2,4,20
3014,1702,2022-10-11 15:27:00,ac677538a23b828fef6be41dfdd010ea,0,10,0,0,7,17
3015,1702,2022-10-11 15:34:00,9fda66705f99866fe9f0582c810a21d0,0,13,0,0,5,18
3016,1702,2022-10-11 15:38:00,0a2453f2d6a404ebe3b804cb93d8ce96,0,8,0,1,13,22
3017,1702,2022-10-11 15:42:00,85c880984748fbe6f782e385d710ff22,0,17,0,0,7,24
3018,1702,2022-10-11 15:54:00,9fee16ecaffccea6f366550aacbb25ff,0,14,0,0,7,21
3019,1702,2022-10-11 15:57:00,436770a2ba09f8de2a243be9e381bc59,0,13,0,3,7,23
3020,1702,2022-10-11 16:04:00,0cf31d888de3e90af515e2e993a2c854,0,10,0,2,8,20
3021,1702,2022-10-11 16:09:00,4ad8bdf77e212f5c6b85a2489c8b6883,0,4,0,6,6,16
3022,1702,2022-10-11 16:12:00,802105032df7bb58ee0e54f239961e03,0,5,0,2,11,18
3023,1702,2022-10-11 16:19:00,146fa86f2a60f3640c3b24cb4be904fb,0,11,0,2,6,19
3024,1702,2022-10-11 16:23:00,7478f0e5831629f222c004f0cc593473,0,13,0,4,4,21
3025,1702,2022-10-11 16:28:00,e9facf9c38ef108b27c888ab977a5259,0,13,0,2,4,19
3026,1702,2022-10-11 16:33:00,ee4b1d6de6c4ae4a4ece83387343da45,0,14,0,1,10,25
3027,1702,2022-10-11 16:38:00,8bd2fbe08fbdc3fbfc32ed24526f4d28,0,10,0,3,5,18
3028,1702,2022-10-11 16:44:00,ac8b146f2a942fcb9d434f1fd8ef170c,0,14,0,0,13,27
3029,1702,2022-10-11 16:48:00,f344a30485d85276f9c2eb86f37ad3d9,0,6,0,1,11,18
3030,1702,2022-10-11 16:54:00,e2d16392e1f1749b8ac455fb8839013a,0,9,0,0,16,25
3031,1702,2022-10-11 16:57:00,d7f138ea6e3ce7b24acab80972b23979,0,12,0,1,10,23
3032,1702,2022-10-11 17:02:00,b3a1cd352bc972cc30728aad2ccc027e,0,14,0,1,14,29
3033,1702,2022-10-11 17:08:00,a73391616f099c8b4fe63b8f611a928a,0,9,0,7,10,26
3034,1702,2022-10-11 17:13:00,ac59692b01caddd33cd6d9584271bbea,0,9,0,2,10,21
3035,1702,2022-10-11 17:17:00,9fe0e2dc8538d1f3c457121f3b5c18fb,0,19,0,1,10,30
3036,1702,2022-10-11 17:23:00,91a9b6d23351f390648c1ef6aded8c86,0,18,0,0,7,25
3037,1702,2022-10-11 17:28:00,17786d0fb2b3fffdbfe7d603e2542639,0,13,0,6,11,30
3038,1702,2022-10-11 17:33:00,8ccb7c42c85a230a3a43a9e01a969363,1,13,0,7,11,32
3039,1702,2022-10-11 17:39:00,8bbcf761b4f5083dcf947f6aad0c7d8a,0,15,0,4,10,29
3040,1702,2022-10-11 17:41:00,6c2c2abb860479fe7b648c5d3898181b,0,21,0,1,8,30
3041,1702,2022-10-11 17:47:00,ce72f2674a9bdbe838527cf7c97515fd,0,18,0,2,10,30
3042,1702,2022-10-11 17:53:00,f1f5affd7137d9f1cd2188c34a4b45f3,1,21,0,7,7,36
3043,1702,2022-10-11 17:57:00,0502a5f6f024a06451374b39be0a00f2,0,21,1,1,11,34
3044,1702,2022-10-11 18:03:00,1acef009b0d180a0ca96d177ec60571c,0,18,2,3,13,36
3045,1702,2022-10-11 18:08:00,ec79b1fd45dd1e3025c35e4961a2fbe4,1,22,0,4,7,34
3046,1702,2022-10-11 18:12:00,d9cba5b92793605b698888af9253f7ef,0,17,0,5,4,26
3047,1702,2022-10-11 18:18:00,e29afd5176e93e6bf742ae62393a3dc8,0,13,0,2,11,26
3048,1702,2022-10-11 18:23:00,469720f5af129ddc40604ab7959ace87,3,17,1,1,6,28
3049,1702,2022-10-11 18:28:00,aeb8bfbe38a2ba8e7616fb2343679279,0,19,0,2,7,28
3050,1702,2022-10-11 18:32:00,4659038651bfc1c2ef4b74c0cfe4240d,0,15,0,3,11,29
3051,1702,2022-10-11 18:37:00,93a928bf40207be713d38fc346dbe8af,0,20,0,1,12,33
3052,1702,2022-10-11 18:42:00,56f972eb331041629a103825793b14a4,0,23,0,2,10,35
3053,1702,2022-10-11 18:47:00,503d794279bee706a52ea4bdfa3aa486,1,20,0,0,12,33
3054,1702,2022-10-11 18:53:00,caf5cee03b6c5c889e892fbcf6e7f5e5,0,25,1,2,9,37
3055,1702,2022-10-11 18:57:00,f49b58997bd2aca4802d36b7f14d7355,0,18,0,1,8,27
3056,1702,2022-10-11 19:02:00,d2d834355ec29037a608cf92e0a9b10c,0,27,0,3,4,34
3057,1702,2022-10-11 19:07:00,a00ffd46f20c68dde14c2a7c78e6c56d,0,21,2,0,2,25
3058,1702,2022-10-11 19:11:00,84b87fbf64bae7cc394b1f3ddce4d7f3,0,20,1,1,2,24
3059,1702,2022-10-11 19:17:00,a842296ee04fc83612cc23e1947925b2,1,22,1,0,0,24
3060,1702,2022-10-11 19:23:00,6d92c44fa1b65c1de102382c17792298,1,18,2,1,1,23
3061,1702,2022-10-11 19:26:00,8dce24a6f7a29af1d3a2b09bf5caed9f,0,17,1,0,0,18
3062,1702,2022-10-11 19:32:00,fabbd1a67dabe1309d5a18355d26c2ac,0,21,1,0,0,22
3063,1702,2022-10-11 19:38:00,c312d2a7a0425905c48e79692a7ee4fc,0,22,3,0,3,28
3064,1702,2022-10-11 19:41:00,218e0ba9a2bd5a5651211fa85055fc73,0,17,1,0,1,19
3065,1702,2022-10-11 19:47:00,f3cb77f1fff03c095c2f0ff4176a03f1,0,22,1,0,2,25
3066,1702,2022-10-11 19:51:00,48a6665daeb3fb4442ec66ff79f481f0,0,26,0,0,1,27
3067,1702,2022-10-11 19:56:00,2c3803b9e3a2d89268e88f919af39ab9,1,18,0,1,0,20
3068,1702,2022-10-11 20:03:00,e92dbc9e36c31e423e2222028694848b,0,12,1,0,0,13
3069,1702,2022-10-11 20:07:00,511987f428744f8bcc321f51e021c410,0,16,1,0,0,17
3070,1702,2022-10-11 20:13:00,846ba96e39dcb6e88648b524cd6f6124,0,14,2,0,1,17
3071,1702,2022-10-11 20:17:00,a94038dffc233bf8d8622542cae9f17f,0,14,0,2,1,17
3072,1702,2022-10-11 20:22:00,73e6d9c47f0a23abbd9a2f5bb481b88d,0,14,2,0,0,16
3073,1702,2022-10-11 20:27:00,bbd3c09e5f15ff2c167cd8cc5aefabcc,0,15,0,0,1,16
3074,1702,2022-10-11 20:32:00,4724fed38025969d920c00d3478d2a63,0,17,0,0,1,18
3075,1702,2022-10-11 20:37:00,8d7cccf30ba92b2caff43a8afb79bb1a,0,4,0,0,2,6
3076,1702,2022-10-11 20:43:00,1708ca6504f11d9eb4c10f907d189385,0,6,0,0,0,6
3077,1702,2022-10-11 20:48:00,b663091c43ba1680c4f210cb90f13a47,0,4,0,0,0,4
3078,1702,2022-10-11 20:52:00,14afc5b0787511444850a51faa4067fe,0,10,0,0,0,10
3079,1702,2022-10-11 20:56:00,8bf7b237f8f1693d7be3a399f4b6d66b,0,7,0,0,0,7
3080,1702,2022-10-11 21:02:00,b44fc9e5002ecd47169b39f092a7cecf,0,3,0,0,0,3
3081,1702,2022-10-11 21:07:00,facab72c52ae062c4aebd72c82e4b4e2,0,6,0,1,0,7
3082,1702,2022-10-11 21:12:00,bc42df5b50e878e38320d655fcaf611c,0,4,0,0,0,4
3083,1702,2022-10-11 21:17:00,d6666f20436818bb5963dd3a197e0e3a,0,9,0,1,0,10
3084,1702,2022-10-11 21:22:00,98d2843bc057c8f75e7233e3ead7f86a,0,12,0,1,0,13
3085,1702,2022-10-11 21:27:00,6290f08f1c230a3119d70dcda1f9ab2a,0,12,0,0,0,12
3086,1702,2022-10-11 21:33:00,729fc4afdcb4895f0f72ca34f4a15501,0,10,0,0,0,10
3087,1702,2022-10-11 21:37:00,6801a9a5ac5985d7a28c1e36660f7a95,0,11,0,0,0,11
3088,1702,2022-10-11 21:41:00,981d3e076e90ee4aa2b69c4deb531790,0,17,0,0,0,17
3089,1702,2022-10-11 21:47:00,4431dc36f73d09686817fb1fd486a39b,0,8,0,1,0,9
3090,1702,2022-10-11 21:52:00,ad5c0fa20be311efbcf0c93efc1b74c6,0,6,0,1,0,7
3091,1702,2022-10-11 21:56:00,16482138e0a731442ae12ccdcebc44fe,0,16,1,0,0,17
3092,1702,2022-10-11 22:01:00,75b798e9bd7778963332be2bf2d03b48,0,3,0,0,1,4
3093,1702,2022-10-11 22:07:00,daf03eb2457d0fb4f2b6ff29ae4ea2b3,0,9,1,0,0,10
3094,1702,2022-10-11 22:12:00,db56b37c3db81f6189c131232026fd99,0,1,0,0,0,1
3095,1702,2022-10-11 22:17:00,eabf97f680f622f2bffa8c39d045d7a0,0,14,0,0,0,14
3096,1702,2022-10-11 22:22:00,a6f36db34030113ba681602b74694736,0,9,0,0,0,9
3097,1702,2022-10-11 22:27:00,87510c8c77cd596d0dbf4b95bf6893c1,0,14,1,0,1,16
3098,1702,2022-10-11 22:32:00,8ba608dac65c791c09918945fb8282c9,0,13,0,0,0,13
3099,1702,2022-10-11 22:37:00,6af821aa69813d9ec05823e403e05cac,0,8,0,0,0,8
3100,1702,2022-10-11 22:42:00,9cf9cd55cfd7d3c22e6fa8351cfe8632,0,6,1,0,0,7
3101,1702,2022-10-11 22:47:00,b299c3eef8662e0cc203ea7d6235099b,0,4,0,0,0,4
3102,1702,2022-10-11 22:52:00,4b1e16c317b502cd24ff35e143c7448b,0,8,0,0,0,8
3103,1702,2022-10-11 22:56:00,6a4020cfee2559371a1d00675024c376,0,6,1,0,0,7
3104,1702,2022-10-11 23:02:00,b20a1cee976f0d7d3fdb7a92875c8408,0,6,0,0,0,6
3105,1702,2022-10-11 23:08:00,ccb3e13922670d6a914e58501e92b8a0,0,7,0,0,1,8
3106,1702,2022-10-11 23:11:00,075ee1fe7ba7ec92355950ee14eff770,0,5,0,0,0,5
3107,1702,2022-10-11 23:17:00,dc0b0d00c2c1e6ca0444e1dc51aa1a98,0,3,0,0,1,4
3108,1702,2022-10-11 23:22:00,99f48775c89ce3be3c31ffd45d76bae2,0,3,0,0,0,3
3109,1702,2022-10-11 23:27:00,e95c8443b966bdc0dd46b6cddd6cea72,0,14,0,0,0,14
3110,1702,2022-10-11 23:31:00,d2f47ae729eed14198a0daf6750ee332,0,6,0,0,0,6
3111,1702,2022-10-11 23:38:00,eea5d2218f8df7a6e6283b6e305458ad,0,7,2,0,0,9
3112,1702,2022-10-11 23:42:00,b0c641ec44e9be27235bae33920d65db,0,8,0,0,0,8
3113,1702,2022-10-11 23:47:00,97d0d6eb1dc81d1d6479998f62cbcc51,0,5,0,0,0,5
3114,1702,2022-10-11 23:53:00,62af5ea883bffe58c8694f39e9680118,0,4,0,2,0,6
3115,1702,2022-10-11 23:57:00,4b66cd1de010db58f526387d9a71f480,0,5,0,0,0,5
3116,1702,2022-10-12 00:02:00,8ea76cc5b28fe8ce51f34de9373b688e,0,13,1,0,0,14
3117,1702,2022-10-12 00:07:00,6f4ca99c27a9fcf07a63e1655b821584,0,16,0,0,0,16
3118,1702,2022-10-12 00:12:00,fa3506030240150fbc82739ae867007e,0,5,0,0,1,6
3119,1702,2022-10-12 00:17:00,a89190e2b768c08f74302e9da25eb7e8,0,7,0,0,0,7
3120,1702,2022-10-12 00:23:00,861bed28495f57caa228332d3c98ff8f,0,7,0,0,0,7
3121,1702,2022-10-12 00:27:00,30564dca6d255cd9a0615ddc1e8cdcc9,0,7,0,0,0,7
3122,1702,2022-10-12 00:32:00,8a5d582a56adc6bbfbf872a2cb4bc1ee,0,7,0,0,0,7
3123,1702,2022-10-12 00:37:00,ee7693cf296d635430672f42cdd3af51,0,3,0,0,0,3
3124,1702,2022-10-12 00:42:00,39c092b7beafd234cdedd36354bdc195,0,11,0,2,0,13
3125,1702,2022-10-12 00:47:00,d4136c02dc58cbfcf57b16d56b782c0b,0,2,0,0,0,2
3126,1702,2022-10-12 00:52:00,c158fd91a326414914e3685a990ce41d,0,5,0,0,0,5
3127,1702,2022-10-12 00:57:00,ab126d606df13ab80b97e6b479927fdd,0,2,1,0,0,3
3128,1702,2022-10-12 01:03:00,7b36575fb3e673d4119b75a02b3fca5e,0,6,0,0,0,6
3129,1702,2022-10-12 01:07:00,da4e9607a906084c53746debdd2aee2e,0,3,0,0,0,3
3130,1702,2022-10-12 01:12:00,266771be91dd620b299677710ae14549,0,5,0,0,0,5
3131,1702,2022-10-12 01:17:00,6e306b574de743fceb29a8e6676b3379,0,4,0,0,0,4
3132,1702,2022-10-12 01:23:00,80489289f5881641eb0fd11d22624869,0,1,0,0,0,1
3133,1702,2022-10-12 01:27:00,8711d4fba972951b9e8de283837faa47,0,14,0,1,1,16
3134,1702,2022-10-12 01:32:00,083a9614aecd86da1c33a7772194a01e,0,8,1,0,2,11
3135,1702,2022-10-12 01:37:00,750b219cfbecd9100bb13dfdfb6f8bb3,0,5,0,0,0,5
3136,1702,2022-10-12 01:42:00,233398fa5874da55ba7285bdfcee3475,0,7,0,0,1,8
3137,1702,2022-10-12 01:48:00,f7f634e36d8a5d4de4204de3b9b98c43,0,9,0,0,1,10
3138,1702,2022-10-12 01:52:00,d8df3c16d15f3c905d157607313bbf92,0,2,0,0,0,2
3139,1702,2022-10-12 01:57:00,7e2f026b068c05f37582bbb50457c82a,0,3,0,0,0,3
3140,1702,2022-10-12 02:02:00,604131467eb4f3b5dff187db92af8b2e,0,3,0,0,0,3
3141,1702,2022-10-12 02:07:00,7d69e227b9a39a280ebe2a35b4d220ea,0,2,0,0,0,2
3142,1702,2022-10-12 02:13:00,23c7d05a1c01b02d564dcdc0877d40c5,0,3,0,0,0,3
3143,1702,2022-10-12 02:17:00,8d26b40907c40d95a825ef637be76fb1,0,4,0,0,0,4
3144,1702,2022-10-12 02:22:00,4a94416abc187a839ca893870243869d,0,1,0,0,0,1
3145,1702,2022-10-12 02:27:00,a16114352048df316e5af0f89c781f9d,0,2,0,0,0,2
3146,1702,2022-10-12 02:32:00,044026bf619fc697fc78eeca989866e3,0,1,0,0,0,1
3147,1702,2022-10-12 02:38:00,36f41c2df1416011d900b04836775d88,0,0,0,0,0,0
3148,1702,2022-10-12 02:42:00,a3fc8807c08e45094f2bd78db315ad36,0,0,0,0,0,0
3149,1702,2022-10-12 02:47:00,a9333c4e39ecf0d49191daa060fa6e44,0,0,0,0,0,0
3150,1702,2022-10-12 02:53:00,03be6113154d33a9ad9254e1bc0a2691,0,1,0,0,0,1
3151,1702,2022-10-12 02:57:00,9a26a67b8e2241ef05c7398583cc4a8b,0,0,1,0,0,1
3152,1702,2022-10-12 03:02:00,d8da43d0f6e7be5fb0bd22d50e0c06a6,0,0,0,0,0,0
3153,1702,2022-10-12 03:06:00,b0033956633afd792bd43ba3375d75d0,0,2,0,0,0,2
3154,1702,2022-10-12 03:12:00,1fea55d83b755f4d9a39af9c373e95ee,0,4,0,0,0,4
3155,1702,2022-10-12 03:17:00,9938d0614b3daa6247f51cd19540636e,0,0,0,0,1,1
3156,1702,2022-10-12 03:21:00,8ce3be86c89ceabe7697db70a4c99eac,0,3,0,0,0,3
3157,1702,2022-10-12 03:27:00,ba68339ece8f76aa8dbbc67eaed276d4,0,4,0,0,0,4
3158,1702,2022-10-12 03:32:00,7266413bc0b43270f3d5e7a7d226c99a,0,1,0,1,0,2
3159,1702,2022-10-12 03:36:00,7526f9fe3f1d1af337dfb7dd8a2b2946,0,4,0,0,0,4
3160,1702,2022-10-12 03:41:00,e8edf9a7a74bc8e1af68f3aaf97680ed,0,1,0,0,0,1
3161,1702,2022-10-12 03:47:00,296d1d2c5960497ae5916d1d984a7147,0,1,0,0,0,1
3162,1702,2022-10-12 03:52:00,6d36d62dfc9976d1bb86a554ced59ccb,0,1,0,0,0,1
3163,1702,2022-10-12 03:56:00,67e5b8d57d4914d35956ef47e67e265f,0,3,0,0,0,3
3164,1702,2022-10-12 04:01:00,0af5af35ac1eb0a7872120d66fd877ec,0,0,0,0,0,0
3165,1702,2022-10-12 04:06:00,d339d1ef81f9fa7200f5c69c3d791373,0,1,0,0,0,1
3166,1702,2022-10-12 04:11:00,ff2bbab585c91ed878169eab78ce9c05,0,4,0,0,0,4
3167,1702,2022-10-12 04:16:00,da244e29a406640a11e2664b2e0ddf33,0,0,0,0,0,0
3168,1702,2022-10-12 04:22:00,bdce4dc6d57b2f2593820ff789465927,0,0,0,0,0,0
3169,1702,2022-10-12 04:26:00,39e3e9c88b6f5043a208d2597e71ffc4,0,1,0,0,0,1
3170,1702,2022-10-12 04:32:00,1c6e01a97b6589fc3fc3e497c8eae987,0,0,0,0,0,0
3171,1702,2022-10-12 04:38:00,4937073c7520f5f417718d31f23111f0,0,0,0,0,0,0
3172,1702,2022-10-12 04:41:00,cc1a39942838b11211036e8a55fff8f5,0,5,0,0,0,5
3173,1702,2022-10-12 04:48:00,38e8abb076cd8782db656432545f7ff7,0,4,0,0,0,4
3174,1702,2022-10-12 04:53:00,ea2aaf758d98b7809bc162fe1e0991ec,0,0,0,0,0,0
3175,1702,2022-10-12 04:56:00,562833b6dd18de6f68711e1e0c6a239d,0,3,1,0,0,4
3176,1702,2022-10-12 05:01:00,5b1611bc611ab5505fe96b344d544a36,0,11,0,0,1,12
3177,1702,2022-10-12 05:06:00,4934d82188c471d1f549ee4b7c3fea39,0,1,0,0,0,1
3178,1702,2022-10-12 05:12:00,3aff20918fcd5645ec3fd02d0ae6ff1d,0,2,0,0,0,2
3179,1702,2022-10-12 05:17:00,a69fde13454095b3944b16a3f9a66ad8,0,7,0,0,0,7
3180,1702,2022-10-12 05:22:00,50114981536c24138ca0b4c4a859745d,0,3,0,0,0,3
3181,1702,2022-10-12 05:27:00,e0c0a0d3e0d583c6b8f7c81d0ca8dcba,0,1,0,0,0,1
3182,1702,2022-10-12 05:32:00,ef3ae6f0418640e43159eaafa5b93c8d,0,2,0,0,1,3
3183,1702,2022-10-12 05:37:00,bcf8b2ff4d917b834258dfb82af3c74e,0,3,0,0,0,3
3184,1702,2022-10-12 05:41:00,a8d946281a8bfedfe9f7a37d5a80fc09,0,3,0,0,0,3
3185,1702,2022-10-12 05:48:00,57df4fd2cf370621f1175c54f44e84fc,0,1,0,1,0,2
3186,1702,2022-10-12 05:53:00,ca8a390088aad4095e1841cb5a68801a,0,5,0,0,0,5
3187,1702,2022-10-12 06:02:00,efa0914e92de9678a312a9bc8635963d,0,2,0,0,0,2
3188,1702,2022-10-12 06:07:00,e1fa9632c9a7a26f3e697e800c2d4e37,0,8,0,3,0,11
3189,1702,2022-10-12 06:11:00,7443265f6b9220b1ee3441efc1ddb06f,0,2,0,1,0,3
3190,1702,2022-10-12 06:18:00,7fe477481f986ff3195809a7a9a676a2,0,3,0,3,0,6
3191,1702,2022-10-12 06:23:00,b8a4772160d8c5c2afb198cc85c022ce,0,2,0,0,0,2
3192,1702,2022-10-12 06:26:00,7570d62db4e68ceaac2e9c2c2b934d70,0,3,0,0,1,4
3193,1702,2022-10-12 06:32:00,6689f9e9c70ada7b623d318a2e025d1a,0,2,1,0,0,3
3194,1702,2022-10-12 06:38:00,171089b7e991b6035aafcc962dfac43e,1,10,0,1,0,12
3195,1702,2022-10-12 06:41:00,ff779a72ba5e6ffc6b6e0bbbbd3694c7,0,16,0,2,2,20
3196,1702,2022-10-12 06:48:00,66c1ccaa88cdbc090306da14b5658297,0,15,0,0,3,18
3197,1702,2022-10-12 06:52:00,84e38f5da5447b392226e043ee3ad1ec,0,19,0,0,3,22
3198,1702,2022-10-12 06:58:00,dd11e31c282c6f7560984409d873a60d,0,16,0,4,5,25
3199,1702,2022-10-12 07:03:00,9a9e3dee885371318faab5f3b61ebea0,1,20,0,1,3,25
3200,1702,2022-10-12 07:08:00,fa0652d821aa0004cfe14967112fee8f,0,14,0,0,11,25
3201,1702,2022-10-12 07:12:00,3986effaf93bb6cd85876c7ebdb48d18,0,16,0,4,10,30
3202,1702,2022-10-12 07:17:00,7d718bfd7ceed6795662c719e6874aeb,0,11,0,6,11,28
3203,1702,2022-10-12 07:22:00,74a5bb1f262764feafbd35bf5b1ed327,0,9,0,0,12,21
3204,1702,2022-10-12 07:28:00,e0e005d61261d36110215c80d9398418,0,17,0,2,7,26
3205,1702,2022-10-12 07:33:00,beed6497612cae4db21ab87184094437,0,12,0,1,10,23
3206,1702,2022-10-12 07:38:00,18a0c9ab1e3002c73f6f00cc8c0416a8,0,13,2,4,6,25
3207,1702,2022-10-12 07:43:00,8f370b36cf06ba48bc3404da5543f635,0,13,0,3,10,26
3208,1702,2022-10-12 07:47:00,d643a2693a2a5bac95f117794b639abb,2,8,0,8,11,29
3209,1702,2022-10-12 07:51:00,b8261a05a2351f61404d56f28fadc2a0,2,15,0,0,10,27
3210,1702,2022-10-12 07:57:00,64847d658e1d8df6917aaaffa95b38d1,0,11,0,3,9,23
3211,1702,2022-10-12 08:03:00,a5b8ef959c982f87ff99692b2495e0ef,1,17,0,2,11,31
3212,1702,2022-10-12 08:08:00,89a85c91cdd4484beca6fe42e39bb2ee,1,18,1,1,6,27
3213,1702,2022-10-12 08:13:00,5642116b15bf4bc11c3af68e6de88c04,0,16,0,5,7,28
3214,1702,2022-10-12 08:19:00,2050380afe92d136e508fd5e779a19f5,1,20,0,8,5,34
3215,1702,2022-10-12 08:22:00,59fd697c760c946c6f29afd2148f6de5,0,19,0,1,9,29
3216,1702,2022-10-12 08:27:00,40f3ca6ec77329568b6e99f760caa1b4,0,16,0,4,10,30
3217,1702,2022-10-12 08:33:00,3b38797c125caf5dc19354dfee9f497e,0,16,0,6,7,29
3218,1702,2022-10-12 08:38:00,b14897b197e5574645eaca625e5b100c,0,14,0,2,13,29
3219,1702,2022-10-12 08:42:00,4b7d9b91faa43fd8d1aacf6268aa6802,0,11,0,0,12,23
3220,1702,2022-10-12 08:49:00,cf9a607041531d9aca7e7ce78425013a,0,12,0,4,15,31
3221,1702,2022-10-12 08:54:00,2742d49a1e209d7147c6b1e982860521,0,22,0,2,5,29
3222,1702,2022-10-12 08:58:00,77e308fe842689ed27a9fbd82ad46e27,0,15,0,2,7,24
3223,1702,2022-10-12 09:03:00,580a7ecb86015ed16b6d81fc45e232fe,0,12,2,0,6,20
3224,1702,2022-10-12 09:07:00,7bcf23b7ba98a685e0677c5775a0f216,0,11,0,0,11,22
3225,1702,2022-10-12 09:13:00,6fb011e3181ffd9b04a28cac0bbb3b8f,2,13,0,2,12,29
3226,1702,2022-10-12 09:18:00,dc4f326882c294163e3596196b2a69af,0,14,0,1,9,24
3227,1702,2022-10-12 09:23:00,77e6703696a69226d58d2c9f4997cd0e,1,25,0,2,7,35
3228,1702,2022-10-12 09:27:00,13c7936674f8823840e88c15aa42d1e2,0,11,0,0,17,28
3229,1702,2022-10-12 09:33:00,01a8989e5b7df533d83bd44c970b25c0,0,10,0,1,13,24
3230,1702,2022-10-12 09:38:00,a18f6f8095c873c5e5948a117c9cb427,1,5,0,0,11,17
3231,1702,2022-10-12 09:43:00,34625240392b91d00bb95a4b4e9568d3,0,14,0,2,7,23
3232,1702,2022-10-12 09:48:00,0c803ce08e22923fce39196686ed2a70,0,12,0,2,7,21
3233,1702,2022-10-12 09:53:00,360e8d36f1476457e74b75664c983029,0,6,1,1,10,18
3234,1702,2022-10-12 09:57:00,cc0e05962af3572e12a10f1f3ee0cdef,0,15,1,1,7,24
3235,1702,2022-10-12 10:03:00,fa39ad89767796930fee23e536b1eedc,0,10,0,2,11,23
3236,1702,2022-10-12 10:08:00,0a33a4a88aba7828d91fadfb5cb0c199,0,17,0,1,7,25
3237,1702,2022-10-12 10:12:00,0b4a2142697923667885472d572b8cd3,0,18,0,2,6,26
3238,1702,2022-10-12 10:17:00,1bf08c12b1e6d6fdbcc778a36c1b9d51,0,17,0,3,8,28
3239,1702,2022-10-12 10:23:00,e21c701ec8509b84ffaf5aca0f23b434,0,12,0,2,7,21
3240,1702,2022-10-12 10:27:00,eb7c7516d42661d6d7620c5be8d9c4b7,0,11,0,3,11,25
3241,1702,2022-10-12 10:33:00,da6ada72b39ccd2a871b93adfbd5970b,0,11,0,2,13,26
3242,1702,2022-10-12 10:38:00,877964145b49a5e11cc3cdec307ba1b2,2,15,0,2,7,26
3243,1702,2022-10-12 10:43:00,809f70743ad429776f3b6af99626ecf6,0,14,0,5,6,25
3244,1702,2022-10-12 10:48:00,81e1825abfafd674feb8f965e2334c6e,0,6,0,1,16,23
3245,1702,2022-10-12 10:53:00,b517b5e809cefd98219437cea53cc85d,1,15,0,1,14,31
3246,1702,2022-10-12 10:58:00,42c3fd60f441d88fb1f0d2adf1f6efd0,0,12,0,8,5,25
3247,1702,2022-10-12 11:03:00,0cd9e8bf2a712410fa2693dabbf2504e,0,15,1,3,10,29
3248,1702,2022-10-12 11:08:00,3c3079d6836c1481670fa15ee496588d,0,7,0,0,21,28
3249,1702,2022-10-12 11:13:00,62e4af175b3ba4b870ef08627bce5aed,0,16,0,0,15,31
3250,1702,2022-10-12 11:18:00,eb038d2baf409e953ae47840a350fee3,0,11,0,0,16,27
3251,1702,2022-10-12 11:22:00,0a72dd383b4ac36e25b9bc7363fc9cf5,0,10,1,2,12,25
3252,1702,2022-10-12 11:28:00,a734469ec055c653ddf8ddb1c9854a89,0,12,0,0,8,20
3253,1702,2022-10-12 11:33:00,1fa276fffed0dc25b54ef1763287425e,0,14,0,1,9,24
3254,1702,2022-10-12 11:38:00,2ba234ed35ba81c089e15bc10eff0f1b,0,14,0,1,7,22
3255,1702,2022-10-12 11:42:00,08ffe0dd197034ce3bdd77dd13b064ca,0,16,0,4,5,25
3256,1702,2022-10-12 11:48:00,01bdb24b936e7e4da0b5349a02c4f620,0,11,0,3,11,25
3257,1702,2022-10-12 11:54:00,bb2347a1fae624945a1a545269085933,1,9,0,2,12,24
3258,1702,2022-10-12 11:58:00,f01192be5219f961a71910f73231e590,0,13,0,3,6,22
3259,1702,2022-10-12 12:03:00,f985ff9034a90c13a1815b51f8eebb37,0,13,0,1,5,19
3260,1702,2022-10-12 12:08:00,45057b9cf24eb11c125e274c9afaf500,0,15,0,1,11,27
3261,1702,2022-10-12 12:12:00,3129b9fd965252addbc88a03bc865237,0,14,0,4,8,26
3262,1702,2022-10-12 12:18:00,27304a0913e9f9d960bf77500b93c7c2,0,18,0,0,10,28
3263,1702,2022-10-12 12:22:00,9f171122e77e54478204f09fca6b081e,0,15,1,2,7,25
3264,1702,2022-10-12 12:29:00,8d10c219dca30751a5855d6cca5f3f60,0,11,1,0,14,26
3265,1702,2022-10-12 12:33:00,b787255d93e561f212a9e95deb9c0765,0,18,0,2,6,26
3266,1702,2022-10-12 12:38:00,8295096e5ee6fde75fbd24b7e7259206,0,16,0,5,3,24
3267,1702,2022-10-12 12:43:00,3d09203544e283f9198b12d623c34ca3,0,12,0,1,7,20
3268,1702,2022-10-12 12:48:00,9d9600a0d96956591c0817d250cbe181,0,15,1,4,7,27
3269,1702,2022-10-12 12:53:00,24834d2914112c6171968f3ab271c7d6,0,13,0,4,12,29
3270,1702,2022-10-12 12:57:00,53ad418c4e0f905fb1526f1548bcaa9f,0,19,0,5,2,26
3271,1702,2022-10-12 13:03:00,d39323841cdeabccc91b89f95457b67f,0,13,0,4,11,28
3272,1702,2022-10-12 13:08:00,c687e1b85b303ce6458a6ac101d95f26,0,10,0,1,12,23
3273,1702,2022-10-12 13:13:00,7c95b9a090b2f84f94e2a9c5ec929fd2,0,11,0,5,8,24
3274,1702,2022-10-12 13:17:00,a29314609d4821abb2242eaf1ca46fa2,0,17,0,3,6,26
3275,1702,2022-10-12 13:23:00,28a518dc4d9c909e9d3d9c8e41e0d84c,0,18,0,5,9,32
3276,1702,2022-10-12 13:27:00,77e36d55dc97c711935d01a14af196e2,0,15,1,2,8,26
3277,1702,2022-10-12 13:33:00,1e3aa202319ba5e5465f0b31e7e3933d,0,13,0,6,8,27
3278,1702,2022-10-12 13:38:00,bba4cb2ea8cb055e2b22fe51a6f16ac8,0,11,0,5,8,24
3279,1702,2022-10-12 13:42:00,20e21e72ce5b45df98b4b8298624edfd,0,15,0,2,9,26
3280,1702,2022-10-12 13:47:00,f7add2bc9d6c8393276bde916f182b10,0,16,0,1,9,26
3281,1702,2022-10-12 13:52:00,f96938b79dea6d04ca999405a8e069fe,0,12,0,0,10,22
3282,1702,2022-10-12 13:58:00,2c83d86914c63918b7297be514194a03,0,13,0,4,14,31
3283,1702,2022-10-12 14:02:00,8516aa138f44a5dc3338b987bb67de6f,1,15,0,1,7,24
3284,1702,2022-10-12 14:07:00,89ce59fe70ac45f4f21649619b06e04b,1,16,0,4,3,24
3285,1702,2022-10-12 14:12:00,7758b1b5230ac354e25aefe4bd2f6be2,0,14,0,1,13,28
3286,1702,2022-10-12 14:16:00,a3c18172eb390a332c56c39a644381eb,0,12,0,7,7,26
3287,1702,2022-10-12 14:22:00,6608665d0b171c46416e0de29029b9a4,0,12,0,2,10,24
3288,1702,2022-10-12 14:26:00,5751e206c66ab60edeb8afe57607a36e,0,7,0,2,15,24
3289,1702,2022-10-12 14:33:00,1fcb894699cddd90e51e380ca6607143,0,12,2,5,11,30
3290,1702,2022-10-12 14:39:00,fc6e454488e4e7dbfdaff18bb238cb00,0,13,0,2,12,27
3291,1702,2022-10-12 14:43:00,2049e8d5e6df78379429b57a2a5cb4c2,0,9,0,2,16,27
3292,1702,2022-10-12 14:48:00,9d7963f8280934dd0d77701afda8cf80,0,9,0,1,16,26
3293,1702,2022-10-12 14:53:00,131699ce3d5466a9e5ab29552714fb73,0,8,0,2,13,23
3294,1702,2022-10-12 14:56:00,e28b46a0ad36c4ecb2acfcf4438b0a79,1,25,0,1,6,33
3295,1702,2022-10-12 15:03:00,8c34cfee0be21c333d6468000bec18c2,0,14,0,4,8,26
3296,1702,2022-10-12 15:08:00,ca836ad75975953a629c7abb9d885a24,0,13,0,2,6,21
3297,1702,2022-10-12 15:12:00,977142b12dd51af5cf7ab1745966e8db,1,13,0,1,14,29
3298,1702,2022-10-12 15:18:00,0c9fcc06e916221686c8e90d4d6eeb59,0,14,0,2,6,22
3299,1702,2022-10-12 15:22:00,b040c169d30d6cf6c1ce6f6ab0c8aa21,0,11,0,4,17,32
3300,1702,2022-10-12 15:27:00,8fd6e95124a559ec369d5e6a42b93b2f,0,11,0,1,8,20
3301,1702,2022-10-12 15:32:00,cc210b237796f90ba12e9de14ddeaea7,0,8,0,1,16,25
3302,1702,2022-10-12 15:38:00,4969c1dca7842fa46fbdbd1ae4ae3ed1,0,12,0,1,7,20
3303,1702,2022-10-12 15:42:00,2118424168a356f95d06e6de1c112ad4,0,12,0,4,10,26
3304,1702,2022-10-12 15:47:00,55779882df4df6b11e42c99762a044cb,0,10,0,5,7,22
3305,1702,2022-10-12 15:53:00,e15177c898fa3dfb4299e95fcd51181c,1,11,1,3,8,24
3306,1702,2022-10-12 15:57:00,910a6a115a04399b596d4c5ca62d4249,0,8,1,3,12,24
3307,1702,2022-10-12 16:03:00,765902276183e843cb32001af3e21b1c,0,13,0,0,14,27
3308,1702,2022-10-12 16:08:00,c538170bc85a8e092e52566250c78913,0,9,0,1,8,18
3309,1702,2022-10-12 16:13:00,85b5921d29b596ecacd07c750bd90519,0,14,0,3,13,30
3310,1702,2022-10-12 16:17:00,c3ba71f6d0c8bca4549797c647141caf,0,19,0,2,15,36
3311,1702,2022-10-12 16:23:00,e9f7bcdc046ab2cd6c4015b30c8d6a8a,1,17,0,6,8,32
3312,1702,2022-10-12 16:27:00,a3747b570a9159fb9f5863b259fa15ac,0,17,0,6,13,36
3313,1702,2022-10-12 16:32:00,ea786cab721b044894162d852eaff50d,0,11,0,4,17,32
3314,1702,2022-10-12 16:37:00,1ae0944d2d7204c4c0329590e06ad175,1,8,0,3,14,26
3315,1702,2022-10-12 16:41:00,b4b2f64b29ffe5626e6faae26e992ce3,1,12,1,3,12,29
3316,1702,2022-10-12 16:47:00,bfcbdd2fafe9330feb4e24fc10074ca9,0,23,0,4,1,28
3317,1702,2022-10-12 16:52:00,8b305a42e48e94fa3e47ff9b97d36f48,0,14,0,3,7,24
3318,1702,2022-10-12 16:58:00,67e3c5493f4f858d21b7af44c8c591c0,0,16,0,1,7,24
3319,1702,2022-10-12 17:02:00,040b82e27d51eb62ea42fb71762b10a8,0,12,0,1,7,20
3320,1702,2022-10-12 17:08:00,4e4f62bae4ba91930f65ceada35cd5b2,1,14,1,2,9,27
3321,1702,2022-10-12 17:13:00,3585b030b2e2b9482be8af026b234220,2,10,0,2,9,23
3322,1702,2022-10-12 17:17:00,eed1dcefad71904d763ae0ff93dfb917,0,11,0,5,14,30
3323,1702,2022-10-12 17:22:00,10ff74460bfe5cfda5de6f40ee12f7ea,2,24,0,7,3,36
3324,1702,2022-10-12 17:27:00,3e4cf57942e4a5f1aab95962f787b73f,3,15,0,3,19,40
3325,1702,2022-10-12 17:33:00,aa9e3390e44c39a1dbe0cb3bd382c4e1,0,22,0,9,10,41
3326,1702,2022-10-12 17:38:00,cb9b243c9b91527768c905788ad3a85b,0,10,0,5,15,30
3327,1702,2022-10-12 17:43:00,4ae11ffd3228075ace89df6b5b0ab4c7,1,15,0,7,11,34
3328,1702,2022-10-12 17:47:00,8a951fc94e92a15c2c83c790377da171,0,16,0,3,12,31
3329,1702,2022-10-12 17:53:00,61b5ec838c9a862218b7212bf017e126,0,21,2,5,9,37
3330,1702,2022-10-12 17:57:00,c0c4dd1f3444fd12009118a08a5e9494,3,13,0,5,14,35
3331,1702,2022-10-12 18:02:00,1d0d9fa8c3435a3515209538927e1a96,0,14,0,5,11,30
3332,1702,2022-10-12 18:08:00,7f2f16f3a7501a357a48bf33cfb1b395,0,12,0,7,17,36
3333,1702,2022-10-12 18:12:00,b5d224958b2ff35781b5be4399eb9eb4,0,19,0,5,7,31
3334,1702,2022-10-12 18:18:00,1cc63bb889102eecf33dc769771fb572,2,18,1,5,8,34
3335,1702,2022-10-12 18:23:00,b23ab695497034e79427d128000f22ee,0,25,0,3,7,35
3336,1702,2022-10-12 18:27:00,5e9101e584b2ccaa897b588c568f0590,0,21,0,1,13,35
3337,1702,2022-10-12 18:32:00,a0fc33139c5bfc66257804a4e7c50bec,0,14,0,4,9,27
3338,1702,2022-10-12 18:38:00,21ca8c9318fbd108b32188036d12bace,1,20,0,3,7,31
3339,1702,2022-10-12 18:42:00,b8b11e9e9df1fc09021c49028276a9c3,0,11,1,1,14,27
3340,1702,2022-10-12 18:47:00,be8e68aa34ca8f11487e7be26aae6d17,2,16,0,4,13,35
3341,1702,2022-10-12 18:52:00,d107d77a6ad273c5384ce12366c1b3eb,0,18,1,1,12,32
3342,1702,2022-10-12 18:57:00,3a617a59c46192b79e2a441e3cbee221,0,15,0,2,9,26
3343,1702,2022-10-12 19:02:00,74480cdb63e608e922be5a1fcc5e2015,0,17,0,0,9,26
3344,1702,2022-10-12 19:09:00,1d9856842ac6fe5f21ce6b7d9b08db51,0,20,3,0,1,24
3345,1702,2022-10-12 19:11:00,8d0a0457aa1298974238bc6690e7d6e3,1,25,2,1,0,29
3346,1702,2022-10-12 19:18:00,d4c684f28159ada791419be03934c11e,0,20,1,0,1,22
3347,1702,2022-10-12 19:23:00,724f417fcbd3c472dcb8405336f50839,0,22,0,0,2,24
3348,1702,2022-10-12 19:27:00,eff083f52df3fbceb76e771d3964c187,0,21,0,1,2,24
3349,1702,2022-10-12 19:32:00,938498d4783a0a988b9a4401bb2cee19,0,17,3,1,1,22
3350,1702,2022-10-12 19:38:00,3ee7533fd9e66b3ae422d55b992c5ce7,0,15,6,3,2,26
3351,1702,2022-10-12 19:42:00,c190331b4e9e95a924e225f55d458908,0,18,1,2,0,21
3352,1702,2022-10-12 19:46:00,bb12c921a15fdc18116c84d36fceb0ca,0,17,1,0,1,19
3353,1702,2022-10-12 19:52:00,65abd172f985a2b8bfe0bad0769a502a,0,20,0,1,0,21
3354,1702,2022-10-12 19:58:00,feeb390503a3b52a32ae9d300caee30b,0,16,0,1,2,19
3355,1702,2022-10-12 20:03:00,871b21818da89aac90c1bf72346d0ffa,0,22,0,0,0,22
3356,1702,2022-10-12 20:07:00,b35ca491a8a5fdc9df547a851e781d63,0,26,0,1,0,27
3357,1702,2022-10-12 20:12:00,4258de2e1bf9991fa81f21314e02303f,1,20,0,0,0,21
3358,1702,2022-10-12 20:17:00,821e0996edb2ac1950f455faa35b4cef,0,18,2,0,0,20
3359,1702,2022-10-12 20:23:00,aa37178f3f69fcc64adaa8ea63986383,0,13,0,0,1,14
3360,1702,2022-10-12 20:28:00,8bdf5f2718f11632b8b2a1fc51f508df,0,18,0,1,0,19
3361,1702,2022-10-12 20:31:00,8fbde6954a1310024cea08fbbbee33bb,0,18,0,0,0,18
3362,1702,2022-10-12 20:37:00,0ec53544aaf307487b450501e95f1f19,1,16,3,1,0,21
3363,1702,2022-10-12 20:42:00,8c472cab8c727023f16cde0b584b772f,0,14,0,1,0,15
3364,1702,2022-10-12 20:47:00,df3211d3b6f367fe6d117a55fd409651,0,19,0,0,1,20
3365,1702,2022-10-12 20:52:00,4fa8ad319108a8b55f4365c417620ac9,0,21,0,0,1,22
3366,1702,2022-10-12 20:57:00,b4a81157f1298cdcfa889332698fed1f,0,17,0,0,0,17
3367,1702,2022-10-12 21:03:00,f94220154329e1adcaaa16df7eae02eb,0,13,0,1,0,14
3368,1702,2022-10-12 21:07:00,4ad956c42fcddf9e15e3f86555fb50bb,0,20,0,0,1,21
3369,1702,2022-10-12 21:11:00,7974f6dddf2915b1e233626dbaa225c0,0,15,2,0,2,19
3370,1702,2022-10-12 21:18:00,05108c8b899e40bcf8411035cea13bb9,0,18,0,0,0,18
3371,1702,2022-10-12 21:23:00,8decaa56c87104ac7595a340d8d0313d,0,28,0,1,1,30
3372,1702,2022-10-12 21:27:00,910c18d83503a8ef5b5e1f139bd0fca9,0,11,0,0,1,12
3373,1702,2022-10-12 21:32:00,c5aa65b41de0e928473f6915121e4a60,0,21,0,0,0,21
3374,1702,2022-10-12 21:37:00,dfbea3b1e0b14bc121500a229ecd4d3a,0,10,0,0,1,11
3375,1702,2022-10-12 21:41:00,fd0ddcb155a3b4489341fb1f79dbc7ac,0,20,0,1,0,21
3376,1702,2022-10-12 21:47:00,68640a0c9fe6d0eb1a1516786330500b,0,18,1,2,1,22
3377,1702,2022-10-12 21:52:00,2d8064f5742d2f26e53b0d08dc3a7932,0,23,0,1,0,24
3378,1702,2022-10-12 21:56:00,d19c6f633eb3c083f476db06d7cf14f0,0,14,1,2,2,19
3379,1702,2022-10-12 22:02:00,b423d3056a1fd351c7dd28e194b2516c,0,21,0,0,0,21
3380,1702,2022-10-12 22:06:00,edea3db37a545609ba9e2c32c5fb69e4,0,19,0,2,0,21
3381,1702,2022-10-12 22:12:00,cae603fce66bcecf437a8b051db0ccec,0,10,0,0,1,11
3382,1702,2022-10-12 22:17:00,d485d87cca3e24e5884372955b13a631,0,15,1,1,1,18
3383,1702,2022-10-12 22:22:00,da8c3374e2885a2f80bf07716cc59d89,0,15,0,0,1,16
3384,1702,2022-10-12 22:27:00,033fea00aa3e45e14a2c759e04cccf2c,0,15,2,0,0,17
3385,1702,2022-10-12 22:32:00,7719b08874dd24c8d9a058a52bdcb84e,0,11,1,0,1,13
3386,1702,2022-10-12 22:37:00,0e3f549167a8979476c573e78687fb53,0,16,2,0,1,19
3387,1702,2022-10-12 22:42:00,1007aac2cb78e2a3c2cd7404b3b3a770,0,21,0,1,0,22
3388,1702,2022-10-12 22:48:00,3d8e80c820489c6cce7a16a73786402e,0,15,0,1,1,17
3389,1702,2022-10-12 22:52:00,3b7b32a72ab7fecb6dcf41087d541ab0,0,11,0,0,1,12
3390,1702,2022-10-12 22:58:00,4c2ae28bd27513a1e9aff571f2ed07a1,0,14,0,1,1,16
3391,1702,2022-10-12 23:03:00,8c4c7fd5c9f9e1bbe039e88eb1e5acb3,0,14,0,1,1,16
3392,1702,2022-10-12 23:07:00,5e0f5ac1e5b7995421a9cc4db30be389,0,15,0,0,0,15
3393,1702,2022-10-12 23:12:00,92bbab846f64a13f0ab6a55be14b8a51,0,11,1,2,0,14
3394,1702,2022-10-12 23:17:00,3897f89c61dbf2516c7dc5b988674de5,0,4,0,0,0,4
3395,1702,2022-10-12 23:21:00,18f4b1519a61433f06858bce8432d6e6,0,8,0,2,0,10
3396,1702,2022-10-12 23:27:00,1670a9c10d6080c92dcd3f0480364e73,0,9,1,0,1,11
3397,1702,2022-10-12 23:33:00,fff6c2c19ffb74035c22e65a4675a6a3,0,12,0,0,0,12
3398,1702,2022-10-12 23:37:00,8dcc777452494183f695eff0fdf0ab1f,0,10,1,0,0,11
3399,1702,2022-10-12 23:41:00,c9f7b13bad6cf2a973581efce4c7775a,0,16,0,0,0,16
3400,1702,2022-10-12 23:47:00,8955b216ffff528724fd99a30c0cb24a,0,14,1,1,2,18
3401,1702,2022-10-12 23:51:00,4f2e8ed40d86873ff515396e76caa9de,0,10,0,1,1,12
3402,1702,2022-10-12 23:56:00,6988d5afc90068b6411fe798cbd5e407,0,8,2,0,0,10
3403,1702,2022-10-13 00:02:00,df840aa0c42bad778b2b91a22eba6c8e,0,4,2,0,0,6
3404,1702,2022-10-13 00:06:00,8e016f532e48f63568a3f376e59d587c,0,11,0,0,0,11
3405,1702,2022-10-13 00:11:00,f3d967a5a90be4e9ac31871f9b4961e9,0,6,0,0,0,6
3406,1702,2022-10-13 00:17:00,002836aa7dd215514f344e1c44f6672e,0,13,0,2,0,15
3407,1702,2022-10-13 00:21:00,606296aede447ae6a03bb2e583e63b33,0,8,0,0,0,8
3408,1702,2022-10-13 00:26:00,eda4c527efe990a22f87fe50e1ded7b3,0,3,0,0,0,3
3409,1702,2022-10-13 00:31:00,71663ad81558651a70317e6b5d9d2957,0,5,1,0,0,6
3410,1702,2022-10-13 00:37:00,bc9cdcdec58f64d76a3c6d878ecfed45,0,6,0,0,0,6
3411,1702,2022-10-13 00:41:00,b929368118247627ada742dadfdc389c,0,9,0,0,1,10
3412,1702,2022-10-13 00:47:00,e5aa6285b134eb8c973252e22773885e,0,10,0,0,1,11
3413,1702,2022-10-13 00:52:00,a3bc97eb1e69a70fee84e8e7769a84b7,0,11,0,0,0,11
3414,1702,2022-10-13 00:56:00,f6661488f7b12e0e5f0b8adfa3227af1,0,8,0,0,0,8
3415,1702,2022-10-13 01:01:00,e1ecdd7d32e032cf1dcdc2255890ceb6,0,8,0,1,2,11
3416,1702,2022-10-13 01:06:00,4a5cae461df7d86fc9de0e7c08a4fb9b,0,4,0,0,0,4
3417,1702,2022-10-13 01:11:00,c5e4c3c57a2e2512131a4ce96375cb4b,0,2,0,0,0,2
3418,1702,2022-10-13 01:17:00,2bd2c889d923490a149a2d71bba9f117,0,3,0,0,0,3
3419,1702,2022-10-13 01:21:00,65c093587fef2191450bbe413053f7c7,0,10,0,0,0,10
3420,1702,2022-10-13 01:27:00,82cce42d146eea4b0e5f6592b282f4e8,0,7,0,1,0,8
3421,1702,2022-10-13 01:32:00,66b1ad06c9a1762f2f2cbe6801bb649b,0,7,0,0,0,7
3422,1702,2022-10-13 01:36:00,06a5d189ff76dac33a83ed7dfb83623d,0,12,0,0,0,12
3423,1702,2022-10-13 01:41:00,a4a9bbaee7bc48e0e60909c796ba171f,0,9,0,0,0,9
3424,1702,2022-10-13 01:47:00,f51998b39aa9503a5aeaf08c7e222734,0,3,1,0,0,4
3425,1702,2022-10-13 01:52:00,84657b0ad60c38cff899a32d98ef6094,0,6,0,0,0,6
3426,1702,2022-10-13 01:56:00,05bfdffc06532c4650d2b379df970052,0,3,0,0,0,3
3427,1702,2022-10-13 02:02:00,5fe5ca204bb92f98e791c87baf354278,0,13,0,1,0,14
3428,1702,2022-10-13 02:06:00,b0dce72f17a799ccdd0218ad7c28effe,0,13,0,0,0,13
3429,1702,2022-10-13 02:11:00,dcad7c6043152628cd962154b4bb3e05,0,8,0,0,1,9
3430,1702,2022-10-13 02:16:00,9ca705e219b550a77e15360d84b21cd4,0,5,0,0,0,5
3431,1702,2022-10-13 02:21:00,0edbc5c39e208c298446cf95b5701cf9,0,3,0,0,1,4
3432,1702,2022-10-13 02:26:00,948e14221654b2a3463808e4e5107a34,0,8,0,0,1,9
3433,1702,2022-10-13 02:31:00,94e7f598a0772a79521abd91fe72a803,0,8,1,0,1,10
3434,1702,2022-10-13 02:37:00,dac8f2e21c4ebac8c7dfc24bf72a7847,0,6,0,0,0,6
3435,1702,2022-10-13 02:41:00,ff13ae8c0d7fad98e20b887e9ae3c07a,0,5,0,0,0,5
3436,1702,2022-10-13 02:47:00,b31733327caae91f099ea162c19875ad,0,6,0,1,0,7
3437,1702,2022-10-13 02:52:00,2dce68a1a61494ee844f9b2a4b2e50fb,0,9,1,0,0,10
3438,1702,2022-10-13 02:56:00,ce1be9ff19adb952b0a94b74128850b4,0,8,0,0,0,8
3439,1702,2022-10-13 03:02:00,02a1e96d658278c91c2ccb5468080105,0,5,1,0,0,6
3440,1702,2022-10-13 03:07:00,a7f0e2345393ad1a12257cf76715b0be,0,4,0,0,0,4
3441,1702,2022-10-13 03:12:00,c84caccde395fecf13199c2bde31130a,0,8,0,0,0,8
3442,1702,2022-10-13 03:16:00,940eb029cf56bff7765d0d886cc0ebf6,0,11,0,0,0,11
3443,1702,2022-10-13 03:21:00,4f14678871ac0f3b61b93bd8bcfb8df2,0,8,0,0,1,9
3444,1702,2022-10-13 03:26:00,c7bb5d6caf7d5f2ef34bc7eb6893cd05,0,3,0,1,2,6
3445,1702,2022-10-13 03:32:00,e7d43d9a9d7607e4f72a6178941ba45a,0,10,0,0,0,10
3446,1702,2022-10-13 03:37:00,1e7edb61f35fb8e3a055348614a04e74,0,8,0,0,0,8
3447,1702,2022-10-13 03:41:00,7d129f86a9c05724537652a3b6d12157,0,7,0,0,0,7
3448,1702,2022-10-13 03:47:00,e22b4e89f5d6a55f27cbb88f5ee88f32,0,1,0,0,0,1
3449,1702,2022-10-13 03:51:00,118ecd25833ad1377a24e7ee015d88d8,0,11,0,2,0,13
3450,1702,2022-10-13 03:57:00,856b2522ffbacb0cf1abb5c8bbea3800,0,3,0,0,0,3
3451,1702,2022-10-13 04:02:00,39a3be3ffc6a89e27e1aba6c0c152669,0,6,0,0,0,6
3452,1702,2022-10-13 04:06:00,eaee47eb5d898ee6b556d0323f9975b2,0,3,0,0,0,3
3453,1702,2022-10-13 04:11:00,706065d46110029e664bcc37d6be5e96,0,5,0,0,0,5
3454,1702,2022-10-13 04:16:00,b805cddab6aeda290982571b0e3dea07,0,6,0,0,0,6
3455,1702,2022-10-13 04:22:00,c76ad07a0eae8f9236406a7fcb0db0b5,0,2,0,0,0,2
3456,1702,2022-10-13 04:26:00,9a17eaa007943af340ede148d1028703,0,1,0,0,0,1
3457,1702,2022-10-13 04:32:00,0a9e3a06de0d57b507b6156893f810d7,0,1,0,1,0,2
3458,1702,2022-10-13 04:37:00,a62d43adc0e7ecb04738987c90d3f802,0,13,0,0,1,14
3459,1702,2022-10-13 04:41:00,bf0ae603ddaf4538a64479fb95eb467b,0,12,0,0,1,13
3460,1702,2022-10-13 04:47:00,abd1367f3b440072957bda64a372a086,0,7,0,0,0,7
3461,1702,2022-10-13 04:52:00,3e49289e74153c9243077e7c357889bf,0,1,0,0,1,2
3462,1702,2022-10-13 04:57:00,c91ff3927adf55729ac5921522709def,0,6,0,0,0,6
3463,1702,2022-10-13 05:02:00,5201efdb70d3179c9c4bd232556b1e86,0,9,0,0,0,9
3464,1702,2022-10-13 05:06:00,8c47475b3605f486671b205de63ad187,0,8,0,0,0,8
3465,1702,2022-10-13 05:12:00,d6d687ed8fbb0f1024cc3a8e2efde230,0,8,0,0,1,9
3466,1702,2022-10-13 05:17:00,a5e41dd76a477f253cfe978691b4f5dc,0,6,0,0,1,7
3467,1702,2022-10-13 05:22:00,2c5f94fbe48a79d309d71a4e88cbcceb,0,2,0,0,0,2
3468,1702,2022-10-13 05:26:00,558edc253e306bcafb4999f25e497b51,0,4,0,0,0,4
3469,1702,2022-10-13 05:32:00,a23915946b098445480bb3ec60cc8d12,0,3,0,1,0,4
3470,1702,2022-10-13 05:37:00,484c4580b13851619d18ac271ff37e17,0,3,0,0,0,3
3471,1702,2022-10-13 05:41:00,f479c354c2039d48ae18574993f59dd7,0,8,1,3,1,13
3472,1702,2022-10-13 05:47:00,75bcff6e0f4c9fccf320bb631403dc24,0,3,0,2,0,5
3473,1702,2022-10-13 05:52:00,14cd1285d3a7a70928af247d4886d735,0,7,0,0,0,7
3474,1702,2022-10-13 05:57:00,687faf735da5653ba14b9b5ac617346e,0,1,0,0,0,1
3475,1702,2022-10-13 06:02:00,7cb2d04e9857f87faad0fddbc1f0b59c,0,3,0,1,1,5
3476,1702,2022-10-13 06:05:00,e2846c83cdda3b1b1caa52a6ee17b4a4,0,11,0,0,0,11
3477,1702,2022-10-13 06:11:00,bec34d835f02e24d4e4b405b77843e77,0,8,0,3,2,13
3478,1702,2022-10-13 06:17:00,96ec795ad3499413192852af5aa9b6e8,0,4,0,0,0,4
3479,1702,2022-10-13 06:23:00,dfe906df651dc207fea8d57556e77e02,0,8,0,0,0,8
3480,1702,2022-10-13 06:26:00,6add764e8fb1df423d6f6b3a2ccf727b,0,6,0,0,1,7
3481,1702,2022-10-13 06:33:00,a0f1872f4476024b1399cf695d266ce4,0,11,1,1,1,14
3482,1702,2022-10-13 06:38:00,7a64d1b0564da53c3fce8254c25f9b39,0,9,0,1,1,11
3483,1702,2022-10-13 06:42:00,8f10a636b2591bad0143bf24d1fb4251,0,17,0,1,4,22
3484,1702,2022-10-13 06:48:00,9e4f8ee24f9ce4994e25b534fbf04f57,1,18,0,3,0,22
3485,1702,2022-10-13 06:52:00,c0de92cc571dcfe7429a36053f547b2d,0,20,0,2,5,27
3486,1702,2022-10-13 06:56:00,a7b4ce68c8f3b5a194fd98faafbed68c,0,22,1,0,4,27
3487,1702,2022-10-13 07:02:00,98d347041731806081bd7013f8ec71cc,2,10,0,6,10,28
3488,1702,2022-10-13 07:07:00,60435055a7927f9b103a0072276f80bd,1,14,1,3,8,27
3489,1702,2022-10-13 07:12:00,2f32b6dadf121c1e46403ae8d76cf046,0,18,1,1,8,28
3490,1702,2022-10-13 07:18:00,fb2a45cb5ba02806a9b14de26a14fea8,0,12,0,4,8,24
3491,1702,2022-10-13 07:22:00,c4cf39f099420aa0c2d80e576fb5fe07,0,19,0,3,8,30
3492,1702,2022-10-13 07:28:00,bb5dc7ccee9f4bc7ae3d30f5e3b43752,0,18,0,3,9,30
3493,1702,2022-10-13 07:32:00,551c504a0b66b78a26b07fbea3478378,0,25,2,2,4,33
3494,1702,2022-10-13 07:38:00,85747e9b857ee244ae4e2670ad8c07d6,0,10,0,3,11,24
3495,1702,2022-10-13 07:43:00,37ec9078afe53b689bf2336075518bc3,0,15,0,0,5,20
3496,1702,2022-10-13 07:47:00,b0ebfdc082fe31b94e689bbf3f496c7f,0,14,1,2,6,23
3497,1702,2022-10-13 07:53:00,6c252179d6888a57bd3e6511ca3df468,1,11,1,0,9,22
3498,1702,2022-10-13 07:57:00,ed6273a96b32bda27d4baa480a448e60,0,15,0,1,7,23
3499,1702,2022-10-13 08:02:00,ae27243fce3a7a806dc9ea8fd9ecbf0a,3,14,2,5,6,30
3500,1702,2022-10-13 08:08:00,cbab69194928bbdc39efbddc21c626a3,0,13,0,3,4,20
3501,1702,2022-10-13 08:13:00,a7a3a9167e6ee124fe1b0afc53a7b48f,0,10,0,0,13,23
3502,1702,2022-10-13 08:17:00,1574d2ddfea8f632c792be544baec10a,0,14,0,0,10,24
3503,1702,2022-10-13 08:22:00,6ec12daa839fbb3f57ecd910b284d080,0,18,0,0,6,24
3504,1702,2022-10-13 08:28:00,2f2ca65924a9dc02b0759c84e2217bff,1,14,0,5,12,32
3505,1702,2022-10-13 08:32:00,5e89ea44da4234ed76ee09d07f7304a6,0,14,0,3,9,26
3506,1702,2022-10-13 08:38:00,84f044cc419e32a6a488f0277c086a01,0,10,0,2,15,27
3507,1702,2022-10-13 08:42:00,4ed9c276d2d65489e61dc11a9e182c87,0,8,0,4,11,23
3508,1702,2022-10-13 08:48:00,4dddeaa14e71d9b4b1711acaa2e4ff6a,0,14,0,2,9,25
3509,1702,2022-10-13 08:53:00,a46469014cc824f0f856ffba7cdd3799,0,17,0,0,5,22
3510,1702,2022-10-13 08:57:00,e109a6fc8e046fd87abbe6ef61ae01f1,0,13,0,1,9,23
3511,1702,2022-10-13 09:02:00,151362325d77ded96b0dbe526c19413c,1,15,0,2,3,21
3512,1702,2022-10-13 09:08:00,634c338289038f4559d716713d2a706b,0,13,0,1,4,18
3513,1702,2022-10-13 09:12:00,18d8657ecdd3d6b0bebac6ad9fd82021,1,15,0,1,2,19
3514,1702,2022-10-13 09:17:00,d1390c75478c58b63a74b583c30d111c,0,8,0,2,10,20
3515,1702,2022-10-13 09:22:00,396a4eb97aaf469b4006ec8ff9c8c8df,0,13,0,0,3,16
3516,1702,2022-10-13 09:27:00,632341ed2a5bf9dc42b916a4995ccd88,1,11,0,1,9,22
3517,1702,2022-10-13 09:32:00,e0c3d35db1ca8b96349cb0d117f7772b,1,12,0,0,9,22
3518,1702,2022-10-13 09:38:00,3352553d5ce22c63d4d91310c409ab33,0,14,0,1,11,26
3519,1702,2022-10-13 09:43:00,7881114dac740071ae5399654e8e0aa2,1,7,0,2,9,19
3520,1702,2022-10-13 09:48:00,34086fab1cab7ffc6cd5671da6f90052,0,12,0,2,3,17
3521,1702,2022-10-13 09:53:00,429ff4a95e3b8068cd36c613d600ee63,0,12,0,1,8,21
3522,1702,2022-10-13 09:58:00,43b08f318a33faf77319775f809d7d1a,0,14,1,0,15,30
3523,1702,2022-10-13 10:02:00,553e8b95f15641367d15ede7fd1f7594,1,11,0,1,7,20
3524,1702,2022-10-13 10:09:00,d7111f1307aa5a716f71bae206f99e51,0,9,0,2,12,23
3525,1702,2022-10-13 10:12:00,b22406791ae338213df1c3a0b1378dd1,0,17,0,0,10,27
3526,1702,2022-10-13 10:18:00,9a82eef7207776aaf31919e0ded7ac13,0,14,0,4,10,28
3527,1702,2022-10-13 10:23:00,72e0fda0e66dcacb4c5e0f40dcfc4172,0,18,0,3,8,29
3528,1702,2022-10-13 10:28:00,225572d48ef83eee5f17fbd62681f8c2,0,14,0,2,8,24
3529,1702,2022-10-13 10:34:00,8cee04f57360ac6514468286dd707a89,0,21,0,2,7,30
3530,1702,2022-10-13 10:43:00,862d6cbb5f9f2d4d428b9ae4c51e8d6c,0,15,0,1,11,27
3531,1702,2022-10-13 10:49:00,65219c5001028afc2503084a0f2656c2,0,9,0,3,13,25
3532,1702,2022-10-13 10:52:00,4d7fa71985b0c6042cecc2cc3debd2a1,0,14,0,5,7,26
3533,1702,2022-10-13 10:58:00,b560818f499b9bb5d9890590d7ab51f6,0,15,0,5,3,23
3534,1702,2022-10-13 11:03:00,e3145666af14477d2c76bb1050ef7807,0,13,0,5,8,26
3535,1702,2022-10-13 11:09:00,e786e1e3d510887f258077e6075fcfb1,0,10,0,2,9,21
3536,1702,2022-10-13 11:13:00,a2943148c785f52b2ac4a3e1cd476a11,0,16,0,1,14,31
3537,1702,2022-10-13 11:19:00,64c6b589786025189946e7073f62b348,2,8,0,6,9,25
3538,1702,2022-10-13 11:23:00,f78fa1a6620ccca7c57cc5da079a33e9,0,15,0,1,9,25
3539,1702,2022-10-13 11:28:00,f58af5c6b3185c199acbe31b2501b6bc,0,16,0,2,9,27
3540,1702,2022-10-13 11:32:00,74830518a0d53a8f926e9b3e39b8bd69,1,17,0,3,8,29
3541,1702,2022-10-13 11:38:00,d284131e63c868f2a0a7be728b58c538,0,19,0,2,7,28
3542,1702,2022-10-13 11:41:00,3851004d968db6ca27e4c858bf4da4e5,0,18,1,2,4,25
3543,1702,2022-10-13 11:48:00,d203a8dc44e12d45881acdf32d5f1477,0,12,0,5,3,20
3544,1702,2022-10-13 11:53:00,beef593e7bb540c24b92a92fd680aed7,0,17,0,3,7,27
3545,1702,2022-10-13 11:57:00,138366e5c3710981a375d778a196bcac,0,13,0,2,5,20
3546,1702,2022-10-13 12:04:00,4f935b5082ebc304a9371c452cf65612,0,17,0,1,9,27
3547,1702,2022-10-13 12:08:00,c2129ee9ba57db0311ec140952a07f0e,0,15,0,2,6,23
3548,1702,2022-10-13 12:12:00,16fdfcf2cd620e9fd8b416355ec3e340,0,16,1,3,5,25
3549,1702,2022-10-13 12:18:00,1fbf4b23ec9f1b05dec4ff4947d6aa24,0,12,0,2,7,21
3550,1702,2022-10-13 12:23:00,fd7ef70d80faba1154be72fae14b62ae,0,15,0,3,3,21
3551,1702,2022-10-13 12:27:00,0dc0cab3664854402755bd66d1f99f0c,0,11,0,2,10,23
3552,1702,2022-10-13 12:32:00,6d3d3d49260c119f4f4180ec629cdd2d,0,16,0,1,11,28
3553,1702,2022-10-13 12:38:00,2b66bafcb5febbf19278f751083fc35e,0,20,0,2,2,24
3554,1702,2022-10-13 12:42:00,2ef7f335aa89dd15b233929a7a505342,0,17,0,4,3,24
3555,1702,2022-10-13 12:47:00,aee9059ae3dd481d11caae4c671285ed,0,11,1,2,7,21
3556,1702,2022-10-13 12:53:00,ca98f1802ebfffeca126fff857f8a704,0,15,0,2,3,20
3557,1702,2022-10-13 12:57:00,582778ad838947ae341b796416325185,0,14,2,2,2,20
3558,1702,2022-10-13 13:02:00,9775ea61338ba6542687415e2db8fcdd,0,21,0,2,3,26
3559,1702,2022-10-13 13:08:00,bc56874f70fbd9a050ffeeaed3385dc4,0,10,0,2,8,20
3560,1702,2022-10-13 13:17:00,d41ef5b182d17da6407bf038cb2df3ed,0,17,0,4,2,23
3561,1702,2022-10-13 13:24:00,352b30d04daa045a0fb6b9e61c825d9a,0,16,0,0,2,18
3562,1702,2022-10-13 13:27:00,b5529aaea77f6739ef1a38e2a94f2cc7,0,16,0,3,6,25
3563,1702,2022-10-13 13:32:00,14c6db256fa5ef9a93eabd85fc02bb33,0,14,0,3,5,22
3564,1702,2022-10-13 13:37:00,310bb21a4bac7cc4f29c929dad0478b4,0,13,0,2,12,27
3565,1702,2022-10-13 13:43:00,b4f2f0ac0357d63083e8dce7e9057002,0,14,0,3,4,21
3566,1702,2022-10-13 13:49:00,7453ce4d82f87e2cb240440ca31bfcf1,0,9,0,2,17,28
3567,1702,2022-10-13 13:52:00,a178ac5bdd18ba39e07d65c5092c0212,0,13,0,0,10,23
3568,1702,2022-10-13 13:57:00,df94e978c0480906209844e9502b3322,0,12,0,2,10,24
3569,1702,2022-10-13 14:03:00,95bfab8e86f1ff957971d630526acd54,0,14,1,2,7,24
3570,1702,2022-10-13 14:08:00,319922d45d372f39121b2cf202047168,0,10,0,1,13,24
3571,1702,2022-10-13 14:12:00,4cdce4fedda097d5214a4e3a35c10fbe,1,13,0,3,10,27
3572,1702,2022-10-13 14:18:00,d45989b57dc2b27881d41a0f9c670c7b,0,13,0,0,8,21
3573,1702,2022-10-13 14:23:00,1c4989ab998ebd9d35dcfc65a23a9027,0,15,0,1,12,28
3574,1702,2022-10-13 14:26:00,201f53d77db074aa56571d7ea082f5f0,0,14,0,2,7,23
3575,1702,2022-10-13 14:33:00,61feaf7b6dc91925f1517fb64ab05e15,0,15,0,1,9,25
3576,1702,2022-10-13 14:38:00,f9ebbd5740eb7d80ad7bb42c4f3e8d55,1,14,0,4,8,27
3577,1702,2022-10-13 14:43:00,fb95ba05c68dbc2dc6993864a7f161aa,0,15,0,1,10,26
3578,1702,2022-10-13 14:48:00,e903c71f93cb94b48cb89c47e21c7d7b,0,13,1,7,15,36
3579,1702,2022-10-13 14:52:00,abb8301664a1bc1047e15ff93ee69497,1,20,0,4,9,34
3580,1702,2022-10-13 14:57:00,2201e08c30430a8ee36461856b3c408e,0,19,0,2,11,32
3581,1702,2022-10-13 15:03:00,7292f0fc047588f835b8075721be6d32,0,16,0,5,5,26
3582,1702,2022-10-13 15:08:00,35af49529c56b47df03d79512a6556a2,0,11,0,1,10,22
3583,1702,2022-10-13 15:13:00,28536ca24e99691e3823fd3dc295f127,0,8,2,1,13,24
3584,1702,2022-10-13 15:18:00,8527a0fc841b7a80870a94826cd27eaa,0,16,0,1,10,27
3585,1702,2022-10-13 15:23:00,005061902c037ce47e10f0ee98b70512,2,17,0,2,11,32
3586,1702,2022-10-13 15:27:00,5d5561284be6ab761caecb6682d816e9,2,15,1,2,10,30
3587,1702,2022-10-13 15:34:00,a144a35bd100ef31ea9d7cc5e1b2c2d5,0,16,0,6,12,34
3588,1702,2022-10-13 15:39:00,5ff6ab52563f25a1e8fae2b37474543d,0,14,1,1,9,25
3589,1702,2022-10-13 15:43:00,ce653c56007e68bf1090571c9ec2558f,0,13,0,2,16,31
3590,1702,2022-10-13 15:49:00,64c0f2cef1989cbccfcbbce72c83f4d9,0,10,0,7,13,30
3591,1702,2022-10-13 15:54:00,23fb1743860feb59fd35d8589c3715db,0,10,0,3,9,22
3592,1702,2022-10-13 15:58:00,07e10196c15110af8c1e5cd6053c4a55,1,9,0,0,12,22
3593,1702,2022-10-13 16:04:00,906ad64393f988644a79c635f4a82da8,0,8,0,0,14,22
3594,1702,2022-10-13 16:08:00,2b641e8029aab2357c5bcf151246e43b,0,12,0,1,5,18
3595,1702,2022-10-13 16:12:00,e5ef600d8dc6161bf9e6b8920757a8ee,0,12,0,2,5,19
3596,1702,2022-10-13 16:19:00,50197d2b54043b5dfccad7e3d912153c,0,15,0,0,14,29
3597,1702,2022-10-13 16:23:00,576f29853d69e9b25cc777f9c5f0e9d1,0,11,0,1,9,21
3598,1702,2022-10-13 16:28:00,dc0a53f03048e31f53af4c6918317dda,0,14,0,2,12,28
3599,1702,2022-10-13 16:34:00,d0c616815e2c045fdfc2fad24fc32c58,0,14,0,4,7,25
3600,1702,2022-10-13 16:38:00,9ad002909b1b244028cfe4e6864c3dc0,0,12,0,1,7,20
3601,1702,2022-10-13 16:43:00,81cbfc61615d81604a31a26736169c51,1,15,0,2,8,26
3602,1702,2022-10-13 16:48:00,0e403661b8907e8fefb4a5c2ac536107,0,12,0,1,11,24
3603,1702,2022-10-13 16:53:00,0962e3ee18b05e5b8b89d8e599995958,0,10,1,7,10,28
3604,1702,2022-10-13 16:58:00,b080e18c1e880227915926fc49aad01b,0,10,0,0,15,25
3605,1702,2022-10-13 17:03:00,a43524f5582e47e7e4ec8d3ad36fd66d,0,12,0,2,16,30
3606,1702,2022-10-13 17:09:00,f2f445bbc9163cca1e5ee9d6caa84a88,0,14,1,9,7,31
3607,1702,2022-10-13 17:13:00,25a8e0302ea07d4e1d18374e239544be,0,14,0,7,14,35
3608,1702,2022-10-13 17:18:00,98308943361dbfde159158d85f365f49,0,8,0,2,15,25
3609,1702,2022-10-13 17:22:00,b2bda5a1f5d7d286df2a3a39d77ffd1d,0,16,0,7,8,31
3610,1702,2022-10-13 17:29:00,65599f88ea2036657d2e6f0e493a7d75,1,12,0,3,9,25
3611,1702,2022-10-13 17:37:00,6eb364346699bedfab7940b35bda9393,0,19,0,3,10,32
3612,1702,2022-10-13 17:43:00,ca9837ac88657d2d6dc50254251e2496,0,19,0,3,12,34
3613,1702,2022-10-13 17:47:00,3a4aa01160d8736f3419a441a4899fa8,2,18,1,7,10,38
3614,1702,2022-10-13 17:53:00,759a4219b114a3cdd8393aa9be1da016,0,23,0,1,9,33
3615,1702,2022-10-13 17:59:00,306a9d710e28808d1709790dd9603862,0,27,0,3,8,38
3616,1702,2022-10-13 18:03:00,6a19ea2792d72863a00cffcfe80e3c35,1,16,2,0,9,28
3617,1702,2022-10-13 18:07:00,4dc2354a8e7de061940c3bed4b7452b6,0,20,0,1,6,27
3618,1702,2022-10-13 18:13:00,22292edf4c62f8a204db1d918e229630,0,21,1,1,9,32
3619,1702,2022-10-13 18:18:00,bd3c9a29b925f51bb398f64eb342798e,0,12,0,5,11,28
3620,1702,2022-10-13 18:22:00,83af508138c1c2b0cff37b7c582a6e52,0,16,0,4,9,29
3621,1702,2022-10-13 18:27:00,b2039d4aebb9e305b6c0efa906564815,2,18,1,4,12,37
3622,1702,2022-10-13 18:31:00,5b08faa54b4751ad6e0422cc26985f4a,0,15,0,1,12,28
3623,1702,2022-10-13 18:39:00,44271d013b8e183a30868024725783c6,0,15,0,3,13,31
3624,1702,2022-10-13 18:42:00,89075ce815b3d1fcf4d1046e796dfc88,1,14,0,5,7,27
3625,1702,2022-10-13 18:48:00,0bc50342e6dad7fea41464d6adc3587f,0,25,0,2,3,30
3626,1702,2022-10-13 18:52:00,faf08bd13ef44f1bbdfb97d3995b1ebc,0,22,1,1,4,28
3627,1702,2022-10-13 18:57:00,3560ff2bb767765a496136a8b3bce2ee,0,16,0,0,7,23
3628,1702,2022-10-13 19:02:00,a61c9aa98bb80ca1325ae14a1145f6f1,0,17,1,1,2,21
3629,1702,2022-10-13 19:07:00,d9be7c4bf372f85a73b75b8f081f361d,0,17,1,0,5,23
3630,1702,2022-10-13 19:12:00,2dd5f12272440650977debb42d75a17b,0,22,1,1,0,24
3631,1702,2022-10-13 19:17:00,1200ff985fbe11ba42a2355f3948d11c,2,20,2,0,1,25
3632,1702,2022-10-13 19:22:00,d11f76257e392ab1f021abe7338320a7,0,26,0,0,0,26
3633,1702,2022-10-13 19:27:00,9e817512130ae2e1b082e2e620f366a1,0,26,1,0,0,27
3634,1702,2022-10-13 19:32:00,8da6af934af680382a29d69cc119936e,0,14,1,0,3,18
3635,1702,2022-10-13 19:37:00,167b3b3b4870f0aecf1d021c3b8cbe63,0,22,0,0,0,22
3636,1702,2022-10-13 19:42:00,7fcb289053f7bd0f198cb925c17a0b78,0,23,0,0,1,24
3637,1702,2022-10-13 19:47:00,0f555257f6e31b4da5c0cfdfab6b9ea5,0,18,0,0,0,18
3638,1702,2022-10-13 19:52:00,a67e0012f063f61e88a09ce317699b7e,0,18,0,0,1,19
3639,1702,2022-10-13 19:57:00,c3813ac07792e1753b6c7d6d3443d7e7,1,16,1,1,3,22
3640,1702,2022-10-13 20:02:00,5d7ea07a07707ccd71c7be83a2d6aad0,0,19,0,0,1,20
3641,1702,2022-10-13 20:08:00,29a547a9e2cefec2eb8ed129dbc361c7,0,19,0,0,0,19
3642,1702,2022-10-13 20:12:00,f633d214aaaaeeefad4437fb210e5a8b,0,14,1,0,3,18
3643,1702,2022-10-13 20:17:00,331b17e7b8d454e1f34324f18a66643f,0,14,0,0,1,15
3644,1702,2022-10-13 20:22:00,b4487142cf3d50c0997c656591f4e47f,1,17,2,0,0,20
3645,1702,2022-10-13 20:27:00,3eeadfc1d296151c1543052a1f6990ad,0,17,0,0,1,18
3646,1702,2022-10-13 20:32:00,05c5fa70337d990d38d41932c550ad01,0,13,1,1,2,17
3647,1702,2022-10-13 20:36:00,e17239e8efd884f65c3eca3e38a4b73c,0,12,1,1,2,16
3648,1702,2022-10-13 20:42:00,04f3a3aa880c1bfa4515f4c0230d3c9f,0,28,0,0,0,28
3649,1702,2022-10-13 20:47:00,40ea65368a475be6ffd966e2497ee0ea,0,11,3,0,2,16
3650,1702,2022-10-13 20:53:00,a33f4228e46e42d4ccb07dcadf7d8e51,0,10,0,0,4,14
3651,1702,2022-10-13 20:57:00,833e14dc772f7bd6f46bd3df6e38b763,0,18,2,2,0,22
3652,1702,2022-10-13 21:02:00,e9ea015408faf54c515ef911b030cab8,0,23,1,0,0,24
3653,1702,2022-10-13 21:07:00,398bc754e091aba01b481abf0d1f2ed8,0,20,2,0,2,24
3654,1702,2022-10-13 21:12:00,81cb686ae427e2b2aa3617e545af87ab,0,18,2,0,0,20
3655,1702,2022-10-13 21:17:00,c9ac8cd072b7dfa5b94d13e957a1750d,0,17,0,0,2,19
3656,1702,2022-10-13 21:22:00,5db010371ad662dfebd1f384f1cc241b,1,23,1,0,2,27
3657,1702,2022-10-13 21:26:00,24a597fb3f7d9168a5ae57526d977a4b,0,18,0,0,2,20
3658,1702,2022-10-13 21:32:00,91fe1020d29e87f5590e88f94f7301c9,0,10,0,1,1,12
3659,1702,2022-10-13 21:37:00,a2e7571fbc47221e194b8f6145b5e2f0,0,19,0,1,2,22
3660,1702,2022-10-13 21:42:00,92d8da8ac98eef82f30c6cf49f91950e,0,22,1,0,3,26
3661,1702,2022-10-13 21:49:00,fddde8651e57f22f96d22752ee088eab,0,14,2,0,0,16
3662,1702,2022-10-13 21:52:00,7a9020811a7fc5334ad7a57f325bec25,0,3,0,1,1,5
3663,1702,2022-10-13 21:57:00,addc333d152e3404e0c0bbce220e36b3,0,13,0,0,0,13
3664,1702,2022-10-13 22:02:00,a757f95809ca689479c39b0d62a542b0,0,15,0,0,1,16
3665,1702,2022-10-13 22:08:00,6f862100354be4ba1fcf5167e7f7f343,1,17,0,0,0,18
3666,1702,2022-10-13 22:11:00,cb536fc7b92775612fd054e8b0c55bec,0,15,3,2,0,20
3667,1702,2022-10-13 22:17:00,4724342cbe37bdd3730f15b42ec54f68,0,19,0,0,0,19
3668,1702,2022-10-13 22:22:00,e0590794f05f5dc148316430098fc199,0,7,0,1,1,9
3669,1702,2022-10-13 22:27:00,2c24654a5337179f2e000d69f2aa0ce4,0,14,0,1,1,16
3670,1702,2022-10-13 22:32:00,d86f0f01046ed043847752b7fce30c0c,0,16,2,0,1,19
3671,1702,2022-10-13 22:37:00,00ef0783a60841e619e40972a1606d22,0,10,2,0,1,13
3672,1702,2022-10-13 22:42:00,2c12599ec179d983e811320d47cd39fa,0,13,0,0,0,13
3673,1702,2022-10-13 22:48:00,666bbfc660790f1100a0f71334ad073e,0,17,0,0,2,19
3674,1702,2022-10-13 22:53:00,e262b8e5214d90b8d2a736902ad021cc,0,11,0,0,0,11
3675,1702,2022-10-13 22:57:00,9ecf75f92c3fd3ee2d128881a2ebf0a7,0,17,1,0,0,18
3676,1702,2022-10-13 23:03:00,98044da5b62d69b28e515fe4aae577b3,1,8,1,0,0,10
3677,1702,2022-10-13 23:08:00,ec139ee6e1e9444d20abe121d77ec049,0,16,4,0,0,20
3678,1702,2022-10-13 23:12:00,dd2bc7efeed4c35a0f6a1234e034bdfd,0,9,2,0,0,11
3679,1702,2022-10-13 23:18:00,974a0315f3443acd30eae207ba3c4479,0,14,0,0,1,15
3680,1702,2022-10-13 23:22:00,3a921c1feb12979e47cb031acf2eeb01,0,22,0,0,1,23
3681,1702,2022-10-13 23:27:00,f30331b20337df09eb6f8572ec30edd2,0,11,0,0,0,11
3682,1702,2022-10-13 23:32:00,6ff2ff5720ef080fad6d35129d441a8c,0,14,0,0,0,14
3683,1702,2022-10-13 23:37:00,6a575a3d91cd29724250082e68121ff2,0,13,0,0,0,13
3684,1702,2022-10-13 23:43:00,d2e18b1ef755aa43c7760ad8d9bbf088,0,9,1,0,2,12
3685,1702,2022-10-13 23:47:00,c92e5a44f73ddd735748d8daf22921e8,0,11,1,0,0,12
3686,1702,2022-10-13 23:52:00,9ce0e5dce7c2a0007766d32f8af4def9,0,9,1,0,1,11
3687,1702,2022-10-13 23:58:00,848bab200c744d2e946cc9736ab17b1f,0,7,0,0,1,8
3688,1702,2022-10-14 00:02:00,f7ffe48dd204aa557015cdc0ad6418b0,0,9,0,0,1,10
3689,1702,2022-10-14 00:08:00,e1c4588bb59a23d3095ef1c23b90f0df,0,8,0,1,1,10
3690,1702,2022-10-14 00:12:00,5ffe8dcdec8e16606f2a84b29886ceeb,0,8,0,1,0,9
3691,1702,2022-10-14 00:17:00,c5c604533b9ef565652122bc992d7052,0,14,0,0,0,14
3692,1702,2022-10-14 00:22:00,bebb22661a9034147ce0946e92a8415a,0,2,1,1,1,5
3693,1702,2022-10-14 00:27:00,55ebbd43cbaf04830479559b980b73f6,0,10,0,2,0,12
3694,1702,2022-10-14 00:32:00,ef223bf4700b292f0f3e3de4b9ed4eb0,0,12,0,0,0,12
3695,1702,2022-10-14 00:37:00,01341ee21d81842942a18a97f3a75421,0,7,1,0,2,10
3696,1702,2022-10-14 00:42:00,aabcce90f39cbff221f399bc5d087ea5,0,10,0,0,0,10
3697,1702,2022-10-14 00:48:00,95a0d1d14e5e407a67de4514239a72ef,0,6,2,1,0,9
3698,1702,2022-10-14 00:52:00,70b85335b58057d902d96dbdd6cfb5d9,0,5,0,0,1,6
3699,1702,2022-10-14 00:57:00,9756b13159021b4efe876d9ca4e6ab40,0,13,0,0,1,14
3700,1702,2022-10-14 01:03:00,07a4f1c5741db6cc7611454aea364271,0,12,0,0,1,13
3701,1702,2022-10-14 01:08:00,df932c0f9104afa0e7c735e1131c1d59,0,10,0,1,1,12
3702,1702,2022-10-14 01:12:00,2e2cf108ceed0cd472b3321e03cf674e,0,2,0,0,1,3
3703,1702,2022-10-14 01:17:00,11e3c42319adc5626fb7630cce63d1be,0,9,0,0,0,9
3704,1702,2022-10-14 01:22:00,b757c0273106a4765fcee07b76897a38,0,5,0,0,0,5
3705,1702,2022-10-14 01:27:00,5f0d22ea9484c7f2137aab06793aa6bd,0,8,0,0,0,8
3706,1702,2022-10-14 01:31:00,b953a78c233bff221da7783fc02b75c0,0,7,0,0,0,7
3707,1702,2022-10-14 01:37:00,71ff128a69c2fd42bc5c636120454c07,0,5,1,0,2,8
3708,1702,2022-10-14 01:42:00,5ecbf76e042cb2a529d33fd7d2d5b2c5,0,5,2,0,0,7
3709,1702,2022-10-14 01:47:00,238c8ba46d5985c6ebe0b21f86491ae4,0,7,0,0,0,7
3710,1702,2022-10-14 01:52:00,e11e8bf7f5f6c60fe9c381b74f469f67,0,10,0,1,1,12
3711,1702,2022-10-14 01:57:00,e662081f180464129c7701d3f37a6369,0,15,0,0,1,16
3712,1702,2022-10-14 02:02:00,4135478d21fba8f31bdac4652caf99f5,0,5,0,0,0,5
3713,1702,2022-10-14 02:08:00,7596224ddae179b6407c26df99e60bd8,0,5,0,0,0,5
3714,1702,2022-10-14 02:11:00,5374f61e1695ed740ce39390fb2bb3a8,0,6,0,1,3,10
3715,1702,2022-10-14 02:18:00,472fb5fbedd9a3fdc437a0d961e29dd3,0,12,1,0,0,13
3716,1702,2022-10-14 02:22:00,2f173c470879f421ecf49701033b5518,0,1,1,0,0,2
3717,1702,2022-10-14 02:26:00,8626f67cfe1c3b8e8c897831890b5948,0,5,0,0,1,6
3718,1702,2022-10-14 02:31:00,f7923efd5a014260e7900b5269f6b221,0,1,0,0,0,1
3719,1702,2022-10-14 02:36:00,044ec00dbdb4683c8e205a9bc4ba72f7,0,5,0,0,1,6
3720,1702,2022-10-14 02:42:00,ccb8652ec76b1165cc673c81d9192693,0,3,1,0,0,4
3721,1702,2022-10-14 02:47:00,7fa1e40f13d792685fdc260a1f407db8,0,4,2,0,0,6
3722,1702,2022-10-14 02:53:00,147c7551c0b5e67a54192be331ffc44f,0,6,0,0,1,7
3723,1702,2022-10-14 02:57:00,10361466c52b0cf5e732b41797a76fbb,0,7,0,0,0,7
3724,1702,2022-10-14 03:02:00,01d0b6380e028e6f7bde5f74ba2495bf,0,9,1,0,0,10
3725,1702,2022-10-14 03:08:00,d323dfb4a8cbcec39e4b4d3d91105433,0,7,0,0,0,7
3726,1702,2022-10-14 03:11:00,e45b6b5cf226ec53ec900c21224eb7a8,0,4,0,0,0,4
3727,1702,2022-10-14 03:17:00,018cfdaec7ebf0dfbbf9b76ecf0649e8,0,10,0,0,0,10
3728,1702,2022-10-14 03:21:00,6627faa1b5650f6d4bccd7bd7e625245,0,0,1,0,3,4
3729,1702,2022-10-14 03:26:00,e9c8e3a414e389ace12245129039f5f2,0,2,0,0,0,2
3730,1702,2022-10-14 03:31:00,afb403ea030807990d13374351eb0674,0,7,1,1,0,9
3731,1702,2022-10-14 03:37:00,28d8cbf9e789ab2c22599c5e51db9cb3,0,5,0,0,0,5
3732,1702,2022-10-14 03:41:00,20a14b5a884f89f85b622e4e05cc82aa,0,6,0,0,0,6
3733,1702,2022-10-14 03:46:00,0473c6834ce87aa9605cb6249e46ca2a,0,9,0,0,0,9
3734,1702,2022-10-14 03:52:00,e9718526f6cfae28298dee39f76df3ef,0,6,0,0,0,6
3735,1702,2022-10-14 03:57:00,0075f2b40e45715a1b70518c8cec1339,0,2,0,0,0,2
3736,1702,2022-10-14 04:01:00,067209258e3772b892b985f064eedb81,0,4,0,0,0,4
3737,1702,2022-10-14 04:06:00,b47201cafcaf48c1704a0920981e2460,0,11,0,0,1,12
3738,1702,2022-10-14 04:11:00,a085838d291e6e0d95735e5750c1270c,0,10,0,1,1,12
3739,1702,2022-10-14 04:16:00,6e55331d2eece8af02fe4e768664c054,0,6,1,1,0,8
3740,1702,2022-10-14 04:22:00,dc4e280a20f09183e66eb82402f909c7,0,7,0,0,0,7
3741,1702,2022-10-14 04:26:00,24b866b6c548a2b4024b2dac15634c04,0,8,0,1,0,9
3742,1702,2022-10-14 04:31:00,1e8207a5624e895a6e9ebb6dd4641e56,0,5,0,0,0,5
3743,1702,2022-10-14 04:37:00,aa2799607fce8ca72e50028d7da75db9,0,8,1,0,0,9
3744,1702,2022-10-14 04:41:00,7e0dba3786ebbf0bcc7a67fad1b051fe,0,9,0,0,1,10
3745,1702,2022-10-14 04:46:00,0ae2b7241ec57cb638daccd114ab43a0,0,5,0,0,0,5
3746,1702,2022-10-14 04:52:00,8a35a83379c6f877ef62a3d22c03d4d2,0,3,0,0,0,3
3747,1702,2022-10-14 04:56:00,2fd01bb82aab1901ecdb1eb5c784c70c,0,8,0,0,0,8
3748,1702,2022-10-14 05:02:00,7349584febea0be23483c9c32e9b2933,0,3,0,0,0,3
3749,1702,2022-10-14 05:07:00,0a7517e4f9bd255beb635b1c4811626c,0,6,0,0,0,6
3750,1702,2022-10-14 05:11:00,dc1be29a21158869ab2f36d7d13810d4,0,4,0,1,0,5
3751,1702,2022-10-14 05:18:00,3185298cf3c640f373657e09793f8224,0,5,0,0,0,5
3752,1702,2022-10-14 05:21:00,a035caaf1c3ca1c366b0c122ca3284cf,0,4,0,1,1,6
3753,1702,2022-10-14 05:26:00,28b17fab0be5be19a8281b6e0655520f,0,3,0,0,1,4
3754,1702,2022-10-14 05:31:00,594abeb6635c6a8df67862994abcad57,0,2,1,1,0,4
3755,1702,2022-10-14 05:36:00,e96c907d8ca58e9c4fbf6260bb6d60ba,0,1,0,1,0,2
3756,1702,2022-10-14 05:41:00,882aca91b846d320672522a66b76f8fc,0,5,0,0,0,5
3757,1702,2022-10-14 05:47:00,09b9d33a1b970815c2c7b50b120a127a,0,12,0,0,2,14
3758,1702,2022-10-14 05:52:00,de75e67ff43e358db8c4883993bf6029,0,6,0,1,2,9
3759,1702,2022-10-14 05:57:00,185eb04854767686cc606758c535a5ee,0,8,0,0,0,8
3760,1702,2022-10-14 06:02:00,191dd60819b1c035d0f7b899e7f5ae39,0,5,0,0,1,6
3761,1702,2022-10-14 06:07:00,96ab55bf6919da36064723ab52d0705a,0,7,1,0,0,8
3762,1702,2022-10-14 06:11:00,71c3730d3bd8120edc21f9ab48d086dc,0,8,0,0,0,8
3763,1702,2022-10-14 06:16:00,9d9c0e08ba752703f31ef2ef8fdec492,0,4,0,1,0,5
3764,1702,2022-10-14 06:22:00,5af238e3a5b0e9e085368df256a5cdd0,0,8,0,1,0,9
3765,1702,2022-10-14 06:26:00,834ba3585bd201f009662e4cfbe648f2,0,14,0,0,0,14
3766,1702,2022-10-14 06:32:00,22298a69fc0af8e580e2d480f0f5944e,0,13,0,0,1,14
3767,1702,2022-10-14 06:37:00,b332a520bb7c710f0870333ce721221b,0,16,1,1,3,21
3768,1702,2022-10-14 06:41:00,3b8c0086aa3676de352ba418f54e597c,0,14,1,2,1,18
3769,1702,2022-10-14 06:47:00,7a2ffa21717ff20defc04cc0c8279816,0,19,1,1,4,25
3770,1702,2022-10-14 06:52:00,0dc1d3bd73afbdd7dac9bf52da3be8f0,0,10,0,2,3,15
3771,1702,2022-10-14 06:56:00,17a54af7e7f1e05a941433832a0853ae,0,17,0,1,4,22
3772,1702,2022-10-14 07:02:00,0db90d132f9b3bc553f7cce380a7d2a2,0,16,0,0,7,23
3773,1702,2022-10-14 07:07:00,9b8752a959538c89245d0a74b708e086,0,16,0,0,8,24
3774,1702,2022-10-14 07:12:00,0bf49cdaff0b21c141b6264283b04b50,1,14,1,1,6,23
3775,1702,2022-10-14 07:17:00,c448115ad6e56c20432db984a621e250,1,18,0,2,8,29
3776,1702,2022-10-14 07:22:00,32297b7d6b04fd0c568da68d249c923f,0,14,0,3,7,24
3777,1702,2022-10-14 07:26:00,3fdefa4e21ae554834597a86c8f168f3,0,9,0,1,16,26
3778,1702,2022-10-14 07:31:00,f8b373ab5791d77b216d16711de8a34d,0,17,1,3,10,31
3779,1702,2022-10-14 07:37:00,3f7cd448f476f36bf90d1108798f9048,0,12,1,2,9,24
3780,1702,2022-10-14 07:42:00,02ddbaa77e372bd0e475dc51098370a4,0,9,0,0,16,25
3781,1702,2022-10-14 07:47:00,5078a54c0c629af1e928e51caa766d36,0,13,0,2,11,26
3782,1702,2022-10-14 07:53:00,561bf8be715a7f297a01e815be0783ee,0,20,0,3,6,29
3783,1702,2022-10-14 07:57:00,66461f47df3241c156f6ec66c46226b7,1,13,0,2,13,29
3784,1702,2022-10-14 08:02:00,65bb2ce58e7f902d1350789f8667c513,0,15,0,2,8,25
3785,1702,2022-10-14 08:07:00,ab6bac1ab42d5382e813ae25d62a7b66,0,14,0,2,12,28
3786,1702,2022-10-14 08:12:00,2558a66949af9978900c02b292ec6678,0,11,1,1,10,23
3787,1702,2022-10-14 08:17:00,eb4125ae8947f4e27f258d2dab750517,0,13,0,1,13,27
3788,1702,2022-10-14 08:22:00,2ae20e509fa50b4c3d01ad5ee8fd9848,3,15,0,0,9,27
3789,1702,2022-10-14 08:27:00,cf410c7c393ad9000e9ab2e5115207ef,0,15,0,1,10,26
3790,1702,2022-10-14 08:32:00,b6e878614a1a9514209427dd4b12d04a,0,16,0,1,7,24
3791,1702,2022-10-14 08:37:00,6eefa8cf6b283dbaa8ee10318ab17c29,0,13,0,0,11,24
3792,1702,2022-10-14 08:42:00,4ccd8f3a3ff42ec8457312d8b1022541,0,16,0,1,14,31
3793,1702,2022-10-14 08:47:00,ddcf43ffc591fefbe0a7e74a7eb0f242,0,14,0,1,10,25
3794,1702,2022-10-14 08:52:00,f813a5f2b3fdd4eeacdce29b1251b1d5,0,10,0,2,9,21
3795,1702,2022-10-14 08:57:00,16b5139393ba398a98600df72130cba5,0,8,0,1,13,22
3796,1702,2022-10-14 09:02:00,b4264734706163a7b1bea27d01983df2,0,14,0,1,4,19
3797,1702,2022-10-14 09:08:00,4c6dd0ecf81a4b0bc94227e4a22c8efb,0,15,1,0,7,23
3798,1702,2022-10-14 09:12:00,4d87e363debb22bc1593a38cf4ef89cf,0,12,0,2,12,26
3799,1702,2022-10-14 09:17:00,322c9963ace424fb4c9a651e4ad2e886,0,12,0,1,6,19
3800,1702,2022-10-14 09:21:00,eda1152f66978c111a91e77b292106db,1,10,0,3,10,24
3801,1702,2022-10-14 09:26:00,1407978b728d97bc2e5614c0c911612b,0,11,0,2,9,22
3802,1702,2022-10-14 09:32:00,e7ac0e152139e30cf48c04513014f43c,0,14,0,3,6,23
3803,1702,2022-10-14 09:37:00,ed65830996c789fd44f70d8e4fc6a75e,0,16,0,1,6,23
3804,1702,2022-10-14 09:42:00,16ee1ba53a031aaeb2f6d45627726933,0,18,0,1,10,29
3805,1702,2022-10-14 09:47:00,a98083e45d050a60b2bae944e2085b5c,0,11,0,1,19,31
3806,1702,2022-10-14 09:52:00,a8f6cfe09073997ec1ffd4b47e89d839,0,15,3,2,7,27
3807,1702,2022-10-14 09:57:00,86601f5de4a9dadf3a2f7bf4cede2057,1,14,1,0,11,27
3808,1702,2022-10-14 10:02:00,7bef399a6e644419f84aaa7662bc27cc,0,14,0,2,10,26
3809,1702,2022-10-14 10:06:00,b5dbc4f1a0346fc4454e760f48ebd5a8,0,13,0,0,7,20
3810,1702,2022-10-14 10:12:00,fbf3f416e204a7590ab51ca30b011301,1,17,0,0,12,30
3811,1702,2022-10-14 10:17:00,4ff931e4070396479fb55728b5b9fef8,0,17,0,0,10,27
3812,1702,2022-10-14 10:22:00,4930f764c9b29c64bfaf2418551ad600,0,8,0,1,14,23
3813,1702,2022-10-14 10:27:00,df8af416ff3d2577e8866fc14ff0925c,0,18,1,4,3,26
3814,1702,2022-10-14 10:32:00,a75ac1d601e4a97c71d18561b89c8979,0,16,0,5,14,35
3815,1702,2022-10-14 10:38:00,d5d4a3fc7026faf7458cdba6c4e944c2,0,17,0,4,9,30
3816,1702,2022-10-14 10:41:00,59fe411e083fff2557a9b440ca643095,0,13,0,0,12,25
3817,1702,2022-10-14 10:47:00,a50e1e8b6dd4cc85a54ba8ab48f118c9,0,25,0,3,4,32
3818,1702,2022-10-14 10:52:00,1b157420962df39b9467779f96056121,0,7,0,5,6,18
3819,1702,2022-10-14 10:56:00,40794ba441c371c25a96335ec356fc87,0,10,0,2,11,23
3820,1702,2022-10-14 11:02:00,b4aba2c7af8ebc02d1b4ebad179a28b0,0,14,0,1,3,18
3821,1702,2022-10-14 11:06:00,9ef278471b093decfd379b487086b685,0,18,0,5,4,27
3822,1702,2022-10-14 11:12:00,a78d396b84c0e3b63933bb33d13c2bdd,0,19,0,4,6,29
3823,1702,2022-10-14 11:17:00,90149fddd9b57a9f812ef07b0261078b,0,18,0,1,4,23
3824,1702,2022-10-14 11:22:00,d1cce670f5e24818d44057c5f179c608,1,16,0,3,7,27
3825,1702,2022-10-14 11:26:00,89eb9c768476481a563c94879caab1ff,0,16,0,5,10,31
3826,1702,2022-10-14 11:32:00,39ea1f5b3978932d0c2d9d515a32795f,0,12,0,0,14,26
3827,1702,2022-10-14 11:37:00,f082f330f661d47a983a79a6bdf9b424,0,16,0,0,6,22
3828,1702,2022-10-14 11:42:00,f87bd7787114da3b33992ddee021c941,0,11,0,0,16,27
3829,1702,2022-10-14 11:47:00,87056da2ba253df2dc92b4fc9009d398,2,11,1,4,10,28
3830,1702,2022-10-14 11:52:00,135d8bfb303a75205d50872263c8ef5c,1,15,0,4,12,32
3831,1702,2022-10-14 11:58:00,96a707b0aeb705902b5ad012332bf873,0,9,0,2,15,26
3832,1702,2022-10-14 12:02:00,c66dda1c314da33b16852febadff3c99,0,20,2,7,5,34
3833,1702,2022-10-14 12:07:00,ada7eaa420f27055ded90a8cc1dcc46f,0,13,0,4,6,23
3834,1702,2022-10-14 12:12:00,41ce800614c91b7d80d078a371e60c88,0,12,0,0,5,17
3835,1702,2022-10-14 12:16:00,cd2e94952ec436b4d9629f74f3db2f80,1,15,1,0,6,23
3836,1702,2022-10-14 12:22:00,e0c3a1e76010e8d80c204e70ec4ffc28,0,17,0,2,9,28
3837,1702,2022-10-14 12:27:00,47b85f04c2083324a2dc7ce4810a7c95,0,10,0,1,12,23
3838,1702,2022-10-14 12:32:00,3e0935ce22e1f8c0c29958cb16c51ba6,0,14,0,2,9,25
3839,1702,2022-10-14 12:38:00,16140382bcabcee6fc22df1659d21b83,0,12,0,3,8,23
3840,1702,2022-10-14 12:42:00,382205e5ce6f90ca7d340743cb6fa0df,0,20,0,2,5,27
3841,1702,2022-10-14 12:47:00,c7f352619f81600198e5efc21fe6a9c6,0,19,1,3,6,29
3842,1702,2022-10-14 12:53:00,b5889531d33112ea1b8792542fa75874,0,10,0,8,6,24
3843,1702,2022-10-14 12:57:00,a63e0025ed27b0dca48b8917dd229ead,3,18,0,1,12,34
3844,1702,2022-10-14 13:01:00,909fa712d1250ce8d45f922f6d4c7656,0,14,0,1,7,22
3845,1702,2022-10-14 13:07:00,821e4e3adc2fca95b0369f239105efbe,0,8,0,2,4,14
3846,1702,2022-10-14 13:11:00,cb93e78a06e1e314e7dc0799e68a9507,0,13,0,4,7,24
3847,1702,2022-10-14 13:17:00,f6f9f6c66d4ee99bc33e880412ba874c,0,13,0,3,10,26
3848,1702,2022-10-14 13:23:00,a8a6506923d21edc6380308ffaad10ce,0,14,0,3,11,28
3849,1702,2022-10-14 13:27:00,c9227b6960c222c906a94b7d38e4d7f4,3,14,0,6,8,31
3850,1702,2022-10-14 13:31:00,ff790ba4d3a1b8c99d2fe842b40229a5,0,18,0,3,7,28
3851,1702,2022-10-14 13:37:00,e0a27f1f2e203b75b3a851bb59d8ab1b,0,16,0,0,13,29
3852,1702,2022-10-14 13:42:00,5f63d7e36767daff3f6116d886c732fe,0,9,0,2,12,23
3853,1702,2022-10-14 13:47:00,b2901d1dc33908fb1a456ed718389792,0,17,0,5,7,29
3854,1702,2022-10-14 13:52:00,f43b627417055b23927cf6e6d4778e22,0,17,0,1,10,28
3855,1702,2022-10-14 13:58:00,e6015927f8a2a8a08fc8a935a29b33cd,0,7,0,8,14,29
3856,1702,2022-10-14 14:01:00,5ed3d4a9fbc38ebaebc84c02c8535821,2,19,0,3,5,29
3857,1702,2022-10-14 14:07:00,dcc88a20f06cd4e272738548a0a37027,0,14,0,0,12,26
3858,1702,2022-10-14 14:12:00,c2f415ff31494b8bb9d86759cd9c2d79,0,13,0,8,10,31
3859,1702,2022-10-14 14:17:00,c0bc6cbbafcd5ac11e79680002e01e72,0,12,0,9,18,39
3860,1702,2022-10-14 14:22:00,ec375d244b579be54ec45e98c7e62f31,0,19,0,10,7,36
3861,1702,2022-10-14 14:26:00,f01a09cdddda96daa83776ec8e2691a4,0,24,0,8,2,34
3862,1702,2022-10-14 14:32:00,6a1fe50a59ac0ebe95e6326e83e42870,0,23,0,7,5,35
3863,1702,2022-10-14 14:37:00,0140d43fea817f1fb3400c44e0e40006,0,21,0,6,3,30
3864,1702,2022-10-14 14:41:00,ab0c56229f730cfc2814c00cb65bc770,0,23,0,4,12,39
3865,1702,2022-10-14 14:47:00,64d7dbc491760907372d47f5dab7a830,0,24,0,2,10,36
3866,1702,2022-10-14 14:52:00,58729cbcf5abbd90c45115ae83f141d9,0,13,2,1,16,32
3867,1702,2022-10-14 14:57:00,e813cd7ad6d973d33112cb0c9377caa8,0,16,0,0,10,26
3868,1702,2022-10-14 15:02:00,6a789fa3cd959732da89e321a786e5b3,0,16,0,2,8,26
3869,1702,2022-10-14 15:06:00,d4c7bfa50370107b5c6d30c12ee3b281,0,8,1,0,17,26
3870,1702,2022-10-14 15:11:00,d9277823836306e5da60c04c9974adc9,0,11,1,7,4,23
3871,1702,2022-10-14 15:17:00,e1ca22cdcab067ec44ff34a429015105,1,9,0,3,13,26
3872,1702,2022-10-14 15:22:00,a31771bd76ddc8be823426a382667a16,4,17,0,3,6,30
3873,1702,2022-10-14 15:27:00,1f9da2ebbd7670a87561134eebc5080e,0,13,0,6,12,31
3874,1702,2022-10-14 15:32:00,795fd92312dd7da18051eeff1a40d547,0,13,0,7,12,32
3875,1702,2022-10-14 15:38:00,fd8a795df91af1d499dd615dea2d2e09,1,20,0,2,12,35
3876,1702,2022-10-14 15:43:00,207e2e74fde15fad5d0a7c16f13dbcaf,0,15,0,7,8,30
3877,1702,2022-10-14 15:48:00,3642e71b610133ed294677a9664eaba9,0,14,0,8,9,31
3878,1702,2022-10-14 15:52:00,043844c138e42d2f74508712fcf80afe,0,16,0,4,6,26
3879,1702,2022-10-14 15:57:00,169ffd5b0e07022c153491254b4b2d88,0,13,0,4,13,30
3880,1702,2022-10-14 16:02:00,eedd94ad8938ef6d9eaf1daaac76516b,1,8,0,6,12,27
3881,1702,2022-10-14 16:08:00,9b84eaaaaa6445d3ecb07faeab56da07,0,12,1,3,14,30
3882,1702,2022-10-14 16:12:00,14ee54cf408d4ef6ac2da97481a98739,0,14,0,1,11,26
3883,1702,2022-10-14 16:17:00,cad435080efccfb611dd75b8582f61e4,0,12,0,3,8,23
3884,1702,2022-10-14 16:22:00,992bf220a9454e0cc8b6a61b8ef7fae8,0,21,0,1,7,29
3885,1702,2022-10-14 16:27:00,853e7d05ed87f944ad00ac9d80972f0e,0,19,0,4,4,27
3886,1702,2022-10-14 16:32:00,48839e1213264ce048f2594888b633cf,1,21,0,3,6,31
3887,1702,2022-10-14 16:37:00,e9f8c4ec25b917773d08092a15bd11dd,0,16,0,4,7,27
3888,1702,2022-10-14 16:42:00,b5c92fae9d010118dbd9f95c63a7fe52,1,15,1,6,14,37
3889,1702,2022-10-14 16:47:00,00f7e4d9974679ac0cc58ad57dd38c43,2,16,0,2,6,26
3890,1702,2022-10-14 16:52:00,708a7c4de3dd821e043e3b9b37f5fba5,0,12,0,2,13,27
3891,1702,2022-10-14 16:57:00,99c68ee585ee3de90fe80fb7d4a676cc,0,17,0,7,8,32
3892,1702,2022-10-14 17:02:00,e33a047e7fe931d6434cdf23ab9595d5,0,13,0,6,6,25
3893,1702,2022-10-14 17:07:00,03203f4141eebd2309bb1519ab2d12e1,0,15,0,7,7,29
3894,1702,2022-10-14 17:17:00,6ea0f2c3c45a73d19af9f128a120e5d2,1,19,0,9,12,41
3895,1702,2022-10-14 17:22:00,b8daae4a8ddc74f6e4c3817d47f09fc9,0,18,1,5,5,29
3896,1702,2022-10-14 17:27:00,1a9fe62ab6f1af99d7aed4b99ad7b1d9,0,16,0,6,11,33
3897,1702,2022-10-14 17:32:00,691c179d71a3190ce6c2acf09741fd3e,0,20,0,6,6,32
3898,1702,2022-10-14 17:38:00,ae75b32501082a0598c7c1c7f3322a60,0,13,0,8,12,33
3899,1702,2022-10-14 17:42:00,3f67ad9341c37ac7056ddf885e377067,1,19,0,8,7,35
3900,1702,2022-10-14 17:47:00,89fd2b167f91e15d61487f507b1bd437,0,18,0,1,12,31
3901,1702,2022-10-14 17:52:00,a73e37db1de425945b13c43388d8ee66,0,21,0,1,16,38
3902,1702,2022-10-14 17:56:00,bd050f631ac139f155be54816250b91b,0,15,1,5,9,30
3903,1702,2022-10-14 18:02:00,c09632df1aea53fe68a8facfbf6de7ba,0,19,1,7,9,36
3904,1702,2022-10-14 18:07:00,21fb0330ab13ae4ddc483cf60f174e7b,0,20,0,0,11,31
3905,1702,2022-10-14 18:12:00,7c376a0a24512818f74d40254d947d1d,0,16,0,5,13,34
3906,1702,2022-10-14 18:17:00,33992c6836b68d589bd40cd5c2db597d,1,13,0,3,13,30
3907,1702,2022-10-14 18:22:00,4a5bb6018c1f315e2868b386b81d1d8a,1,12,0,2,14,29
3908,1702,2022-10-14 18:26:00,33075df0005a23639cfd69310cf5fa3f,0,14,0,3,12,29
3909,1702,2022-10-14 18:32:00,90112529633db13e7c477ec9dc592c66,1,17,0,1,14,33
3910,1702,2022-10-14 18:37:00,ec1b7792adb2187d4f2a115720293b9d,0,27,0,2,2,31
3911,1702,2022-10-14 18:42:00,3ec9964592392e681e4da262d81fc01a,1,24,0,3,10,38
3912,1702,2022-10-14 18:46:00,e5b707161f281fe4655cbf71eadccbe0,0,17,0,2,7,26
3913,1702,2022-10-14 18:52:00,4a147b7fab9042df8e55a3476a50adcb,0,17,0,2,8,27
3914,1702,2022-10-14 18:56:00,388db27bd318f07d78efd47df8803168,0,19,0,4,0,23
3915,1702,2022-10-14 19:03:00,dada85524619d377dd0fdd5aeed7d218,0,20,0,2,2,24
3916,1702,2022-10-14 19:06:00,4511c77354cd0a289750e235e8ffa458,0,23,0,0,3,26
3917,1702,2022-10-14 19:11:00,95884dc2006693bb9e1991850644d052,0,15,0,1,2,18
3918,1702,2022-10-14 19:17:00,d1bccddd853df981ab07088d3f51bb61,0,27,0,4,0,31
3919,1702,2022-10-14 19:22:00,457e0edc9efcd49ed263d2f7ed18a9f7,0,18,1,2,0,21
3920,1702,2022-10-14 19:26:00,aef7173bd366e17fa01e498cc00b5f54,0,18,0,0,0,18
3921,1702,2022-10-14 19:32:00,b08c6baa1ac29ef0fa0be9da841cce10,0,15,2,3,3,23
3922,1702,2022-10-14 19:37:00,659a52fb4c9af3f45b6801885f2cc7bb,0,23,1,2,0,26
3923,1702,2022-10-14 19:41:00,557eef35495d5afb07fbd6c6d8a5576e,0,26,0,1,1,28
3924,1702,2022-10-14 19:47:00,1ab6b5623da740a0573d4d19af7e7482,0,9,0,0,3,12
3925,1702,2022-10-14 19:52:00,44f51ef0f51398b4c0da1b0829dae625,0,9,0,3,0,12
3926,1702,2022-10-14 19:57:00,f68002429c2764d9b7621ef263dba4ad,0,16,0,0,0,16
3927,1702,2022-10-14 20:01:00,49f9247e82f3d562686b990e02960365,0,17,3,0,0,20
3928,1702,2022-10-14 20:08:00,cd7737e626c28a7c63138a20223ce0a3,0,13,0,0,2,15
3929,1702,2022-10-14 20:11:00,39f2a3f19e55be801dee81bfcfea6883,0,17,1,1,1,20
3930,1702,2022-10-14 20:16:00,cc82f9793f64c6cb90601f30a9b1ccbd,0,22,1,0,1,24
3931,1702,2022-10-14 20:22:00,7bd974472acaff2dcbed2433fac9b7b0,0,22,1,0,5,28
3932,1702,2022-10-14 20:26:00,9bcfd73522650452f558177452f66286,0,16,1,1,1,19
3933,1702,2022-10-14 20:31:00,d23d23e6b1530bd5df6c644d5f78d567,0,19,0,0,1,20
3934,1702,2022-10-14 20:37:00,e6ed34bc78c1b287cb321b73b725be1b,0,19,0,0,1,20
3935,1702,2022-10-14 20:41:00,414c10cc3e4991972f5324dfc1b88b83,0,18,0,0,1,19
3936,1702,2022-10-14 20:47:00,1b90d68491a3549f00a25a043f1f8420,0,18,2,0,0,20
3937,1702,2022-10-14 20:51:00,d9d2c2285bb28141e34bce5d05a37d7e,0,9,0,0,3,12
3938,1702,2022-10-14 20:56:00,2c5c84fbd836aa57cdb6671653ee5809,0,18,0,0,0,18
3939,1702,2022-10-14 21:02:00,dd7d7899c13bf6ae6b5a99e461a82daa,0,17,1,1,1,20
3940,1702,2022-10-14 21:06:00,99fae7f21e84386b4f9593beb7d00242,0,9,1,0,0,10
3941,1702,2022-10-14 21:11:00,94639c5acb971667d3179dfd9178a63c,0,22,0,0,2,24
3942,1702,2022-10-14 21:17:00,dc67ab14ee121109bc55b71e3750de8c,0,19,1,1,0,21
3943,1702,2022-10-14 21:21:00,e00c2b4fd20a669c3182adc21fea0e52,0,17,0,2,1,20
3944,1702,2022-10-14 21:27:00,4b29c9a0afc658f840711dd475007e55,0,23,2,2,1,28
3945,1702,2022-10-14 21:32:00,8a9b31c6e6a50f441db66d509b4f9ad6,0,18,3,0,1,22
3946,1702,2022-10-14 21:37:00,c0511c52fc0a36eed2576dabe341e7da,0,21,1,1,0,23
3947,1702,2022-10-14 21:42:00,907ca553af3d0e25910b863484185065,0,21,0,0,1,22
3948,1702,2022-10-14 21:47:00,1ec3fb507d9076e8f62759d110f36e9a,0,22,0,0,1,23
3949,1702,2022-10-14 21:52:00,c75501f236676695195c1de2bacb95d5,0,17,2,0,1,20
3950,1702,2022-10-14 21:56:00,c53cdd502e5b14222992ba5f169384e6,0,18,0,2,0,20
3951,1702,2022-10-14 22:02:00,e04ce5c675db9856d30fc32cc5c7a2ed,0,21,0,2,1,24
3952,1702,2022-10-14 22:07:00,f93bed8c78314d3f0b65d280156a6dd0,0,22,0,0,5,27
3953,1702,2022-10-14 22:11:00,83d3d3e45c93a9a82cf2bd555857983b,2,18,0,0,0,20
3954,1702,2022-10-14 22:17:00,dfa0362baf93bffe571ffae16033e243,0,20,0,0,1,21
3955,1702,2022-10-14 22:22:00,3b63a0915a003f2e728513a724db7f5d,1,18,0,2,0,21
3956,1702,2022-10-14 22:27:00,0186a9583bb85912cb77a1607e67c9bf,0,24,1,1,0,26
3957,1702,2022-10-14 22:32:00,1733398206f3b57769709f2d3b00446d,0,25,2,1,0,28
3958,1702,2022-10-14 22:37:00,d4122de53db9a4e565976b88904c38d6,0,25,0,1,4,30
3959,1702,2022-10-14 22:41:00,7168ffaf40baf951ee02a468482c8110,0,20,1,0,1,22
3960,1702,2022-10-14 22:47:00,fc55291197601f2e26329074876b6e4f,0,15,1,0,2,18
3961,1702,2022-10-14 22:52:00,bf2f4c93a76630b2b523006397403b3d,0,27,1,0,1,29
3962,1702,2022-10-14 22:56:00,ce67dacf8a2fdbfde59a9f704c2d5db4,0,8,1,0,1,10
3963,1702,2022-10-14 23:02:00,d2f1e8640a8c4494564f524c6000e261,1,12,5,0,1,19
3964,1702,2022-10-14 23:07:00,c7eff67ac879dc1d4b527cfa4706b51a,0,20,0,2,1,23
3965,1702,2022-10-14 23:12:00,a418ab4643a12427ca3b59c4aacd3021,0,19,0,0,0,19
3966,1702,2022-10-14 23:17:00,45d124aa85e8a2358dcee9b7848ed2f8,0,11,1,0,0,12
3967,1702,2022-10-14 23:21:00,790d872fa39cf70e6c005c3333890c80,0,11,1,0,1,13
3968,1702,2022-10-14 23:27:00,1c793ce6b79c8e7f8a5c7e74d7b33b38,0,17,1,0,1,19
3969,1702,2022-10-14 23:31:00,2848e9c3edb4acd75200a87e19eb2f28,0,12,2,0,1,15
3970,1702,2022-10-14 23:37:00,914fcbed497d2d0a3021f5d0c77e350d,0,8,0,0,0,8
3971,1702,2022-10-14 23:41:00,0e1c3028ea9abc32521dc80975cfaab2,0,14,3,0,1,18
3972,1702,2022-10-14 23:47:00,032cd57a2d4180f4d02bca845bcec153,0,13,0,0,1,14
3973,1702,2022-10-14 23:53:00,34ffb29b93030411242498a0e4455733,0,13,5,0,0,18
3974,1702,2022-10-14 23:57:00,8740b4e46de3c352423949feac4f63b3,0,9,1,0,0,10
3975,1702,2022-10-15 00:03:00,96fe731c6ebaa3c1d27ebcf6d0969853,0,9,0,0,1,10
3976,1702,2022-10-15 00:07:00,4203c99719650a776a2620878c26d889,0,12,1,0,0,13
3977,1702,2022-10-15 00:11:00,146cd69f55cfca9e7bb83acf025a34d8,0,11,0,0,0,11
3978,1702,2022-10-15 00:18:00,5e7541588a8017e86025f33fc170c404,0,9,3,0,0,12
3979,1702,2022-10-15 00:22:00,768becde8808dbe37481a232bb1ef232,0,9,0,1,1,11
3980,1702,2022-10-15 00:27:00,3e0870cdb41bfe4680982dd7ff54cc8b,0,5,2,0,2,9
3981,1702,2022-10-15 00:32:00,1ebd0c18a0d7e79d78f6b5760d536b82,0,16,0,0,0,16
3982,1702,2022-10-15 00:38:00,111edd2c9c6212253b8739ab1c9f1357,0,7,1,0,0,8
3983,1702,2022-10-15 00:42:00,f926eb3c09b08c1353ea869c63ad71b5,0,11,0,0,1,12
3984,1702,2022-10-15 00:47:00,83e159eaba7b0d75f468b6168849be9d,0,8,0,0,1,9
3985,1702,2022-10-15 00:51:00,b94379355c7e94544240694c42bf1882,0,4,2,0,1,7
3986,1702,2022-10-15 00:57:00,db614c1e09a8bd311f03995e849d446c,0,13,0,0,0,13
3987,1702,2022-10-15 01:03:00,902d2ada1870a2570fc9c8183e3da9c6,0,7,0,0,1,8
3988,1702,2022-10-15 01:07:00,793685a006a0efc52bd14f183d8bc551,0,7,0,0,1,8
3989,1702,2022-10-15 01:12:00,dceebbc297cc4c3940a9674d28cdc994,0,9,0,0,0,9
3990,1702,2022-10-15 01:18:00,b04e719ebf0e2ce37f7a4523e7acf94f,0,13,0,0,0,13
3991,1702,2022-10-15 01:23:00,8ae2407177cac880d5a71fb73af83d79,0,8,0,0,0,8
3992,1702,2022-10-15 01:27:00,8f33b6b9f1a9dba37ed0a10c2f40ca63,0,15,1,0,2,18
3993,1702,2022-10-15 01:33:00,ae081c48626152a04ed7b32b5b066210,0,10,0,0,0,10
3994,1702,2022-10-15 01:38:00,c3cff90d8c71bb39b9844c01fdd39b6a,0,6,0,0,0,6
3995,1702,2022-10-15 01:41:00,b3bc10bb279357072403ea28a3ae8308,0,13,0,1,0,14
3996,1702,2022-10-15 01:47:00,d3916be44994f2019909c68322437071,0,9,0,2,0,11
3997,1702,2022-10-15 01:53:00,e8fad1efecdfaca9b952b0980701ed3e,0,5,0,0,0,5
3998,1702,2022-10-15 01:57:00,3e84f26e7213bebf04ce2ec214809458,0,12,0,0,1,13
3999,1702,2022-10-15 02:03:00,5478e0bae9ba1c11cb911cc1878e590d,0,15,1,0,0,16
4000,1702,2022-10-15 02:08:00,954a08fda7380a1e9e2f4e9fed27eeed,0,14,0,0,0,14
4001,1702,2022-10-15 02:12:00,4f68b0739d6b129950b07cde2941214f,0,13,0,0,0,13
4002,1702,2022-10-15 02:17:00,3e04bd17355af764390401bfbf8e8b66,0,7,1,0,0,8
4003,1702,2022-10-15 02:22:00,9219b276a2ff831aba2c7843779dc60c,0,13,0,0,0,13
4004,1702,2022-10-15 02:28:00,59da9ddd9bd862273fa94a075b21ebcd,0,8,0,0,1,9
4005,1702,2022-10-15 02:32:00,c7e9118167a5694e6873d1b662e561ea,0,13,1,1,1,16
4006,1702,2022-10-15 02:38:00,2a04233542426514d5c2a4ce87f8febd,0,9,0,0,0,9
4007,1702,2022-10-15 02:42:00,72c91b917078cb2b60cb2c1584757ce6,0,9,1,0,0,10
4008,1702,2022-10-15 02:47:00,a7f53e10d0227aeebda87914a5ff66e5,0,7,0,0,0,7
4009,1702,2022-10-15 02:52:00,cb74a5d49eb421d9dd38703ad2f55006,0,6,0,0,0,6
4010,1702,2022-10-15 03:02:00,b22aa2a9a4cc7022fda7e5d23c412132,0,8,0,0,0,8
4011,1702,2022-10-15 03:07:00,b863f60bc77c97012ffae59144fe3363,0,5,0,0,0,5
4012,1702,2022-10-15 03:11:00,7a36e365cec3af86d96b6b07a9c794e7,0,12,0,0,1,13
4013,1702,2022-10-15 03:17:00,a7d34a52e8dbfbb6db13669c0789e871,0,6,0,0,1,7
4014,1702,2022-10-15 03:22:00,1b33d6827b1dda227538e68eb4c308b3,0,8,1,0,0,9
4015,1702,2022-10-15 03:27:00,bf573305be11c3f747f0bd164512bbf9,0,6,1,0,0,7
4016,1702,2022-10-15 03:32:00,6d34e8ecfa7f87d7edf0cda188226f2a,0,8,1,0,1,10
4017,1702,2022-10-15 03:37:00,4b695acd3ed25490d50b87985d6a7e9d,0,4,0,0,0,4
4018,1702,2022-10-15 03:42:00,9fcdee3a0816dff7bd6e533f0de303e4,0,6,0,0,0,6
4019,1702,2022-10-15 03:47:00,88f053141924f906f98e185b88a3108c,0,7,1,0,0,8
4020,1702,2022-10-15 03:53:00,21bdd4df8dd6705a51befca74445a794,0,11,0,0,1,12
4021,1702,2022-10-15 03:57:00,a9e2fbad734ef8f157f090ee7b2dcbb2,0,5,0,0,0,5
4022,1702,2022-10-15 04:02:00,69cd776b60080f946030553bd00e8488,0,4,0,0,2,6
4023,1702,2022-10-15 04:07:00,446ce27d4a9bd9e34e124a69dc9317c5,2,6,0,0,1,9
4024,1702,2022-10-15 04:12:00,6fac5ae8602556dc29116788695f29ff,0,2,0,0,1,3
4025,1702,2022-10-15 04:18:00,eb5a32753b703340cdb89c6528697c0a,0,7,0,1,0,8
4026,1702,2022-10-15 04:23:00,8070370b880d672ed94eeef8d9effd6f,0,5,1,0,0,6
4027,1702,2022-10-15 04:27:00,be5375d2d9247ce9ca77a07fc65c7373,0,9,0,0,0,9
4028,1702,2022-10-15 04:32:00,d11dde08b36c33b9dfe88614a517ffe9,0,7,1,1,0,9
4029,1702,2022-10-15 04:37:00,e7e48085b87f37e92115ccd4869980ef,0,7,0,0,0,7
4030,1702,2022-10-15 04:41:00,02cb08640868c37f48fa19658ddb723d,0,5,2,0,0,7
4031,1702,2022-10-15 04:47:00,0e11a7e5847e8bfad5c9d69ccc0d1eea,0,1,0,0,0,1
4032,1702,2022-10-15 04:52:00,b644a65ad581a527dbb1def336e54477,0,11,1,0,0,12
4033,1702,2022-10-15 04:56:00,338bebcf9402d15b8b2c8f8dd54dc68f,0,7,0,0,1,8
4034,1702,2022-10-15 05:01:00,2deca0a7975c6b517b34fe73f356adef,0,7,0,0,0,7
4035,1702,2022-10-15 05:06:00,c7591b725adc39637b6e4b3d83d298b2,0,6,0,0,0,6
4036,1702,2022-10-15 05:13:00,97a9fa2c509987d1928cba373c7a6dfd,0,3,0,0,0,3
4037,1702,2022-10-15 05:18:00,49b4145cb470c26c863c0bf470218132,0,6,0,0,1,7
4038,1702,2022-10-15 05:23:00,c033774ad257b88587c38c114d501cca,0,9,0,0,0,9
4039,1702,2022-10-15 05:27:00,0df261768119e6545c18b164fdba71e9,0,3,0,0,1,4
4040,1702,2022-10-15 05:31:00,e5fb7f8a8706267fe0eac5f7ef16cc23,0,8,0,0,2,10
4041,1702,2022-10-15 05:37:00,15a49145bbec16c3f7d275357d57a29d,0,3,0,1,0,4
4042,1702,2022-10-15 05:42:00,d111e784910a069022d6b5d2732fe3ce,0,3,0,0,0,3
4043,1702,2022-10-15 05:48:00,37f79157e980ba4b4ee2520a2e0463eb,0,1,0,1,2,4
4044,1702,2022-10-15 05:52:00,88ef0f7fd8c4df2fc4dd321efd5aa889,0,0,0,1,0,1
4045,1702,2022-10-15 05:57:00,9964f9e5efbddb2a3b1fd85741a54824,0,5,2,1,0,8
4046,1702,2022-10-15 06:01:00,b3fd04019fb8137bde4ff8b82c80ad63,0,4,0,1,1,6
4047,1702,2022-10-15 06:08:00,638f59f680accd3c1a4db2f41e755606,0,7,0,0,0,7
4048,1702,2022-10-15 06:12:00,a99364f6295879e08c1d7053b7759c5d,0,6,0,2,1,9
4049,1702,2022-10-15 06:18:00,cf9184163033f4fb1c7785ebd29a8cc8,0,9,2,1,0,12
4050,1702,2022-10-15 06:23:00,ad5fb1695a7260d8e73c7a95f96f6def,0,7,0,2,0,9
4051,1702,2022-10-15 06:28:00,7c10657678e28fb09ad7f96a4f29d2b6,0,10,0,2,0,12
4052,1702,2022-10-15 06:31:00,da1db3ada822a748e78d3df0dc3018c2,0,10,1,0,1,12
4053,1702,2022-10-15 06:37:00,4f8116510bfee197df3793cb0640a15a,0,7,0,0,0,7
4054,1702,2022-10-15 06:41:00,c6c3178c5d4cd2832d3a5ade031dc1ff,0,10,0,0,0,10
4055,1702,2022-10-15 06:47:00,de1db63e9a66b271a12aff78d3067a95,0,12,2,1,3,18
4056,1702,2022-10-15 06:53:00,ff14a6ea822000206b2b80f06f29d8d9,0,12,0,1,0,13
4057,1702,2022-10-15 06:57:00,e8ab6a514348804ac353c9dde483912f,0,6,0,1,4,11
4058,1702,2022-10-15 07:02:00,42c0df6bc52344ed6b3554e34699d085,0,11,0,0,6,17
4059,1702,2022-10-15 07:07:00,c30e35f8efe1b59fd0efc6974fe31a7b,0,9,0,1,5,15
4060,1702,2022-10-15 07:12:00,835c587b96198cac290e90021dc3abd9,0,10,1,2,6,19
4061,1702,2022-10-15 07:17:00,148639885d87c9deb133da082adc10cd,1,7,0,0,7,15
4062,1702,2022-10-15 07:23:00,2f342e39404cb7c1df1a5f7f2fd8c221,0,9,1,1,10,21
4063,1702,2022-10-15 07:26:00,d09ef4764bb8db5f62dd46b4cd8f7637,1,12,0,3,5,21
4064,1702,2022-10-15 07:32:00,972249517f2fb0ddf33ff1e99f6737ed,0,11,0,2,3,16
4065,1702,2022-10-15 07:38:00,a6ce76813ba81a40d90e765f95073e70,0,14,0,0,5,19
4066,1702,2022-10-15 07:43:00,c3b90f97fe0d51ff163b8bacf188697c,1,12,2,1,9,25
4067,1702,2022-10-15 07:47:00,cf620db4df1bc4d9ec6a4e11787db8dc,0,13,0,2,13,28
4068,1702,2022-10-15 07:53:00,884341b2064984a0f1bc3eeabfcd3d3f,0,12,0,2,8,22
4069,1702,2022-10-15 07:58:00,4d5affeee3548c67b7722c70aabf0d04,0,12,1,1,8,22
4070,1702,2022-10-15 08:02:00,cef128a297ed589c979a9d5965b51fb0,0,7,0,4,2,13
4071,1702,2022-10-15 08:08:00,8089b776fa204e2bfb1c8848b4695b69,0,11,1,1,6,19
4072,1702,2022-10-15 08:13:00,f982ef2a318a8e386993276763f8dcba,1,12,0,0,9,22
4073,1702,2022-10-15 08:18:00,ea10a9dc8c8dbd3454bd1a3f6c3d846f,0,20,0,3,9,32
4074,1702,2022-10-15 08:24:00,88581947c7666f02027a46ac0932544b,0,16,1,0,6,23
4075,1702,2022-10-15 08:27:00,e6015ab8dcc09841beb8d33fbed282e2,0,15,0,1,11,27
4076,1702,2022-10-15 08:33:00,4fd083904c01467bd156573df97daf3d,0,15,0,4,10,29
4077,1702,2022-10-15 08:38:00,200f96ac0b57062a49f57187de9ceb05,0,9,0,6,10,25
4078,1702,2022-10-15 08:42:00,01e5f48ee01b1f37dc738a2e4168c53c,0,16,0,2,8,26
4079,1702,2022-10-15 08:49:00,47134b466996472b2501e6ee133da599,0,20,0,2,5,27
4080,1702,2022-10-15 08:53:00,21b99720c3e4f39550903bb60a634671,0,11,0,4,8,23
4081,1702,2022-10-15 08:57:00,ebbf3cc3e607dc4d087b7fe7ac2c6044,0,17,0,3,11,31
4082,1702,2022-10-15 09:04:00,9eef78d156ae8966f63134f47658714d,0,16,0,3,9,28
4083,1702,2022-10-15 09:09:00,e5212cf827c44a8d031afb7d96828c04,0,16,0,0,15,31
4084,1702,2022-10-15 09:13:00,8898bf1aa5f8f49a1bc6f4f25d941a20,1,15,0,3,6,25
4085,1702,2022-10-15 09:18:00,d7b17c33cd392a0726b5d0fc664423a1,0,14,0,2,6,22
4086,1702,2022-10-15 09:22:00,d797780a4f81174d78470e54f967fcbd,0,12,0,2,5,19
4087,1702,2022-10-15 09:27:00,d8b7751f7e2477be1e940d149efa90e9,0,12,0,3,9,24
4088,1702,2022-10-15 09:32:00,6467894c76127ea744f57b0623427b1b,0,11,0,2,11,24
4089,1702,2022-10-15 09:38:00,e6c9ba524083adb889f88e8d06921060,0,13,0,1,6,20
4090,1702,2022-10-15 09:43:00,40e32338f2da1345228ba801dcd7f253,0,10,0,1,11,22
4091,1702,2022-10-15 09:48:00,d9cfc6ce0a1fae409142167a4b291183,0,16,0,2,6,24
4092,1702,2022-10-15 09:52:00,82938d63650c4b3e98589baa0ac3481a,0,19,0,0,9,28
4093,1702,2022-10-15 09:59:00,922730aa7771d5ee72f2bc05cfcc6caf,0,12,0,0,7,19
4094,1702,2022-10-15 10:04:00,765fcdd47a0811be078ecbb54b83b355,0,16,0,3,7,26
4095,1702,2022-10-15 10:08:00,269bd3923ceb4732e02efbf88e3b11e1,1,12,1,2,7,23
4096,1702,2022-10-15 10:13:00,ea2fbcee4f15adc194519bf2f816c5c0,0,16,0,3,10,29
4097,1702,2022-10-15 10:18:00,9fb0a6538ce6b44028e9a7421f745ec3,0,13,0,5,7,25
4098,1702,2022-10-15 10:23:00,03c30401e32a8b7f91a99506eec52c30,0,13,1,1,14,29
4099,1702,2022-10-15 10:28:00,618ed018f850e594dc49b148973e7ca3,0,13,0,9,9,31
4100,1702,2022-10-15 10:33:00,b98d9981ee8b0cd9444e2b1a6dbde044,0,19,0,2,5,26
4101,1702,2022-10-15 10:39:00,c069f143fff937a703428c936c052ce7,0,18,0,4,3,25
4102,1702,2022-10-15 10:44:00,bab0b171872a901461fb018412f953f8,0,16,0,3,6,25
4103,1702,2022-10-15 10:47:00,4de45aa0bee70010082ff793844c585c,0,15,0,0,9,24
4104,1702,2022-10-15 10:54:00,e17b944fd71791b7e8a5b591e09c8893,0,17,0,2,12,31
4105,1702,2022-10-15 10:57:00,86a072d9b279f91697e893ea9d37ec27,0,20,1,1,10,32
4106,1702,2022-10-15 11:08:00,be30bf33164fefb110a6ad87efe0f83e,0,13,0,5,11,29
4107,1702,2022-10-15 11:13:00,a69a0c64b28cf2cb3bd56448d468ca3f,0,16,1,0,12,29
4108,1702,2022-10-15 11:17:00,fb2fa625559fd996fed7396b5265de44,0,9,0,5,9,23
4109,1702,2022-10-15 11:24:00,cadad7fefa2355f22edae180ca8f4faa,0,12,1,4,5,22
4110,1702,2022-10-15 11:28:00,0b68503c2c233a6577deca8f9c9e3a70,0,24,1,0,4,29
4111,1702,2022-10-15 11:32:00,d15cfe47bd1b3555b608288e9afd9cf4,1,20,0,3,11,35
4112,1702,2022-10-15 11:39:00,6210222d7073f6dd28ecda6f8bc5ba08,1,17,3,3,6,30
4113,1702,2022-10-15 11:43:00,54d5538c75884aed64651ce942648c11,0,21,0,7,5,33
4114,1702,2022-10-15 11:48:00,b86401ea68b606a1ec37733aea5388dc,0,24,0,3,3,30
4115,1702,2022-10-15 11:53:00,acdc4d3a0f97c4a565673400edf62a09,0,15,0,1,9,25
4116,1702,2022-10-15 11:58:00,5921173cd452984f8e423b1768260847,0,13,1,3,7,24
4117,1702,2022-10-15 12:05:00,4987093d2a84915a90ccfbd171e2871e,0,16,0,1,7,24
4118,1702,2022-10-15 12:13:00,f371f55895698670fdebdab5314b6d8c,0,15,0,2,10,27
4119,1702,2022-10-15 12:18:00,e26c91cab946964fc2c7c57fc452892b,0,13,0,3,16,32
4120,1702,2022-10-15 12:22:00,e15d91303a9f423681694b0fa37974c2,0,25,1,2,5,33
4121,1702,2022-10-15 12:28:00,9dfe0319c00553c91cc652e4117fc801,0,20,1,4,5,30
4122,1702,2022-10-15 12:33:00,6a0b7d8a2b280e334f11ad94e84625ff,0,14,0,4,4,22
4123,1702,2022-10-15 12:39:00,15e08a7249ffae5a776d5f2503cef447,0,17,0,2,3,22
4124,1702,2022-10-15 12:43:00,7ec816164669fea3a837057a7a655c41,0,18,0,6,2,26
4125,1702,2022-10-15 12:49:00,9cf025b3846e9f318bc52a75fdf1e223,0,18,0,4,1,23
4126,1702,2022-10-15 12:53:00,42a0038898cb08b0bfbd9c2814b335f3,0,16,0,5,7,28
4127,1702,2022-10-15 12:57:00,1ff45b54738aa7d8ac6d90aab7d45a28,0,13,0,1,10,24
4128,1702,2022-10-15 13:03:00,feb68583f5ecce74b870c2f974866b49,0,13,0,0,8,21
4129,1702,2022-10-15 13:08:00,10b480aa819f24b9e2c281ee16974959,0,20,0,2,7,29
4130,1702,2022-10-15 13:12:00,203e611c3fea77a4cbda5f1b0306dcf8,0,8,0,4,8,20
4131,1702,2022-10-15 13:18:00,287fe6b6e65e703de13d226d920bc57c,0,12,0,6,0,18
4132,1702,2022-10-15 13:24:00,f0df7ac08f98516a1ec096cd5bfeccb3,1,16,1,3,4,25
4133,1702,2022-10-15 13:29:00,2f3ce9b7fc6f125d780915c8f14e0785,0,18,0,4,3,25
4134,1702,2022-10-15 13:32:00,7ce1eb511f8a36bda42e589c2e953c32,0,13,0,1,10,24
4135,1702,2022-10-15 13:38:00,621ecd6adc6142116f8ce65ef6d28063,0,20,0,7,3,30
4136,1702,2022-10-15 13:43:00,2c73807e3a26e16c30ca16f4df8bdb8d,0,9,0,4,14,27
4137,1702,2022-10-15 13:49:00,a1075bd9b87c0a03ee743cd49c74b7b1,0,16,0,0,10,26
4138,1702,2022-10-15 13:53:00,1edd8cc9b3f6c81b3e89b16c3c4d1496,0,17,0,2,8,27
4139,1702,2022-10-15 13:58:00,117de6d7b21c0fa17dffab5116020617,0,11,1,0,13,25
4140,1702,2022-10-15 14:03:00,d5fa2cc42381961e18829fa943f83f1f,0,19,0,2,3,24
4141,1702,2022-10-15 14:08:00,e77cdb9850de69b665f384d5bc9968c9,0,13,0,1,9,23
4142,1702,2022-10-15 14:13:00,a059ebb5142b0632e5a51549a12aedfa,0,22,0,8,3,33
4143,1702,2022-10-15 14:18:00,b2b2368432687b9f35dbb66be14fcd07,0,20,1,8,6,35
4144,1702,2022-10-15 14:23:00,4a6ecfe0507bf3407ad5aa8fb1245dfa,0,17,0,2,7,26
4145,1702,2022-10-15 14:28:00,fa773ced4957419ded275be91529121d,0,22,0,1,6,29
4146,1702,2022-10-15 14:33:00,f27b5cff7f7aba4f99e699b998601dcb,0,13,0,4,4,21
4147,1702,2022-10-15 14:39:00,d02333c9dd2489eb44ccf43df4b74393,0,19,0,3,5,27
4148,1702,2022-10-15 14:43:00,13beee78c840cf8125ae721168f0a312,0,19,1,1,5,26
4149,1702,2022-10-15 14:49:00,f226d54c5f04c5a297cf58fa5c753c47,0,17,0,2,7,26
4150,1702,2022-10-15 14:54:00,189a33582bdca171755284a6795e67a0,1,22,0,4,8,35
4151,1702,2022-10-15 14:57:00,b0d887d96e2240a5ad6f2e8127aad718,0,14,0,2,10,26
4152,1702,2022-10-15 15:04:00,e3cbd505dfc749b6b2e4b4fb5beba9a2,0,20,0,6,7,33
4153,1702,2022-10-15 15:08:00,29952426223ad360ace734fed56454a7,0,20,0,3,6,29
4154,1702,2022-10-15 15:13:00,18c105e75a970ba6b806c88b5db27ac5,0,19,0,3,9,31
4155,1702,2022-10-15 15:18:00,a16e8719547c45114c780896615f6fa9,1,20,0,2,7,30
4156,1702,2022-10-15 15:23:00,e0e42bca9bae041276ff4d6ba7ff6605,0,22,0,3,7,32
4157,1702,2022-10-15 15:28:00,b56d33c078f5ae7a31ecfcec800a540b,0,16,0,6,15,37
4158,1702,2022-10-15 15:33:00,da99cf5e3b821f370de85ebd8cf55570,0,19,1,8,8,36
4159,1702,2022-10-15 15:38:00,1f4991d883478346402fb29b012b9321,0,14,0,6,6,26
4160,1702,2022-10-15 15:43:00,e821078ebeaf66386a42b21231b7e19f,0,16,0,5,11,32
4161,1702,2022-10-15 15:49:00,c541144d1d55aec1121d4161dc0839dd,1,19,1,4,11,36
4162,1702,2022-10-15 15:53:00,2f82b0d3d32053d59a7b2e6e091d0e64,1,12,0,2,10,25
4163,1702,2022-10-15 15:58:00,a715f9f2e1b0b3b6a3cefd12d14984aa,1,21,0,4,8,34
4164,1702,2022-10-15 16:03:00,125088fc46b2ef349738cbbdc11b9182,0,14,1,3,4,22
4165,1702,2022-10-15 16:08:00,3e4c16f23d1a983da31670c6a9c6b8be,0,16,0,3,12,31
4166,1702,2022-10-15 16:13:00,814967c0236f02aeab0e697ad985babf,1,13,0,3,8,25
4167,1702,2022-10-15 16:17:00,4efaddce7138eea5b17e15d5471c8d07,0,17,1,3,11,32
4168,1702,2022-10-15 16:22:00,c933e2969d79ad35cd3c7a66ebf77508,3,16,0,7,5,31
4169,1702,2022-10-15 16:28:00,e5912bcdda22dda2fcf476a9bdc35649,1,14,0,3,10,28
4170,1702,2022-10-15 16:33:00,298fb59a61ac7868b1f24159e94e57ce,0,15,0,3,10,28
4171,1702,2022-10-15 16:38:00,36bc1721f7daef0593ef38658fd2a70c,0,13,0,4,13,30
4172,1702,2022-10-15 16:43:00,fd92b637b101f057ba926083d206c187,1,8,0,2,16,27
4173,1702,2022-10-15 16:48:00,22ff5db60a2839ec11763f996d4bd853,0,13,0,6,6,25
4174,1702,2022-10-15 16:53:00,435ad4d42760a298c789c00e47af1a6c,0,19,0,4,6,29
4175,1702,2022-10-15 16:58:00,89427a42aebedc026f0cc8dc5a73ee26,0,12,1,0,12,25
4176,1702,2022-10-15 17:03:00,2c8c75d4c2c900e235945b59c5833abe,0,17,1,2,7,27
4177,1702,2022-10-15 17:08:00,a93cace2b227f1fbc917b69404bdd65a,1,18,0,0,7,26
4178,1702,2022-10-15 17:13:00,7e75590350708ceb1e8e3528ea8176a6,1,18,1,2,3,25
4179,1702,2022-10-15 17:18:00,8e12973687aee97d348d758542aff56b,1,15,1,0,9,26
4180,1702,2022-10-15 17:23:00,fe1ae88eeefdcd9ad38a23c31307e301,0,14,0,1,17,32
4181,1702,2022-10-15 17:28:00,36d7f373fdb11574f4e2370393d0c6d2,0,13,1,4,10,28
4182,1702,2022-10-15 17:32:00,fdbde77a68c8a3d317ac33cfe56d3465,0,14,0,1,14,29
4183,1702,2022-10-15 17:38:00,cb1219392b356c265a6769a1b2266f90,0,17,0,1,17,35
4184,1702,2022-10-15 17:43:00,9472bca6545ddb959dce760927c44480,1,24,0,2,9,36
4185,1702,2022-10-15 17:48:00,186786247d31d13ed2cb468c675df83b,2,21,0,1,7,31
4186,1702,2022-10-15 17:53:00,2678d4fb50f3f8d6c820654345109a05,0,15,0,2,15,32
4187,1702,2022-10-15 17:57:00,675ab8fd32ac5ed26383a6ca9da207ca,0,26,0,2,7,35
4188,1702,2022-10-15 18:03:00,9d283444e3de9885944653d8c77af91c,0,15,1,1,10,27
4189,1702,2022-10-15 18:07:00,043ac984d068a5312da14e8c5f73d96c,0,13,0,3,7,23
4190,1702,2022-10-15 18:12:00,c84723a9d36d498b2cee695e4949fc61,0,23,0,2,10,35
4191,1702,2022-10-15 18:18:00,e62cc826c609570a83834463e17ff585,0,14,0,1,11,26
4192,1702,2022-10-15 18:23:00,a82b13963c7cfb8f529208ba75bd8ef3,0,22,0,2,9,33
4193,1702,2022-10-15 18:26:00,e8034bc02c0d36b781f1a504d9bfdc4a,0,15,0,7,9,31
4194,1702,2022-10-15 18:33:00,8bf46d2d2c921ffdf5df062f07257baf,0,13,0,4,10,27
4195,1702,2022-10-15 18:36:00,caeb9794209a015e300f9ae73ed264c3,1,11,2,3,18,35
4196,1702,2022-10-15 18:42:00,79ff98646b9ab671ae61705171574551,0,18,1,0,8,27
4197,1702,2022-10-15 18:47:00,a623a368ac9219f852c31e4e15d0c405,1,13,0,0,10,24
4198,1702,2022-10-15 18:53:00,1b629efac44defe777f082ae475a3eed,0,10,0,2,11,23
4199,1702,2022-10-15 18:57:00,3d67d401802fa53ae03878e628fe71b8,0,28,0,0,5,33
4200,1702,2022-10-15 19:02:00,b36c970acad974a376ebedc99c2520d1,0,27,1,0,5,33
4201,1702,2022-10-15 19:08:00,563252651470a378a6a48727397f6f26,0,17,2,3,1,23
4202,1702,2022-10-15 19:12:00,dd6373301ffa6d83881f9cb2725c1851,0,21,4,0,1,26
4203,1702,2022-10-15 19:18:00,d45b5b1ef03707df3366fcb77a997f16,0,27,0,0,0,27
4204,1702,2022-10-15 19:23:00,d3746bdfac1157e6c2ef52edcd51a3d0,0,20,1,1,0,22
4205,1702,2022-10-15 19:27:00,58cf5bfca57ce472502f669dd6a0cc67,0,23,1,2,0,26
4206,1702,2022-10-15 19:32:00,0cf0d3b23fa1d66a7856f58e78741ca5,0,22,0,1,0,23
4207,1702,2022-10-15 19:37:00,0778d822ababd0ed4648924680ccec23,0,25,1,0,0,26
4208,1702,2022-10-15 19:42:00,e3967d43d34f9f33913837c0b6a734ad,0,19,0,0,2,21
4209,1702,2022-10-15 19:47:00,03a88829358e876f92b51eb2e130366b,0,20,0,1,1,22
4210,1702,2022-10-15 19:52:00,2a75cc673d7045c4ed98f3913aa6311d,1,22,1,3,0,27
4211,1702,2022-10-15 19:58:00,afe8d1589aef1647ac5bef3e2ab500c6,0,23,0,1,5,29
4212,1702,2022-10-15 20:03:00,fe3adacf5f475bf8e65de04b27787e4e,0,23,1,1,0,25
4213,1702,2022-10-15 20:08:00,5944b69bcec3fc06f6376cdac779278a,0,20,0,1,1,22
4214,1702,2022-10-15 20:12:00,3ed4a29110e4833ec5b0b8c063480fae,0,16,0,1,1,18
4215,1702,2022-10-15 20:18:00,a4ac43615bf6b8453563636242a33447,0,20,1,0,0,21
4216,1702,2022-10-15 20:23:00,3813a3b9d5ec0b39d448a64f10fdad79,0,17,1,0,0,18
4217,1702,2022-10-15 20:27:00,9fe2ada3a8996225c387352e3ede4a8a,0,17,0,1,0,18
4218,1702,2022-10-15 20:32:00,3bb0b5563e69be859a684b389a3bdbb8,0,18,1,0,1,20
4219,1702,2022-10-15 20:37:00,f67790f5df639a9cb9785923fd114c20,0,14,0,1,0,15
4220,1702,2022-10-15 20:42:00,818f49c69b796ec90a81e1e869d8026c,0,21,0,2,1,24
4221,1702,2022-10-15 20:48:00,592e15feaefc1d913f16a24c7d11e530,0,23,1,0,0,24
4222,1702,2022-10-15 20:52:00,b5d079daa38ae6b7c5ea16380ac12bb8,0,16,0,0,1,17
4223,1702,2022-10-15 20:57:00,93ebb4f2ef1e9c714929e7718ec99c8f,0,17,0,1,1,19
4224,1702,2022-10-15 21:02:00,4d6ceddea6029550d09ceaff298274ec,0,23,1,0,1,25
4225,1702,2022-10-15 21:07:00,d392eb86469d3948f46cf655a7b12ebf,0,21,0,0,2,23
4226,1702,2022-10-15 21:12:00,d9c7928f513c8d2abfac65b3691a18f0,0,17,0,0,0,17
4227,1702,2022-10-15 21:18:00,8b3ee7605d3f64363097f306404a2a31,0,22,1,0,1,24
4228,1702,2022-10-15 21:23:00,1303fdfb311c294bc43343710fca048b,0,23,1,2,0,26
4229,1702,2022-10-15 21:27:00,16a9635fb5ac93302206f7182ba7db37,0,19,0,0,1,20
4230,1702,2022-10-15 21:33:00,0f1355d3108094f3c2a39750095d65e0,0,20,0,1,1,22
4231,1702,2022-10-15 21:38:00,0f7591b268c725c9360de89324a125fa,0,27,2,2,1,32
4232,1702,2022-10-15 21:42:00,ce8b3e7e04463950be81e0f5b2b2e2e8,0,18,2,0,0,20
4233,1702,2022-10-15 21:48:00,19522b931858295d3472bb9ea4d765b8,0,17,1,0,0,18
4234,1702,2022-10-15 21:52:00,88ea3ec26b17087f5065217d3ac6541c,0,18,1,0,0,19
4235,1702,2022-10-15 21:56:00,2b75de70eebda77d5f15853981613237,0,18,1,0,0,19
4236,1702,2022-10-15 22:03:00,f8afed54027c3d1cd2c575a183841b3b,0,16,0,0,1,17
4237,1702,2022-10-15 22:07:00,e56e688b1b9a94ce907423879320b418,0,21,0,0,0,21
4238,1702,2022-10-15 22:12:00,2091cb837c23c881c24fe8802f566188,0,15,2,0,0,17
4239,1702,2022-10-15 22:17:00,4113451de46c2d1c79975a0058b84fd4,0,15,0,0,2,17
4240,1702,2022-10-15 22:23:00,c187c8777e1ea57bb841ab847b8dbc8e,0,12,0,0,0,12
4241,1702,2022-10-15 22:27:00,beb2a41a080d9ea554de81792858b629,0,15,1,1,0,17
4242,1702,2022-10-15 22:32:00,e58765abe42f6a954c03128554463272,0,12,2,0,0,14
4243,1702,2022-10-15 22:36:00,08d99c00cde2a4e9b3cf56801ba723a2,0,14,1,0,0,15
4244,1702,2022-10-15 22:42:00,466cb6b6a166328f614d324c3999307f,0,20,5,0,0,25
4245,1702,2022-10-15 22:48:00,60a9fca506afe219dfa4d4b04ba4b77d,0,11,7,0,0,18
4246,1702,2022-10-15 22:53:00,f4da05536e55e981e66a1af16f6e7624,0,15,1,0,0,16
4247,1702,2022-10-15 22:57:00,53f4c3c05ec479e5dc9b48c57b09cceb,0,13,0,0,1,14
4248,1702,2022-10-15 23:02:00,627b8908795c2743fd096aa24735e6c4,0,15,0,0,0,15
4249,1702,2022-10-15 23:08:00,a50f2184d12a75674f506b6f60aad38c,0,11,2,0,0,13
4250,1702,2022-10-15 23:12:00,b14cac608228b4731f673b326409848a,0,15,1,0,2,18
4251,1702,2022-10-15 23:18:00,de32baf255bc276334185247b0af4211,0,12,0,0,0,12
4252,1702,2022-10-15 23:22:00,05fd0039f69bdd66db8b784952e47465,0,4,1,0,1,6
4253,1702,2022-10-15 23:27:00,6c309bf73a071ff343808bb741aca256,0,12,1,1,0,14
4254,1702,2022-10-15 23:32:00,8fff9a48e2b599c7cf5fba0c1b2314bd,0,12,0,0,0,12
4255,1702,2022-10-15 23:37:00,c05fb58bcf5690718052a2b4f3d665ca,0,8,3,0,0,11
4256,1702,2022-10-15 23:43:00,6d5ed0d4ef09d4ea41c3e8130f340bb1,0,7,0,0,0,7
4257,1702,2022-10-15 23:47:00,3698ea5e904cf163bddc54af2b0d4896,1,7,1,0,0,9
4258,1702,2022-10-15 23:52:00,ef97e1967b644544890eef820ea9bfb7,0,5,0,0,0,5
4259,1702,2022-10-15 23:56:00,42726d81d83d625dcce11b9fa2fcc5bd,0,10,1,0,0,11
4260,1702,2022-10-16 00:02:00,5b16e27aeae01434716c52c8febe030a,0,5,0,0,0,5
4261,1702,2022-10-16 00:07:00,68eb8fb7585ab57047110cd7e943302f,0,10,0,0,0,10
4262,1702,2022-10-16 00:11:00,264dbf0ddecff5b223774d63b972db10,0,13,0,0,1,14
4263,1702,2022-10-16 00:17:00,23ddd7d8a1fab4ed57a5d9906f0a244e,0,15,0,0,1,16
4264,1702,2022-10-16 00:22:00,79613cf2d66019117c6a9c352204c279,0,10,0,0,0,10
4265,1702,2022-10-16 00:26:00,7e35b5a8f84039ddecd8eeecd1fbbe80,0,4,4,0,0,8
4266,1702,2022-10-16 00:33:00,293a31d514ffc4150552651c8bb34e66,0,12,0,1,0,13
4267,1702,2022-10-16 00:36:00,7065b01b917bf4647cbcd3ac9506c4ab,0,7,0,0,0,7
4268,1702,2022-10-16 00:41:00,e9d3a1404e384f9b29e6f1fc1f19c1c5,0,7,0,1,0,8
4269,1702,2022-10-16 00:47:00,66848d4ef692bf458ab5c965f4020050,0,0,2,0,0,2
4270,1702,2022-10-16 00:51:00,9cc0ca61a86cead40434ba62bd43641c,0,9,0,0,1,10
4271,1702,2022-10-16 00:56:00,a28e16279b3f749859946d94afcb01cc,0,2,0,0,0,2
4272,1702,2022-10-16 01:02:00,288428260f3a2a603a2c8716cd50afef,0,6,0,0,0,6
4273,1702,2022-10-16 01:07:00,ac601c3b544b3b3d746b29aa5086162e,0,11,0,0,0,11
4274,1702,2022-10-16 01:11:00,82249d47acdd3d797140be1ae6a15717,0,7,0,0,0,7
4275,1702,2022-10-16 01:17:00,68226b3b9a719c377f3e7d83bd3ff3ef,0,2,3,0,1,6
4276,1702,2022-10-16 01:22:00,48b41cf6fe66b477efdaec157beece47,0,4,6,0,0,10
4277,1702,2022-10-16 01:27:00,d58be605548987fc21b5a34e2a8f3c3e,0,3,1,1,1,6
4278,1702,2022-10-16 01:32:00,bedb8ce2e7c097af59a730a963a6758a,0,7,0,0,0,7
4279,1702,2022-10-16 01:37:00,2cd0e9d128ef5060d48acf173e7f0fab,0,6,0,0,0,6
4280,1702,2022-10-16 01:41:00,0947f7ab840d5de05ad6d81abb2acc40,0,6,0,0,0,6
4281,1702,2022-10-16 01:47:00,ac373f6d5417aaab8f369e5ec1645f9f,0,8,0,0,0,8
4282,1702,2022-10-16 01:52:00,1826edcc13c00e75d0e9e36557bf6c94,0,12,0,0,0,12
4283,1702,2022-10-16 01:57:00,e347559dd4e8951df7aa18c6e9dc1a4b,0,6,1,0,0,7
4284,1702,2022-10-16 02:01:00,e96341f4ad2ef6ac6882f438973fc1d8,0,11,0,0,0,11
4285,1702,2022-10-16 02:11:00,f6fb79285dadb46974e961dee1acb7e1,0,6,0,0,0,6
4286,1702,2022-10-16 02:17:00,f389aea5f1ca0cfdddbbbb7923e9236b,0,5,1,0,0,6
4287,1702,2022-10-16 02:22:00,b0ddaf52e361adaf7b1e7152f5d3aec4,0,8,0,0,1,9
4288,1702,2022-10-16 02:26:00,f44caa7e0052fd7c1c9d4a849b127314,0,10,1,0,1,12
4289,1702,2022-10-16 02:31:00,bd7193edb4bc225408d8e48c44509e66,0,2,0,0,0,2
4290,1702,2022-10-16 02:37:00,88aa530fcc8697a95abbd535c41e9c4d,0,0,0,0,0,0
4291,1702,2022-10-16 02:41:00,586ea83d02bce7aff9f8f1a3fb89c4f4,0,0,0,0,0,0
4292,1702,2022-10-16 02:47:00,8d077dbdd0a86d5826d012e0522232c0,0,1,0,1,0,2
4293,1702,2022-10-16 02:51:00,1e6c30877d84f14f84098c5faa719eb2,0,4,0,0,0,4
4294,1702,2022-10-16 02:56:00,6d8432e6253c6457508f42bcb7119523,0,2,0,0,0,2
4295,1702,2022-10-16 03:01:00,10c8f79046f49e1cebdf7f426992d1db,0,1,0,1,0,2
4296,1702,2022-10-16 03:06:00,5598b14f35476498851e7fabca4ffa91,0,0,0,0,0,0
4297,1702,2022-10-16 03:11:00,31c035f4124512f0e0ae9554fb952c9c,0,1,0,0,0,1
4298,1702,2022-10-16 03:17:00,5001180fe08504783a15af0048f72681,0,3,0,0,0,3
4299,1702,2022-10-16 03:22:00,951de5735a70e1b8e29e9f7b76c9b3a4,0,2,0,0,1,3
4300,1702,2022-10-16 03:28:00,14631f363bf308e8f0816ba413b2d726,0,1,0,0,0,1
4301,1702,2022-10-16 03:32:00,45fefca66485f96669962bef04a17609,0,2,0,0,0,2
4302,1702,2022-10-16 03:38:00,3e94643e5924fde0ad9a151a6781d8f3,0,0,0,0,0,0
4303,1702,2022-10-16 03:43:00,f2b2e4cd668c2fc922bd98c89b7b8c07,0,0,0,0,0,0
4304,1702,2022-10-16 03:48:00,5b44d67d9396218d071341f85958e3af,0,6,0,0,0,6
4305,1702,2022-10-16 03:52:00,83d4516278f2cd0fd6392ce4822cc927,0,3,0,0,0,3
4306,1702,2022-10-16 03:56:00,6ce4962c6aad6c6a853c7123c3e9bff6,0,1,0,0,0,1
4307,1702,2022-10-16 04:01:00,74e7093159050e238a815d3cfec0f908,0,1,0,0,0,1
4308,1702,2022-10-16 04:08:00,d5f6844977474e3821839dbb585f3a68,0,0,0,0,0,0
4309,1702,2022-10-16 04:12:00,61c608835221940780cd5344eb6fbfa7,0,0,0,0,0,0
4310,1702,2022-10-16 04:18:00,85e7dac73f6746300302d25907b4b687,0,5,0,0,0,5
4311,1702,2022-10-16 04:22:00,cc0f90021bf86f821442b418acd80417,0,3,0,0,0,3
4312,1702,2022-10-16 04:28:00,bef81e68385d8d410b6a6791b96b99e8,0,0,0,1,1,2
4313,1702,2022-10-16 04:33:00,fb4ba83da0a0ac1a0e3a1ef520485dee,0,1,0,0,0,1
4314,1702,2022-10-16 04:38:00,461641a9c290d8a65ba55eb578098e56,0,1,0,0,0,1
4315,1702,2022-10-16 04:42:00,a4076c229051b7251aeb58a6a3448fd6,0,2,0,0,0,2
4316,1702,2022-10-16 04:48:00,63c688d168ff1d8f37c6c82102c9a911,0,2,0,0,0,2
4317,1702,2022-10-16 04:52:00,518e6110e81cd3b78775ef4e46cbfec8,0,1,0,0,0,1
4318,1702,2022-10-16 04:57:00,71813b21bca6435e2369ea422127ec6a,0,1,0,0,0,1
4319,1702,2022-10-16 05:02:00,6a7fad0db072e7fa4f2116813837b1b1,0,1,0,0,0,1
4320,1702,2022-10-16 05:07:00,ade8d5883c84d81bcf4005123bbdf649,0,0,0,0,0,0
4321,1702,2022-10-16 05:12:00,b444b57074465a32d1a50c84fb8c306a,0,0,0,0,0,0
4322,1702,2022-10-16 05:18:00,b254893c3c187a193b7bad80015693ec,0,1,0,2,0,3
4323,1702,2022-10-16 05:22:00,bb605e219539e695a97fabeb4df979ee,0,0,0,0,0,0
4324,1702,2022-10-16 05:28:00,e2ce2a88e0f55a0295e3fe624f89a2e5,0,0,0,0,0,0
4325,1702,2022-10-16 05:33:00,907e2eb4d25956a13aa242c4e65afb66,0,2,0,0,0,2
4326,1702,2022-10-16 05:37:00,38a881667b8f5f1d13a01a8b7b35da8d,0,2,0,0,0,2
4327,1702,2022-10-16 05:42:00,c940c2491d896c45aecf361e82cd9159,0,0,0,0,0,0
4328,1702,2022-10-16 05:48:00,58b2efe46d55e19a6b983645f3c46c9d,0,2,0,0,0,2
4329,1702,2022-10-16 05:52:00,e715b4f36ce70b6af6f62bceddb2211c,0,1,0,0,0,1
4330,1702,2022-10-16 05:57:00,5b778516523bc2079cbdbfd396cd8e83,0,1,0,0,0,1
4331,1702,2022-10-16 06:03:00,a2f715f411370cde9592669ab03c0fdd,0,0,0,0,0,0
4332,1702,2022-10-16 06:08:00,868ce373a49c5f6ba1a95da721501b4d,0,0,0,0,0,0
4333,1702,2022-10-16 06:12:00,fb47fe6f73c5e0482f17423ffaf232c3,0,6,0,0,0,6
4334,1702,2022-10-16 06:17:00,3e6f6c5a66c05accccf65fb9f32e6f8d,0,0,0,0,0,0
4335,1702,2022-10-16 06:22:00,c7ab174d6e1b01973497450e4334c623,0,1,0,0,0,1
4336,1702,2022-10-16 06:27:00,8cfe9782164bd21f4ff563b7a7abfaf2,0,3,0,3,0,6
4337,1702,2022-10-16 06:33:00,e0c9ba026e827e088191ceae2005b9d2,0,7,0,1,1,9
4338,1702,2022-10-16 06:38:00,3b6b430e4bce4ff7c0cd0ff981e354c0,0,2,0,0,0,2
4339,1702,2022-10-16 06:43:00,1f07cebe9b23e7eff58e5cbd9a980414,0,2,0,1,0,3
4340,1702,2022-10-16 06:48:00,c8681c37ce2e6197af3ceac9173eaa88,0,1,0,0,0,1
4341,1702,2022-10-16 06:51:00,8e6a2765b2ab03e5f57659d80fdb7222,0,2,0,0,0,2
4342,1702,2022-10-16 06:57:00,b3b6fb479e4a3fa83a86ebf68067bf1a,0,5,0,0,0,5
4343,1702,2022-10-16 07:03:00,5488fa2da32fe5be5a3d0fa8aecf3fd0,0,9,0,0,0,9
4344,1702,2022-10-16 07:07:00,d5379f5c645e6d9f6bceab0161d45121,0,1,0,0,1,2
4345,1702,2022-10-16 07:12:00,509ac737fb38857abb2ac1af260c91b6,0,6,0,0,0,6
4346,1702,2022-10-16 07:19:00,2497dc400d4f5d5bcad267d396a62f20,0,2,0,0,0,2
4347,1702,2022-10-16 07:22:00,30f79f82902c4636d8c4b56b59a05a13,0,2,0,1,0,3
4348,1702,2022-10-16 07:26:00,4e173d349909dd6eba2bfee27b14e32e,0,1,0,2,0,3
4349,1702,2022-10-16 07:32:00,00170e17ae613175d1db84c7253c27d0,1,9,0,1,1,12
4350,1702,2022-10-16 07:38:00,da6fdf7085fe528aaf132ca409b30ceb,0,4,0,0,1,5
4351,1702,2022-10-16 07:42:00,9e34c32e3f90e417303675b9bf9bc23d,0,4,0,0,2,6
4352,1702,2022-10-16 07:48:00,4a0435385e94f225f745d00e9ff22f1a,0,8,0,2,2,12
4353,1702,2022-10-16 07:52:00,56040e73235f4af9a316821643c95f73,0,9,0,1,3,13
4354,1702,2022-10-16 07:57:00,4fbce6137b04f8dcc9eb9f1075ee2874,0,16,0,0,1,17
4355,1702,2022-10-16 08:02:00,db8c9d510fd67b0944b9ebb6d249bd9c,1,11,0,0,1,13
4356,1702,2022-10-16 08:07:00,16e168cf8538870e0e5557b1f09ae13d,0,9,0,1,1,11
4357,1702,2022-10-16 08:12:00,81df04eaf67ba2f80468ffe9f490d229,1,7,0,3,1,12
4358,1702,2022-10-16 08:18:00,a6a5256250ebcaa519eeee46378ba267,0,14,0,2,1,17
4359,1702,2022-10-16 08:23:00,bc9d7e949d2617bbf9a68ba9de883cc4,0,12,0,3,1,16
4360,1702,2022-10-16 08:28:00,5337319cf20edc3b24725d155d6f04d9,0,8,0,0,3,11
4361,1702,2022-10-16 08:32:00,75e2a153fc8a0d20d0befafd5f151e03,0,3,0,2,1,6
4362,1702,2022-10-16 08:37:00,e1e07eca25b1019a12afd837d2892f0e,1,16,0,3,4,24
4363,1702,2022-10-16 08:42:00,3992145fc130b918e1b5cde961bef53f,0,13,0,0,5,18
4364,1702,2022-10-16 08:48:00,0c62954630ee23c5386693649c7a8419,0,14,0,1,6,21
4365,1702,2022-10-16 08:53:00,7660f535b86c222565469bfc6bb7edf0,0,15,1,0,6,22
4366,1702,2022-10-16 08:57:00,99ccf6977524ec987030ddee70ae679c,0,17,0,1,2,20
4367,1702,2022-10-16 09:03:00,2d84f3c4113036126cac16a370def335,0,17,0,0,2,19
4368,1702,2022-10-16 09:08:00,b84606bb126cfff0d7acc729e11651a9,2,20,0,0,4,26
4369,1702,2022-10-16 09:13:00,5ab762a3195e861d7b15d72cca7bb1ae,0,15,0,2,4,21
4370,1702,2022-10-16 09:17:00,86cf144fe41fcd3094767ab12df8c651,0,12,0,0,4,16
4371,1702,2022-10-16 09:23:00,0e948954f810a27f2b8e6e9701642ffb,1,14,0,0,7,22
4372,1702,2022-10-16 09:28:00,5d28268944855851e84ce64dfb959e44,0,11,0,2,4,17
4373,1702,2022-10-16 09:32:00,e63c99890e6fba49015ea0581ee1a6a6,0,19,0,1,5,25
4374,1702,2022-10-16 09:38:00,1c87fc10b594afe097dfff6b6d5582f2,1,15,1,2,3,22
4375,1702,2022-10-16 09:42:00,b6c749d6e1a725130575ada4fdcc9d49,0,23,0,0,4,27
4376,1702,2022-10-16 09:47:00,6ed3d23f5352dc4886835a60f4cc9525,0,10,0,0,10,20
4377,1702,2022-10-16 09:53:00,c88c7c7ad6431e39bee1598bedb0af72,0,13,0,0,10,23
4378,1702,2022-10-16 09:57:00,6081514f5a45d1396bad0a7ff5430063,0,9,0,3,5,17
4379,1702,2022-10-16 10:03:00,d6860dbd04822b3709ce2b64659017e3,1,23,0,2,1,27
4380,1702,2022-10-16 10:09:00,d8ffe6015a303b01be03cf3e6a38a7ee,0,18,0,1,7,26
4381,1702,2022-10-16 10:13:00,17e9768a537cfeb064c2cb56f286188e,0,14,1,1,10,26
4382,1702,2022-10-16 10:18:00,26c195b10388a7a699a156f82d8af617,0,10,1,0,8,19
4383,1702,2022-10-16 10:22:00,06d82b2c97e0802f4de936ae827e023d,0,11,0,0,11,22
4384,1702,2022-10-16 10:28:00,aa426c68fc5a1a17eab39401a0025d15,0,15,1,1,8,25
4385,1702,2022-10-16 10:34:00,bf667fd7a42e1a1913588b5e9660c53f,0,18,0,1,5,24
4386,1702,2022-10-16 10:39:00,8284618fc63e79b931eb6dbf1ba42bff,0,10,0,0,11,21
4387,1702,2022-10-16 10:42:00,d97321829a35321908991659eb93cfdf,2,14,1,0,7,24
4388,1702,2022-10-16 10:48:00,7feb4e0eb65a31836259009bb6832eff,1,15,0,1,10,27
4389,1702,2022-10-16 10:53:00,d3d27746c77564312b6bf4214392cc3f,1,14,0,3,6,24
4390,1702,2022-10-16 10:57:00,99c3c53278d8ad4d3ac725ce2a8ade92,0,17,0,0,7,24
4391,1702,2022-10-16 11:04:00,60eab87873b73a5fce7ff7bc84616de8,0,14,0,3,7,24
4392,1702,2022-10-16 11:07:00,977ef544fb7ba43a5026788d3e7b84b8,0,15,0,0,6,21
4393,1702,2022-10-16 11:13:00,05255e228b6bf5b95f4f5c241d1559eb,1,9,0,3,9,22
4394,1702,2022-10-16 11:19:00,935c977224fb6b03577a838949a082bb,0,11,0,1,9,21
4395,1702,2022-10-16 11:23:00,6d304cff278fc3885e9164a9b9310df9,0,18,2,3,6,29
4396,1702,2022-10-16 11:28:00,24e73a99abc2adb1c5479fe56007bfdd,0,23,0,2,4,29
4397,1702,2022-10-16 11:33:00,001c9f332fb21a1f802c1ef123a56fb2,0,17,0,4,13,34
4398,1702,2022-10-16 11:37:00,4dc67c043c42d56d61a5cac2e8c787da,0,18,0,4,7,29
4399,1702,2022-10-16 11:43:00,77a5ed413f451c04c3d9d418b8dbacb4,0,15,0,9,9,33
4400,1702,2022-10-16 11:48:00,1774024fd24e326033f5291958a713ea,0,16,0,2,14,32
4401,1702,2022-10-16 11:52:00,599b733b6cc0a7e35e2f3cda28ee0e6e,0,15,0,6,8,29
4402,1702,2022-10-16 11:57:00,275f0f37ff2173ecb5a663328649e86a,0,11,0,3,12,26
4403,1702,2022-10-16 12:03:00,0ad5258323ed0b11942c9373d38869d6,0,11,0,1,15,27
4404,1702,2022-10-16 12:09:00,d45015531835bc57c22b20b31c22afe7,0,20,0,2,10,32
4405,1702,2022-10-16 12:13:00,6245a45c01f512df3d753b81ab5db6c1,0,13,0,2,10,25
4406,1702,2022-10-16 12:18:00,894788a3de99db176534406767272246,3,18,0,2,11,34
4407,1702,2022-10-16 12:24:00,219e0896f26471b5b971d251326ef51c,1,15,0,5,11,32
4408,1702,2022-10-16 12:29:00,c58f128533daab2610eaafd4df42380d,0,15,0,1,10,26
4409,1702,2022-10-16 12:34:00,0bb7915a5109a72731de2987118e5632,0,11,0,4,10,25
4410,1702,2022-10-16 12:38:00,99f468999d83432b00176568115f95c2,0,18,1,2,4,25
4411,1702,2022-10-16 12:43:00,239feb75d1ba2d0f8e37cfc87ec266f7,0,10,0,1,7,18
4412,1702,2022-10-16 12:48:00,c44640b1e6674d0645c73d12e6a1d592,0,14,0,3,9,26
4413,1702,2022-10-16 12:53:00,78ff23ecff8e7a7189304fd7024928a9,0,12,0,2,9,23
4414,1702,2022-10-16 12:57:00,04aa219b39cafb5148ef21d92d6ad94c,0,14,1,3,11,29
4415,1702,2022-10-16 13:04:00,edfdaf3ee9d6d66065b11120887952bd,0,17,0,1,8,26
4416,1702,2022-10-16 13:08:00,fd22fc53d7f975c4b2c06353097b09a9,0,19,1,1,1,22
4417,1702,2022-10-16 13:12:00,3fe66d51de294dc666cece95542287e2,0,24,0,0,8,32
4418,1702,2022-10-16 13:19:00,0ebfee58ceacfb744da57a3217ed840a,0,21,0,2,7,30
4419,1702,2022-10-16 13:23:00,ff5a04f6cf526355cc9a9f47b4421642,0,19,0,1,4,24
4420,1702,2022-10-16 13:28:00,b493afc18d04cdfd08aba77f194a2bea,0,17,0,0,5,22
4421,1702,2022-10-16 13:33:00,1191bbd70d5ffd6dacddb8d87efdc8f3,0,16,0,2,4,22
4422,1702,2022-10-16 13:38:00,f758e2a722e674204053e00eb8406f5e,0,10,0,1,10,21
4423,1702,2022-10-16 13:42:00,20465b0e3e4ccf8f57ab260a1af61015,1,14,0,0,8,23
4424,1702,2022-10-16 13:47:00,20a79564057914f292e2b6bee252a75d,1,10,1,1,6,19
4425,1702,2022-10-16 13:53:00,c9a3954de94fb84b2b8ba208be736b98,0,19,0,1,9,29
4426,1702,2022-10-16 13:59:00,fe4443296eda474d8ec1c0e59fbd9981,0,14,0,1,10,25
4427,1702,2022-10-16 14:03:00,9971769d4032e934e0d0ff095808525c,0,21,0,5,8,34
4428,1702,2022-10-16 14:09:00,c3621cbb5c2413a1cbea4d1b07da6262,0,13,0,2,12,27
4429,1702,2022-10-16 14:12:00,3a2e4ee82ed52871197a7289740f34fb,0,13,0,1,8,22
4430,1702,2022-10-16 14:18:00,0a60e53f08e95d3bfbeca4a495db8ad0,0,11,0,2,7,20
4431,1702,2022-10-16 14:23:00,b48f20fc83c6b0faaf13e0f8b38a5941,0,16,0,5,3,24
4432,1702,2022-10-16 14:28:00,1e0ac9aef10ea925b0f3b27f501fb9b4,0,24,0,0,3,27
4433,1702,2022-10-16 14:34:00,78862a259a676fd17fd496bcc874e9f3,0,14,0,1,3,18
4434,1702,2022-10-16 14:38:00,2def7ea336975ee0843275046e712e55,0,17,0,5,8,30
4435,1702,2022-10-16 14:42:00,643c2cbb4feb3e232eee6e2b553448e7,0,15,0,2,4,21
4436,1702,2022-10-16 14:48:00,846bea94dab02f6b59f5e669cdfa8f5d,1,15,0,3,12,31
4437,1702,2022-10-16 14:53:00,243c9dbb46a6f0b367cc9e30f8ba1ea2,0,14,0,2,8,24
4438,1702,2022-10-16 14:58:00,19945106417ffcac386309d86322ffc0,0,10,0,2,11,23
4439,1702,2022-10-16 15:03:00,8def4871e596d7e8bd1e754cdc6ce0a1,0,16,0,0,6,22
4440,1702,2022-10-16 15:09:00,95b64b85b3802ffe12f342a1c347cf6c,0,14,0,4,4,22
4441,1702,2022-10-16 15:13:00,ca5437ef51033ca873d844c8c4d6b656,0,19,0,0,12,31
4442,1702,2022-10-16 15:18:00,5734173ad6e8845d77ae6976db61585c,0,14,0,1,7,22
4443,1702,2022-10-16 15:23:00,2757bd706ac4b0706d3c545e54814088,0,14,0,0,13,27
4444,1702,2022-10-16 15:27:00,66a870af5d630577e453a3e5dec132cf,0,9,1,0,12,22
4445,1702,2022-10-16 15:32:00,5eb0b6a415b68db6de3e6be8787d3f3d,0,15,1,3,5,24
4446,1702,2022-10-16 15:38:00,750d16308dbedab616e28ea353bdd830,0,14,1,0,8,23
4447,1702,2022-10-16 15:42:00,104b9a23fd8000dae588de8971c7dd5a,1,14,0,2,10,27
4448,1702,2022-10-16 15:47:00,bbcdf8b6c38f7fffd9a527e58f8c08f8,0,11,2,1,9,23
4449,1702,2022-10-16 15:53:00,dae1e03a12fe40ea3a52eeafcbf3a01d,0,11,0,2,9,22
4450,1702,2022-10-16 15:58:00,90bf2921725fb1cdca454b332108b850,0,14,0,0,5,19
4451,1702,2022-10-16 16:03:00,c1602b6faffafdb2d7d2d7ebb1dad10b,0,18,0,2,5,25
4452,1702,2022-10-16 16:07:00,d0f22368b398d88fcb04158d451fe0df,0,15,0,0,9,24
4453,1702,2022-10-16 16:13:00,e48abef146a2c60f46effac81e4c7cc5,0,15,0,1,6,22
4454,1702,2022-10-16 16:18:00,c456b324c12ab2778f21a833c207554a,0,14,1,0,6,21
4455,1702,2022-10-16 16:23:00,c43e6e0b97f893343d381232f0b476b2,0,11,1,1,11,24
4456,1702,2022-10-16 16:28:00,9710a0716b36a86367ac4dc748831722,0,12,0,0,9,21
4457,1702,2022-10-16 16:33:00,f90b940e923e747d6378ab00ac2a0638,0,17,1,2,7,27
4458,1702,2022-10-16 16:37:00,1fd3e960c9909f3b76c28b2ad139c6b6,0,18,0,0,10,28
4459,1702,2022-10-16 16:43:00,e3cb6d55dbd4fb4f7cbcc838cc4bf53d,0,16,0,2,4,22
4460,1702,2022-10-16 16:48:00,e6a7c60a7f497d8ff65e6e0f1fdbdc05,0,17,0,2,10,29
4461,1702,2022-10-16 16:53:00,cf19fcbd73313103c16853383ed0b54d,2,18,1,0,5,26
4462,1702,2022-10-16 16:57:00,aba828b84a931418f8cc946c7637865f,1,16,1,0,8,26
4463,1702,2022-10-16 17:03:00,5ddc380bb190223bd8fb057f39f0f61c,1,18,0,1,7,27
4464,1702,2022-10-16 17:08:00,4f6462b8b9ea0f21ed8bef8346f0f8a7,0,12,0,1,14,27
4465,1702,2022-10-16 17:12:00,deae22946580e92831d4da60346215a8,0,19,1,1,6,27
4466,1702,2022-10-16 17:19:00,2579ab771524df867693cd57a993aab7,0,16,0,0,5,21
4467,1702,2022-10-16 17:23:00,613577441e539cd672e7245996a20d34,0,12,0,0,12,24
4468,1702,2022-10-16 17:27:00,4fcdcb2b3b5e37a672b7dfaec8aeb1ee,0,17,0,5,5,27
4469,1702,2022-10-16 17:34:00,7551fa33afd60c85fd374c3c712d78af,0,14,0,3,14,31
4470,1702,2022-10-16 17:37:00,3a902931568e286fb5d5deaae0ff36ce,0,16,0,2,17,35
4471,1702,2022-10-16 17:42:00,1331ada2e8401475831ba9201cde5ae9,1,16,1,1,8,27
4472,1702,2022-10-16 17:49:00,3ed02d5f4281d45bfb309b05fb7aea69,0,19,2,2,12,35
4473,1702,2022-10-16 17:52:00,04be37e9e90221ff2c9e08bea1f95e1b,0,16,0,2,9,27
4474,1702,2022-10-16 17:57:00,4f3d27dfe1df83e878e4cf93e7b426de,0,16,0,2,11,29
4475,1702,2022-10-16 18:03:00,b2748a691807e381e78afa6f8d28cb50,0,17,0,1,9,27
4476,1702,2022-10-16 18:07:00,d93820fcfb677851d9f67f8f5d9c8f30,0,21,1,2,5,29
4477,1702,2022-10-16 18:12:00,c21610a8bb7f5f7c39e668967f662122,0,13,0,0,8,21
4478,1702,2022-10-16 18:17:00,7174a4e271a3df657ed219275c1dd3bc,4,13,0,0,6,23
4479,1702,2022-10-16 18:23:00,3670d66ad5cc6eccc1d8fb7feb3a12ff,0,17,0,1,7,25
4480,1702,2022-10-16 18:27:00,618df43faec45de5615ab5868561b68d,0,17,0,3,11,31
4481,1702,2022-10-16 18:33:00,7315c10ce33177d08a4e0db7cac3e0da,1,14,0,2,8,25
4482,1702,2022-10-16 18:37:00,0abbcb799ce425b8858b46d6cdffbb24,1,16,0,2,2,21
4483,1702,2022-10-16 18:43:00,fdb32dedd6de2a866b3a473f31f2c3fc,0,20,0,1,4,25
4484,1702,2022-10-16 18:47:00,34bb31722a3dd3132e804573c34f76d6,0,18,0,1,7,26
4485,1702,2022-10-16 18:52:00,b2ac07cb50c386aa5b22b82bb6fb9c7b,1,22,0,1,3,27
4486,1702,2022-10-16 18:57:00,8fa9e828b97f3a75147a0f4856baf071,0,21,1,0,4,26
4487,1702,2022-10-16 19:02:00,61451e3463740b7b4a21c3a627054e04,0,11,0,1,4,16
4488,1702,2022-10-16 19:07:00,1df967a7c20fb413221406cfa91e22b3,0,23,1,2,1,27
4489,1702,2022-10-16 19:12:00,fdca17507d50c79402f558f336c8995a,0,18,0,0,2,20
4490,1702,2022-10-16 19:17:00,c2deca508f338e90d1277988bca73d94,0,20,0,2,1,23
4491,1702,2022-10-16 19:22:00,852cc7e90161faff31d138c711d7eeaf,0,17,1,0,1,19
4492,1702,2022-10-16 19:27:00,9524cd5388caf28489f96c403c184df3,0,20,0,0,0,20
4493,1702,2022-10-16 19:32:00,2c36ec362d5414e7732c444ac82c4335,0,17,0,0,0,17
4494,1702,2022-10-16 19:36:00,ee5eed2c696f1d8c914be83c8435a4e7,0,18,0,1,2,21
4495,1702,2022-10-16 19:41:00,4b2345f49c3f42b46fb74cc912e4094d,0,17,1,1,0,19
4496,1702,2022-10-16 19:48:00,fc509d739cd771405127b2a618c1fbdb,1,21,1,0,0,23
4497,1702,2022-10-16 19:53:00,54d2aae6f484ead1ae863fe59db042ce,0,12,0,0,0,12
4498,1702,2022-10-16 19:56:00,2bafe61bba29b57a3aaa39a397ee58cb,0,9,2,1,2,14
4499,1702,2022-10-16 20:02:00,10a07e88c1ae8681ae1384f1dec776fd,0,21,0,2,0,23
4500,1702,2022-10-16 20:07:00,12a4432d86b662ccfaca24114655fbe5,0,20,0,0,0,20
4501,1702,2022-10-16 20:12:00,3ed65ce6d15a42e6314caead9a2d8ab2,0,13,1,0,0,14
4502,1702,2022-10-16 20:16:00,9f1ddcf6c0b8751ca6065f8dd1ef144a,0,11,0,0,2,13
4503,1702,2022-10-16 20:21:00,432d65f128f05c8d31b1ff66be40ffa5,0,23,0,1,1,25
4504,1702,2022-10-16 20:27:00,9bd2a50a7f9ce77888f61491afa30bf3,0,21,0,0,1,22
4505,1702,2022-10-16 20:31:00,875e5b828a5073b94afe1603c4f15587,0,13,0,0,0,13
4506,1702,2022-10-16 20:37:00,d030846a2b2e27af1e9cb8a51644db42,0,13,0,2,0,15
4507,1702,2022-10-16 20:41:00,acc840e4cca990df1af51e0a3a7cbeba,0,13,3,0,2,18
4508,1702,2022-10-16 20:47:00,85a569cd159394d0bbc6aa155ec54720,0,16,0,0,1,17
4509,1702,2022-10-16 20:51:00,75b094275227d36b1e1814a6bc633f01,0,21,2,1,1,25
4510,1702,2022-10-16 20:57:00,0bea6474e285b140878fd53769ba244e,0,16,4,0,2,22
4511,1702,2022-10-16 21:03:00,23ed2e03a8e92e25fce346bb6ca571d6,0,15,0,0,1,16
4512,1702,2022-10-16 21:07:00,accac35200d02b948e32e805281a5c06,0,19,0,0,0,19
4513,1702,2022-10-16 21:12:00,1277603908bd6170ced3f6cc87c67858,0,21,0,0,0,21
4514,1702,2022-10-16 21:17:00,de2f8265afbbaa9355dbbdfe62c0b608,0,11,0,0,2,13
4515,1702,2022-10-16 21:21:00,12e9be9b3a0dc779b3bc6365ffad1b1d,0,15,0,0,1,16
4516,1702,2022-10-16 21:28:00,298dc3bc782171e5e70832515aa16ae2,0,15,2,1,0,18
4517,1702,2022-10-16 21:32:00,265d5868a53068beebe65aa38f424a67,0,15,0,0,0,15
4518,1702,2022-10-16 21:38:00,906198e7778305444b8eb6b33f7edc21,0,14,0,0,0,14
4519,1702,2022-10-16 21:42:00,e1d03370f1160cdf5da189baf29c011a,0,15,0,0,2,17
4520,1702,2022-10-16 21:47:00,8e5bb3686f0a2f4d4ff8d20c172f2b2f,0,13,1,1,0,15
4521,1702,2022-10-16 21:52:00,c7b45aafa4c8252a2fa5da9335da1255,0,16,0,1,2,19
4522,1702,2022-10-16 21:57:00,28d72653349540b83c30d6dce6ad2641,0,16,0,0,2,18
4523,1702,2022-10-16 22:02:00,42d6c7cbe4b5c6de8969915e76a98d07,0,21,0,1,1,23
4524,1702,2022-10-16 22:07:00,2ff26ddaa1b98ad8e4e11b2e9e0f8e0a,0,7,0,1,1,9
4525,1702,2022-10-16 22:12:00,e2257f4a04330c72f5aeee8da4eb439d,0,15,0,0,1,16
4526,1702,2022-10-16 22:17:00,5f05f45a33ef39e54ece12040f8ef0ad,0,7,0,0,1,8
4527,1702,2022-10-16 22:21:00,ce2079a38181d3d9d438b59424b36ced,0,19,1,0,1,21
4528,1702,2022-10-16 22:26:00,8f9c2bf916da8e1ffae8b5a9d535f78e,0,14,0,1,0,15
4529,1702,2022-10-16 22:32:00,e43a443865ac94e5d714a3fb71c2e2e6,0,15,0,0,0,15
4530,1702,2022-10-16 22:36:00,c384433bc5207f45b8ae7545913bbbf1,0,16,0,1,1,18
4531,1702,2022-10-16 22:42:00,463cb4424a77ac16c3918e55b393d1b4,1,10,1,1,0,13
4532,1702,2022-10-16 22:47:00,f9b76ed9068a0564f5578a1d94761271,0,2,0,1,0,3
4533,1702,2022-10-16 22:52:00,325eee4e9c5aaa7c14fc4882c261159c,0,12,1,0,0,13
4534,1702,2022-10-16 22:57:00,bd1400efbdc762213a84c4acc8bd9cbe,0,8,0,0,1,9
4535,1702,2022-10-16 23:02:00,c398822feeb59adbfb4e11832a44d798,0,8,2,1,1,12
4536,1702,2022-10-16 23:06:00,aba2bb63f2381563106b50fa4e2a4ffc,0,14,1,1,0,16
4537,1702,2022-10-16 23:11:00,7c5505caea500990c5af7c8a524832b8,0,7,1,0,0,8
4538,1702,2022-10-16 23:17:00,f557f8a50cfef7e3a1ce77c83f48f76a,0,8,0,0,2,10
4539,1702,2022-10-16 23:21:00,9f201a4682f31695b17926cb1b318500,0,10,0,0,2,12
4540,1702,2022-10-16 23:27:00,61dbe4626a1522bc0c4c0cb70069a28e,0,17,0,0,0,17
4541,1702,2022-10-16 23:32:00,e8109e5eace6f6b31bb2af83089ba959,0,8,0,0,0,8
4542,1702,2022-10-16 23:36:00,72d64055405fb1f7f4204d6453872b6f,0,15,0,0,0,15
4543,1702,2022-10-16 23:42:00,ac951a77691136757fc97a23331f7dff,0,14,0,0,1,15
4544,1702,2022-10-16 23:47:00,2140f98b61b10111c65afff5b03c9783,0,9,0,0,0,9
4545,1702,2022-10-16 23:51:00,903aadde32e49ee76d396c2650176cdd,0,10,1,0,0,11
4546,1702,2022-10-16 23:56:00,ca2d053a5fa14691118ad3c231526cbc,0,8,0,1,1,10
4547,1702,2022-10-17 00:02:00,763c5a0ea49308c0db4731d3be70c50a,0,6,0,0,1,7
4548,1702,2022-10-17 00:06:00,fd39198181877e5215c651118ac120cb,0,11,0,0,0,11
4549,1702,2022-10-17 00:12:00,00155e469bc5631fa4a59212e46ca006,0,9,0,0,2,11
4550,1702,2022-10-17 00:17:00,d86c4d5328670d9dd5a239241a4dba06,0,2,0,0,0,2
4551,1702,2022-10-17 00:22:00,122eb0fcb7d27c32177f03dd513a0fe7,0,9,0,0,0,9
4552,1702,2022-10-17 00:26:00,c09845af9fa85d4b2a5dd7a8a18692bc,0,14,0,0,0,14
4553,1702,2022-10-17 00:32:00,2355c81a117330316d9c570476baf583,0,4,0,0,0,4
4554,1702,2022-10-17 00:37:00,0885ad83d6dcef9f6bf61fe6789c4ceb,0,3,0,0,0,3
4555,1702,2022-10-17 00:41:00,08e6d6a3358ed8055be2eb51be7d9994,0,5,0,1,1,7
4556,1702,2022-10-17 00:46:00,03bb2427de7af4a7331d63616937f1ca,0,11,0,0,3,14
4557,1702,2022-10-17 00:52:00,5a126786b72da7e48a325a86b7bb803e,0,6,1,1,0,8
4558,1702,2022-10-17 00:56:00,d63eba8190aa59eb3eefd90bce13de3c,0,7,0,0,0,7
4559,1702,2022-10-17 01:01:00,0c562f9831463b8129bba1071c9c5e1b,0,3,0,0,0,3
4560,1702,2022-10-17 01:06:00,b2d61ca5aee94c2fddeba9130520b327,0,7,0,0,2,9
4561,1702,2022-10-17 01:11:00,0bd2ea8b16fe76accb731e50e7a3ee11,0,6,1,0,0,7
4562,1702,2022-10-17 01:17:00,4164f8fc5fb10f659abd6f5abc3d3b10,1,10,0,0,0,11
4563,1702,2022-10-17 01:21:00,7a4c9e6fdfffe90ea72486406a578b2c,0,5,0,0,0,5
4564,1702,2022-10-17 01:26:00,c0ebdddd0dfeb010b3986e520213cd30,0,3,0,0,0,3
4565,1702,2022-10-17 01:31:00,15a0bc256f49a37b7512a18f623d52b8,0,5,1,0,2,8
4566,1702,2022-10-17 01:37:00,77d23ae141c6721b641316d3557ae995,0,3,0,0,0,3
4567,1702,2022-10-17 01:41:00,3a26d59ccc9448ed52c39cf2c37066ba,0,7,1,0,3,11
4568,1702,2022-10-17 01:47:00,85a5b0a7071ab92a7792396352694e2a,0,7,0,0,1,8
4569,1702,2022-10-17 01:52:00,3f561a349faa4210e575baa69b67f8b3,0,4,0,0,0,4
4570,1702,2022-10-17 01:56:00,00f9caaea73da8a8f88751a145ab345c,0,8,0,0,0,8
4571,1702,2022-10-17 02:01:00,7c2237cb70dc0b2542a060aabd6f5997,0,9,0,0,0,9
4572,1702,2022-10-17 02:08:00,b3ca555258a8a3317cc88f425378693f,0,8,1,0,0,9
4573,1702,2022-10-17 02:11:00,efdadd4805b4228d8393c9e7fe553612,0,6,0,0,0,6
4574,1702,2022-10-17 02:17:00,c00e21afc45d7a15487c4f269f6feecd,0,4,1,1,0,6
4575,1702,2022-10-17 02:21:00,9b1145daf3b7bd158fb02747257a0442,0,9,2,0,0,11
4576,1702,2022-10-17 02:26:00,c5b497a9cebf7979ff5d2b5ad159eb77,0,6,1,0,0,7
4577,1702,2022-10-17 02:31:00,77b2336684e24ceefb82d2bf528785b5,0,7,0,0,0,7
4578,1702,2022-10-17 02:36:00,422155fe7ee3540d4ad5de1d8734ab35,0,7,0,0,0,7
4579,1702,2022-10-17 02:41:00,df1704046901b6a398a3aabba1e1f4ec,0,7,0,0,0,7
4580,1702,2022-10-17 02:48:00,18c0a945109f6395c5124a0225c035e7,0,6,0,0,1,7
4581,1702,2022-10-17 02:51:00,ff0bc8aa396a97e089793266210a06a5,0,3,0,0,0,3
4582,1702,2022-10-17 02:57:00,fe2480858e8b63539d099b67eebc2daf,0,4,1,0,0,5
4583,1702,2022-10-17 03:02:00,30c281568a8ae6c558a1ec41c88474c9,0,1,0,0,0,1
4584,1702,2022-10-17 03:07:00,eb4061284b16ec7686e2504959c24c05,0,2,0,0,0,2
4585,1702,2022-10-17 03:11:00,40e0a274a0a8eff58909b17687dd165e,0,9,0,0,2,11
4586,1702,2022-10-17 03:17:00,1c097550f5d73ba8e8c1f702c6bdb1bc,0,7,1,0,1,9
4587,1702,2022-10-17 03:21:00,280af0d0bfb608c22abbea62da7f5ad4,0,8,0,0,0,8
4588,1702,2022-10-17 03:27:00,0e2502969a7fa1b419790617216181b6,0,1,0,0,0,1
4589,1702,2022-10-17 03:31:00,602e9e80aaba48a039bfaef59d02476c,0,10,1,0,0,11
4590,1702,2022-10-17 03:38:00,be2278c849590b8983c47346b360a06d,0,6,0,0,0,6
4591,1702,2022-10-17 03:41:00,db56483770afad94411f61da8056d68c,0,2,0,0,0,2
4592,1702,2022-10-17 03:47:00,77dc28bfb58baac636ea7cd93bf84b2c,0,4,0,0,0,4
4593,1702,2022-10-17 03:52:00,3f741aed289dcf5bb354e3b60d059dfd,0,5,0,0,1,6
4594,1702,2022-10-17 03:56:00,e15a933697238bd91107b073033b96f0,0,1,0,0,0,1
4595,1702,2022-10-17 04:01:00,581893aa5bf53f47d074025a3747be5e,0,7,1,0,0,8
4596,1702,2022-10-17 04:07:00,ed007c9a45656f143cf260623b9531ad,0,1,0,0,0,1
4597,1702,2022-10-17 04:11:00,c291dd88ca09ad90071df571be1f1345,0,5,1,0,0,6
4598,1702,2022-10-17 04:16:00,4fff925b3d0df5ad3122a122caa8b52d,0,6,0,0,0,6
4599,1702,2022-10-17 04:22:00,3e7075a069ecc59146afc9df948c7ee1,0,2,0,0,0,2
4600,1702,2022-10-17 04:27:00,c96bed34dacbbae99978e97ef74400e6,0,1,0,0,1,2
4601,1702,2022-10-17 04:32:00,2ddc7718f5ed40cf1cdc442b796ba4b3,0,1,0,1,0,2
4602,1702,2022-10-17 04:37:00,bf09bd30e360a6c9e7734075cf12169b,0,3,0,0,0,3
4603,1702,2022-10-17 04:41:00,4aa52b50d5b61b192c8ade451d1ba6d1,0,2,0,0,0,2
4604,1702,2022-10-17 04:46:00,26ed23543e50a361c571215b6c69f3ab,0,4,0,1,0,5
4605,1702,2022-10-17 04:52:00,05294291af4868201ddddac4734bad92,0,7,0,0,0,7
4606,1702,2022-10-17 04:56:00,d55009172533c035e455c0dd551ffba2,0,1,0,0,0,1
4607,1702,2022-10-17 05:01:00,56b65eb9178d7d9629f67a6a55cbe32d,0,3,0,0,0,3
4608,1702,2022-10-17 05:06:00,3a9944f26ef5fa067f9429779fd40b36,0,4,0,1,0,5
4609,1702,2022-10-17 05:11:00,a188b6c9d7fcdfc7765817cb5472afef,0,1,0,0,0,1
4610,1702,2022-10-17 05:16:00,db0c04ce74b9d9ca7fe45016b9507853,0,5,0,0,0,5
4611,1702,2022-10-17 05:22:00,4a45294975b6b7c99a98d2c5b8e88981,0,0,0,0,0,0
4612,1702,2022-10-17 05:26:00,65f586fe7286639834f18afefd7f8631,0,1,0,0,0,1
4613,1702,2022-10-17 05:31:00,7f6605e9a1654e9533df1f896ad15492,0,0,0,0,0,0
4614,1702,2022-10-17 05:36:00,c0fafcd329d9a6fad371c6be68ed4a83,0,2,0,0,0,2
4615,1702,2022-10-17 05:41:00,defc2514363fdd2ae3885b85f5717692,0,2,0,1,0,3
4616,1702,2022-10-17 05:47:00,b8ebf81b9141f262f6e9d13a8e3fd151,0,0,0,0,0,0
4617,1702,2022-10-17 05:51:00,c341a81ad1f515f4d38f16bc159baea5,0,0,0,0,0,0
4618,1702,2022-10-17 05:57:00,3c87d8f8b02b56febcf10d91b861777e,0,0,0,1,0,1
4619,1702,2022-10-17 06:02:00,fdc65fbcd69a9b352b694b68c8848e96,0,0,0,0,0,0
4620,1702,2022-10-17 06:07:00,d5c2a7cfcccb186454b93871610e8f44,0,0,0,0,0,0
4621,1702,2022-10-17 06:12:00,39522866bfd02e43c2a94b16abd2975e,0,1,0,0,0,1
4622,1702,2022-10-17 06:17:00,890c11422b1e125c210765cd2119b655,0,0,0,0,0,0
4623,1702,2022-10-17 06:22:00,907c4cf20bafae9f1985e8d1608d5377,0,2,0,0,0,2
4624,1702,2022-10-17 06:26:00,2b8ed58e43902db3e6a20bf0f91497ee,0,2,0,1,1,4
4625,1702,2022-10-17 06:32:00,8b201c959fe7ac86832318570b75fd93,0,1,0,0,0,1
4626,1702,2022-10-17 06:37:00,98e3e87c9a86387af579465f35fe61de,0,6,0,0,0,6
4627,1702,2022-10-17 06:41:00,076bfcc5d1076788bef5cc624cc6fbc2,0,3,0,0,0,3
4628,1702,2022-10-17 06:46:00,7c92f58e59a74a7d2949f001671ff1d4,0,13,0,0,0,13
4629,1702,2022-10-17 06:52:00,73f01ff037f1662e0bf66b592b57f1b1,0,4,0,0,0,4
4630,1702,2022-10-17 06:56:00,6eb0be350a0ccdf96688a3acd2053b85,0,11,0,1,0,12
4631,1702,2022-10-17 07:02:00,82c8066b7762656e820321287298c2dc,0,9,0,2,0,11
4632,1702,2022-10-17 07:07:00,2b74c85d965356c54d3e5cd4c563a2f7,0,13,0,4,0,17
4633,1702,2022-10-17 07:11:00,38d1e9646aca8674870dff19d9ffef74,0,11,0,0,3,14
4634,1702,2022-10-17 07:17:00,a932d557a4d53e6b48cdc9460fb37442,0,19,0,0,1,20
4635,1702,2022-10-17 07:22:00,edae08267a64f4d999738f8eb095eaec,0,17,0,1,3,21
4636,1702,2022-10-17 07:27:00,b9a7d180aa2ee63cde34ab119ebcadc3,0,13,0,3,9,25
4637,1702,2022-10-17 07:32:00,c13f980a576349843e2eed8a615d559a,0,19,1,0,7,27
4638,1702,2022-10-17 07:37:00,9b8d20afed3e718fe420883eeb4bdab8,0,17,0,1,0,18
4639,1702,2022-10-17 07:41:00,f8b45e309e647ea1e5caa9eb5486df06,0,14,0,4,3,21
4640,1702,2022-10-17 07:47:00,6d4f37ea5a20ca6181af7219dd7d63c3,1,19,0,2,5,27
4641,1702,2022-10-17 07:52:00,b4d54abe85fb1b325abb210bec6e41b6,1,24,0,1,7,33
4642,1702,2022-10-17 07:56:00,855b9ac04264759e28522df1e16827c7,0,12,0,2,6,20
4643,1702,2022-10-17 08:02:00,6496889ffa42845ec1e1073b4790cc6e,0,15,0,4,5,24
4644,1702,2022-10-17 08:07:00,a7898136f758b32af122d0f077ceeb9e,0,16,1,0,8,25
4645,1702,2022-10-17 08:13:00,38ea03b36f8e85ec42b9aef0e54ca368,0,15,2,3,7,27
4646,1702,2022-10-17 08:17:00,f60b925e0d619e16785f70bbee9f0d89,0,19,0,0,8,27
4647,1702,2022-10-17 08:21:00,c0960064c010c17a544b262c155fbd2e,0,11,0,3,7,21
4648,1702,2022-10-17 08:26:00,bfc06532ee7dcc5059c585acd5c451c0,0,19,0,1,13,33
4649,1702,2022-10-17 08:33:00,f09fec7ebb44dbd36705b72f5124e7fc,0,18,0,0,11,29
4650,1702,2022-10-17 08:37:00,87a570605b2a1ac7fa13cebf16a7bced,0,18,0,1,12,31
4651,1702,2022-10-17 08:41:00,dbed14f4e58718254791a557d9b8a49c,2,8,1,0,11,22
4652,1702,2022-10-17 08:46:00,f55dca9cbc7f2ea33532cdfcb5f97878,1,17,0,1,11,30
4653,1702,2022-10-17 08:53:00,67b455820df05ed8c649c5d4d1e584cf,0,15,0,2,11,28
4654,1702,2022-10-17 08:57:00,7a1e7d9aa0d62f96f7801b5d321e2a72,3,11,0,0,14,28
4655,1702,2022-10-17 09:02:00,18117b235e4436808834af5b06ee4641,0,9,0,2,10,21
4656,1702,2022-10-17 09:06:00,a17a291fceff94eb781486a43acfceb5,0,13,0,0,14,27
4657,1702,2022-10-17 09:11:00,768eec74c8d506e4f629111b602a6537,1,14,0,0,12,27
4658,1702,2022-10-17 09:17:00,968ffcba253da1ddf4a165cd3236f38c,0,10,0,3,8,21
4659,1702,2022-10-17 09:23:00,e8a93f18df2040dfa7b6c1f66c231946,0,8,0,0,17,25
4660,1702,2022-10-17 09:27:00,2a35e56e097f7ee877ee8f7f07c55edc,0,14,0,1,10,25
4661,1702,2022-10-17 09:32:00,2319f52a112f8bea81868ae7bd9893d4,0,9,0,5,9,23
4662,1702,2022-10-17 09:38:00,78c98dcde03c4121d5377542d5e29af8,0,5,0,2,12,19
4663,1702,2022-10-17 09:42:00,60cac5f86713af644d7874190354e762,0,15,1,1,4,21
4664,1702,2022-10-17 09:47:00,8d58a84fcc670f7adf77206c5e8d17ac,1,15,0,1,12,29
4665,1702,2022-10-17 09:52:00,ab32101152604d4e3c7a987160309483,0,17,0,1,7,25
4666,1702,2022-10-17 09:57:00,1ff2090d5b3eaec338aa8faebc4358cc,0,20,0,2,5,27
4667,1702,2022-10-17 10:02:00,0b0a1c31c9b3494eefbfa49ebefc8f7c,2,9,1,0,6,18
4668,1702,2022-10-17 10:08:00,1468595399bb4c5bac41677ec87bcb59,0,15,0,0,12,27
4669,1702,2022-10-17 10:12:00,9f559294e4eb64185dd03798c37f9328,0,14,1,5,8,28
4670,1702,2022-10-17 10:17:00,ca8df8df3234de2b0dd3dca0337845ec,1,14,0,0,7,22
4671,1702,2022-10-17 10:22:00,f6058de08ea11eef00920e543226b9a1,0,11,0,3,11,25
4672,1702,2022-10-17 10:26:00,e474fdb6fbc1d867bfd94e2ead63598b,0,13,0,1,10,24
4673,1702,2022-10-17 10:32:00,bacadd12ac6bd89a0d30c96c9939bdb0,0,15,0,1,12,28
4674,1702,2022-10-17 10:38:00,e021f71aa7db56a2be9760004ae6b623,0,18,0,2,5,25
4675,1702,2022-10-17 10:42:00,f8d060c1e6e0e61c134f3c3597e8302c,0,14,0,0,11,25
4676,1702,2022-10-17 10:47:00,c29398e33b7744d10d6a04fe5492c2f8,0,11,0,1,11,23
4677,1702,2022-10-17 10:53:00,ebf77096840118e28fe1e9ce73b7047e,0,15,0,1,8,24
4678,1702,2022-10-17 10:57:00,a176f8f9818ed457ef70f08971baf1e8,1,10,0,3,9,23
4679,1702,2022-10-17 11:03:00,0f318a5d5162504b84af92d60521be4a,0,14,0,0,11,25
4680,1702,2022-10-17 11:08:00,16ff18df160daed4fd4d762982bf960c,0,13,0,4,13,30
4681,1702,2022-10-17 11:11:00,3eb2096aead74d071b118cba684ba3f2,0,15,0,6,8,29
4682,1702,2022-10-17 11:17:00,338a9b34b65b5268d2b606b4ebb8b97e,0,10,0,0,8,18
4683,1702,2022-10-17 11:23:00,e5ed4c2499521e3c16a87089cfb467fd,1,7,0,2,12,22
4684,1702,2022-10-17 11:26:00,557c13ce9a7bc36307ad266107f873cb,0,15,0,1,7,23
4685,1702,2022-10-17 11:32:00,54b05360a41157fc6607e4746d063db1,0,11,0,1,6,18
4686,1702,2022-10-17 11:37:00,43ccd63042ab8cfb7f084c6dc3a4ef8e,0,8,0,0,10,18
4687,1702,2022-10-17 11:41:00,fedfd7a8443345c7fb48614957c3f4cf,0,11,0,3,7,21
4688,1702,2022-10-17 11:47:00,e5cc9149e1ca19de597e106a1647a24a,0,9,0,3,13,25
4689,1702,2022-10-17 11:51:00,51c69d0197319dd8a77fdbc533c28fc6,2,15,0,1,10,28
4690,1702,2022-10-17 11:58:00,a8ce5ecf24198b3419416238dcb7403e,0,21,0,2,4,27
4691,1702,2022-10-17 12:03:00,614adc1adb05590dcc78ba5c3adff0e7,0,10,0,1,13,24
4692,1702,2022-10-17 12:07:00,606107834c0c1b1d4cd9722e81044ffc,0,15,0,3,7,25
4693,1702,2022-10-17 12:10:00,21c66380b6328db5da859b1a9fe7c708,3,7,0,2,5,17
4694,1702,2022-10-17 12:16:00,2863894804db2cab9dc02107eea5311a,0,12,0,0,8,20
4695,1702,2022-10-17 12:22:00,3c383a09c9a94675c13455bdb1f46e86,0,17,0,2,4,23
4696,1702,2022-10-17 12:27:00,f0ee4a610f6b7e083c1ff2e3ff9d43a7,0,11,0,3,8,22
4697,1702,2022-10-17 12:32:00,4c8b82e924b41628912f0c318cb03d1f,1,7,0,0,6,14
4698,1702,2022-10-17 12:38:00,2aaf8fdbb3c1643e0bfdbf1aa4712f4f,0,7,0,1,10,18
4699,1702,2022-10-17 12:42:00,dbdeca24c8489e7eb3ffdaa7d1d58411,0,8,0,4,7,19
4700,1702,2022-10-17 12:47:00,2ae253f67578e0d64d67bd04751b3eaa,1,8,0,5,3,17
4701,1702,2022-10-17 12:52:00,885a99aaceadfee6d5c91424ad5fbc95,0,16,0,0,6,22
4702,1702,2022-10-17 12:57:00,c1b8648e52918046f241f601e290570b,0,17,0,3,3,23
4703,1702,2022-10-17 13:03:00,48e7726eea6a683cc0bdb1fad1537bd9,0,13,0,1,7,21
4704,1702,2022-10-17 13:07:00,0ec0b73c75547a9d0869703e0c352d9e,0,13,0,5,3,21
4705,1702,2022-10-17 13:11:00,065177ea4a91cc0ec25a0d85d26829a2,0,16,0,0,4,20
4706,1702,2022-10-17 13:17:00,1e6938088fdfa65bdc33369710e342a6,0,13,0,0,4,17
4707,1702,2022-10-17 13:21:00,22621a892ab56d7cd2955264c3f81f48,0,8,0,1,8,17
4708,1702,2022-10-17 13:27:00,017ca77e8287e53fa14e4b23987b01ae,0,17,0,3,7,27
4709,1702,2022-10-17 13:32:00,4b1e9bf6c5ed1de8b8ac2a6738cdd207,1,14,0,9,4,28
4710,1702,2022-10-17 13:37:00,020de24d136b12209ee3756b0e23e1aa,0,14,1,4,8,27
4711,1702,2022-10-17 13:42:00,d466f9b040d6a65f03698603041b8f5f,0,12,1,2,6,21
4712,1702,2022-10-17 13:47:00,43065701b5e3cfbfb52610e45b1c40f7,0,18,0,3,7,28
4713,1702,2022-10-17 13:53:00,93a4d0e1a35ebbdfe53d293388f0281c,0,13,0,2,6,21
4714,1702,2022-10-17 13:58:00,309b749b88be96527f53e1e7a93ab32c,2,9,0,6,7,24
4715,1702,2022-10-17 14:03:00,dfa2e4df636a89faa5d5805c9ba02842,1,12,0,2,10,25
4716,1702,2022-10-17 14:07:00,878ae9bed9ab09c48e4acf21f7c5e3d5,0,12,0,2,2,16
4717,1702,2022-10-17 14:12:00,418c7a736bc0e650a7e689c61f146f23,0,16,0,4,7,27
4718,1702,2022-10-17 14:16:00,3129b26ad706892b3b6759da25c04d44,0,17,1,1,6,25
4719,1702,2022-10-17 14:21:00,1fb5873fb8df61704daec46c13a2aa55,0,13,1,3,7,24
4720,1702,2022-10-17 14:27:00,0e79fd41dd8e8977f1ceef320e32fe7f,0,20,0,3,6,29
4721,1702,2022-10-17 14:33:00,31a782e4975cb2845b087b663abfc995,0,13,0,2,6,21
4722,1702,2022-10-17 14:37:00,1eb150e1f951f47672a177635f04eaa4,1,20,1,3,6,31
4723,1702,2022-10-17 14:41:00,8dc58cf56872d93d81efb60c2fb2d289,0,20,0,3,7,30
4724,1702,2022-10-17 14:47:00,77a7b7afdaadfb220f4e457da857eddb,0,10,0,2,5,17
4725,1702,2022-10-17 14:52:00,77682d93711c207c0a6f01607f5701f9,0,19,0,2,9,30
4726,1702,2022-10-17 14:56:00,cc16847dbc4e12614c488607c3d4081b,0,9,1,1,7,18
4727,1702,2022-10-17 15:02:00,3059198ca595151f92ad5383d683661b,0,15,0,3,7,25
4728,1702,2022-10-17 15:07:00,88b6e0bfd166221473aad60b9c908075,0,16,0,1,8,25
4729,1702,2022-10-17 15:12:00,48b397126b1d0cf7bd8898c28a5ce372,0,12,0,0,9,21
4730,1702,2022-10-17 15:17:00,9108aaa24469daf955385c5519bfc058,0,18,1,8,4,31
4731,1702,2022-10-17 15:23:00,84152db44477a8affd2aba8ee7a42778,0,21,0,1,3,25
4732,1702,2022-10-17 15:27:00,7a07fd4941a08e475352eab00c6c9432,0,17,0,1,7,25
4733,1702,2022-10-17 15:33:00,7ad879997d056a57b44c63246bdb84ef,0,15,0,2,7,24
4734,1702,2022-10-17 15:38:00,8304d03a62a9f5b7f6ed8ca62ff3f187,0,17,0,3,6,26
4735,1702,2022-10-17 15:42:00,a2fd6d4ff103ad62223344c3bbee753f,0,14,0,2,7,23
4736,1702,2022-10-17 15:48:00,5c2483a151ed381eeb86440547243cc7,0,13,0,1,6,20
4737,1702,2022-10-17 15:52:00,09e1814e33fe51b938227f893ec65489,0,13,2,1,10,26
4738,1702,2022-10-17 15:58:00,420227ffe530af14b31496c6cf11b913,0,12,0,0,15,27
4739,1702,2022-10-17 16:02:00,cd6c40605067dc2522c824d0c6a3e2e6,0,9,0,0,8,17
4740,1702,2022-10-17 16:07:00,1c9faca49e15d840b9a001c91858735f,0,11,0,2,7,20
4741,1702,2022-10-17 16:12:00,1e101316921c299de7c89a60d2253588,1,12,0,2,7,22
4742,1702,2022-10-17 16:17:00,f1d68b5b5abde9bb08f89005e1c4930c,0,16,0,2,8,26
4743,1702,2022-10-17 16:22:00,3e7637ffee5d126274e0cd71fe2ae67e,0,10,0,2,3,15
4744,1702,2022-10-17 16:27:00,36cfa20f7e63f6e48a85bead01c46dcc,0,9,0,0,9,18
4745,1702,2022-10-17 16:32:00,3e135e51e62016f5ad8d547edec5fa2d,1,1,0,5,5,12
4746,1702,2022-10-17 16:38:00,fad6dae8f61feda85445274d313276bc,1,9,0,1,7,18
4747,1702,2022-10-17 16:42:00,e2b468edc5df1b72b46524f7eccbcad0,0,10,0,1,12,23
4748,1702,2022-10-17 16:47:00,37d33fd569a452071e448918034b3cc3,0,7,0,4,14,25
4749,1702,2022-10-17 16:52:00,0a82bf29847fa9fdfc336a7922d22ed7,0,11,0,3,8,22
4750,1702,2022-10-17 16:57:00,54014dd3a32ba906efc6cd69a7f79ef9,1,17,0,1,14,33
4751,1702,2022-10-17 17:02:00,40e28710a774b9943bac1b8ceaac3993,0,16,0,1,12,29
4752,1702,2022-10-17 17:07:00,93a571812aee910c88c0bac8decf4909,0,16,0,1,8,25
4753,1702,2022-10-17 17:12:00,41dcc21392bd8df89267f5621903d29c,0,16,0,0,9,25
4754,1702,2022-10-17 17:17:00,4bd7e0be38a057ee5db9837e4736e307,0,14,1,0,13,28
4755,1702,2022-10-17 17:22:00,43d8db615a9b09f9a5f4161536399f0b,0,12,0,5,13,30
4756,1702,2022-10-17 17:27:00,bc48b34a92d2d6024fb2369129d24907,0,18,0,2,10,30
4757,1702,2022-10-17 17:32:00,fbda8b91ccdd5751ea1fc969ab5a0d07,0,15,0,3,9,27
4758,1702,2022-10-17 17:37:00,ae05b4f79bc40dd18f42c43bc66141e8,0,13,1,0,11,25
4759,1702,2022-10-17 17:42:00,322fc308e20e458e79b329f8a4a72681,0,16,0,0,15,31
4760,1702,2022-10-17 17:47:00,18c2275ffde363aa5387d9f6a0e49f3e,1,16,0,7,10,34
4761,1702,2022-10-17 17:51:00,c106ebb8747f4fe07b5113e119e88ce5,0,14,0,1,15,30
4762,1702,2022-10-17 17:57:00,6ec7aa68660add1c3f5a85f8c3b27a6a,0,20,1,1,6,28
4763,1702,2022-10-17 18:02:00,a5ee8b263a1db7623774e3d6e890a57d,1,15,0,2,9,27
4764,1702,2022-10-17 18:08:00,039045b38ed5989ee908a55027ce0c55,0,18,0,1,6,25
4765,1702,2022-10-17 18:11:00,244c070000346e889c9cd7eeaf8f654f,0,18,2,0,6,26
4766,1702,2022-10-17 18:17:00,569afe22c26fee86bb8674bdc7183774,0,15,1,0,8,24
4767,1702,2022-10-17 18:23:00,ab08827fdb9b22679f6b7555be8113e4,3,11,1,2,5,22
4768,1702,2022-10-17 18:26:00,01be41809a4229e00a8da2c12a947e52,0,21,0,2,7,30
4769,1702,2022-10-17 18:31:00,198f6126a1e095daef0516569a714ab3,0,18,0,1,8,27
4770,1702,2022-10-17 18:38:00,93b980797bda8d01015af8029c4ae9fe,0,12,0,0,13,25
4771,1702,2022-10-17 18:42:00,f9c80c2556e86220850546da5f2be1aa,1,17,0,0,8,26
4772,1702,2022-10-17 18:48:00,3f8116e45b816d0899fd111d1ad363a5,0,17,0,0,4,21
4773,1702,2022-10-17 18:52:00,05e5ba95f70d06feae9a99ea628669a3,0,16,0,4,7,27
4774,1702,2022-10-17 18:57:00,38708ab3a3440f982a7e44418ca5132a,0,21,1,0,4,26
4775,1702,2022-10-17 19:02:00,15d79b57d25e1f1d0bc96768e6e87f8e,0,17,1,0,0,18
4776,1702,2022-10-17 19:07:00,6843b3edb29b11c14c3865659f458cf9,0,13,6,1,1,21
4777,1702,2022-10-17 19:12:00,c2b65261198d6b82b11c67fb56eccf92,0,20,1,0,1,22
4778,1702,2022-10-17 19:17:00,20e921b7544e741f512c16c71e844389,0,23,2,2,0,27
4779,1702,2022-10-17 19:22:00,75951d5e56ea6c5b5d56047097dfe2bc,0,19,0,0,0,19
4780,1702,2022-10-17 19:26:00,61b01a91ca415e8d83afca251788399b,0,22,1,0,0,23
4781,1702,2022-10-17 19:32:00,f340d227119f7acfae8dda24c60b9089,0,12,4,0,1,17
4782,1702,2022-10-17 19:36:00,858395398f128fe5fd4fa50ddad2a880,0,21,0,1,2,24
4783,1702,2022-10-17 19:42:00,68c4328db667d742b66a96a5a683e6a3,0,13,0,0,1,14
4784,1702,2022-10-17 19:46:00,779025108384e02fd956003a355ee85c,0,24,1,0,1,26
4785,1702,2022-10-17 19:51:00,699c4703ba110c9f3c6a496c43c8e229,0,22,0,0,1,23
4786,1702,2022-10-17 19:57:00,e77e4d759bce6ad45b302dd31ec15356,0,15,0,1,1,17
4787,1702,2022-10-17 20:02:00,b80e398752b56c5812bd543eb359a101,0,17,3,0,1,21
4788,1702,2022-10-17 20:06:00,a7474e5f199dac6852a745247f203824,0,15,0,1,1,17
4789,1702,2022-10-17 20:12:00,1f38d12f5979253d3d394db5d0f9c00c,0,26,0,0,1,27
4790,1702,2022-10-17 20:17:00,8de0bb7dbe924f9217898108b45ca434,0,21,1,0,0,22
4791,1702,2022-10-17 20:21:00,702aea6ccf0adedd1fe86fee9036dddd,0,6,1,0,0,7
4792,1702,2022-10-17 20:26:00,1d402e85093715065b9053c15459ac9a,0,15,0,0,0,15
4793,1702,2022-10-17 20:32:00,b0a18f5e64619c33cf9c82026031617f,0,15,1,0,1,17
4794,1702,2022-10-17 20:36:00,54260644384ab9464ad1dd370b55683c,0,13,0,0,1,14
4795,1702,2022-10-17 20:41:00,6f6a746e41ef5f66ba0a2b9ecb2e8f14,0,22,2,1,0,25
4796,1702,2022-10-17 20:48:00,484376793bbaa904129c786013d90ef2,0,13,0,0,2,15
4797,1702,2022-10-17 20:52:00,2b0cb09f59916109b50de4b130b93faa,0,15,2,1,2,20
4798,1702,2022-10-17 20:57:00,e7c1c3fcbfb7e87173cdaafdd94d9aa0,0,13,2,2,0,17
4799,1702,2022-10-17 21:02:00,8e2110beb40203aa473fb8d05427bdac,0,9,1,1,1,12
4800,1702,2022-10-17 21:08:00,9aed5a0c7fde889100a31aa961242f1d,0,15,0,1,0,16
4801,1702,2022-10-17 21:11:00,8396d8eddb6fee6d3a01b9c0c2c73a0d,1,20,0,1,0,22
4802,1702,2022-10-17 21:16:00,6ab7ea18f821df673674f85c6af46852,0,16,3,0,0,19
4803,1702,2022-10-17 21:21:00,9f8bbbbe908387b3a62acf73502bcffa,0,13,0,2,1,16
4804,1702,2022-10-17 21:27:00,e59e8632868496dd72a11fbfe21fdde7,1,14,0,1,0,16
4805,1702,2022-10-17 21:31:00,7b1053e49a7f15b8d042ade28221af2f,0,19,1,1,1,22
4806,1702,2022-10-17 21:36:00,829a89b36f3af95329b4bada0534c2a9,0,19,2,0,0,21
4807,1702,2022-10-17 21:41:00,b3996b5732e008c184b25ad59645e80c,0,11,0,0,0,11
4808,1702,2022-10-17 21:47:00,c4aa64a95dcd5661ce2c009d039960ba,0,13,0,2,1,16
4809,1702,2022-10-17 21:52:00,aa4c1bc0a23bcd9a73b8b52056f87c53,0,21,0,1,1,23
4810,1702,2022-10-17 21:56:00,7755c4d00220c32018a1ef301f19fffc,0,14,0,1,3,18
4811,1702,2022-10-17 22:01:00,ad193c05524bbaf63bbaec5c097ca8b6,0,18,0,0,1,19
4812,1702,2022-10-17 22:07:00,a0b82425cde48cbaea44e8c72aaf589a,0,8,0,0,0,8
4813,1702,2022-10-17 22:11:00,4c9665be85e121ead4c8b8c8fa712a9a,0,14,0,0,0,14
4814,1702,2022-10-17 22:16:00,65bc2c4cdb2b82e3b39ff5b6c741b542,0,11,0,1,0,12
4815,1702,2022-10-17 22:21:00,ef56983868637d95607aa179fef4a9ee,0,15,0,0,2,17
4816,1702,2022-10-17 22:26:00,a501c2097d51d06eeb19706acaa90d85,0,12,0,1,0,13
4817,1702,2022-10-17 22:32:00,9babfa20377a9319cbb0b1d518b5f53a,1,14,0,0,2,17
4818,1702,2022-10-17 22:36:00,e218422bdb8667b2fc88812d9a3739c2,0,13,1,0,0,14
4819,1702,2022-10-17 22:41:00,379be302e4809cd53d0bea84dc896de3,0,22,0,0,1,23
4820,1702,2022-10-17 22:46:00,1ec715e74fe759204404b3bcebc726cb,0,14,1,0,2,17
4821,1702,2022-10-17 22:52:00,c998b57d1e2db09233a17b3a3b8cb599,0,6,0,0,2,8
4822,1702,2022-10-17 22:56:00,b3bbdf894675a361cfcbf6ae7d27a6bc,0,10,0,1,0,11
4823,1702,2022-10-17 23:01:00,20a39b0a09bd9c4bf9038510aae807cb,0,11,0,1,1,13
4824,1702,2022-10-17 23:07:00,b1fb13a0e79aed8697230d6567594fd6,0,12,0,1,1,14
4825,1702,2022-10-17 23:11:00,ad20d8222e07614636548748303d36dd,0,11,1,0,0,12
4826,1702,2022-10-17 23:16:00,a0408194ababc527618f47eac80a40a7,0,9,0,0,0,9
4827,1702,2022-10-17 23:22:00,43c5d429abbe81f5f3c170dbe404b270,0,4,0,0,0,4
4828,1702,2022-10-17 23:26:00,c0861ad51a060760fbe7fac340aaca65,0,12,0,0,0,12
4829,1702,2022-10-17 23:32:00,dd43e36a562956f82b9962e325f487e5,0,6,0,0,1,7
4830,1702,2022-10-17 23:37:00,3d6458a80965a11ab1f2e38c891bf659,0,11,0,1,0,12
4831,1702,2022-10-17 23:42:00,87fed75b9a5b46377d379c1236961407,0,7,1,0,0,8
4832,1702,2022-10-17 23:46:00,854a18a9b7c9db9f54a1d0e8cff6614d,0,10,0,0,0,10
4833,1702,2022-10-17 23:52:00,e162978760c4dbb9e61a375e4c7048e2,0,14,0,0,0,14
4834,1702,2022-10-17 23:57:00,8b7f87eb17169999d1bad59a6b2a5ebb,0,7,0,0,0,7
4835,1702,2022-10-18 00:02:00,8c9742c0088e9fe5702c3f150b23112d,0,9,1,0,0,10
4836,1702,2022-10-18 00:07:00,954e0f766c2de6efc4ae51bac0976088,0,6,0,0,0,6
4837,1702,2022-10-18 00:11:00,26690be276ad81d5e9bf2e1793aba52f,0,11,2,0,0,13
4838,1702,2022-10-18 00:17:00,e25a1f916fcc7ef01b7b33c65aa7852a,0,0,3,0,0,3
4839,1702,2022-10-18 00:21:00,70b74441384aa1cee71567e89e6dd58c,0,3,0,1,0,4
4840,1702,2022-10-18 00:27:00,1f0c5c6f57f70982e3f2d0354af79efd,0,5,0,0,0,5
4841,1702,2022-10-18 00:32:00,68ddfdd994419b4b80d1b70c71546b55,0,6,0,0,0,6
4842,1702,2022-10-18 00:37:00,1b5c54c1c31f9deb7c03e71d226116f9,0,14,0,0,1,15
4843,1702,2022-10-18 00:41:00,2121e23691d3420e2221905e5311e45d,0,7,0,0,0,7
4844,1702,2022-10-18 00:46:00,9ab63ed7c382d6532d524281891767d4,0,5,1,0,0,6
4845,1702,2022-10-18 00:51:00,9019c46f84d232aa49dbdad516a61b90,0,10,0,2,0,12
4846,1702,2022-10-18 00:57:00,b406b02f22c19ba92b9994e8fbb79c8a,0,11,0,0,0,11
4847,1702,2022-10-18 01:02:00,ec8666f65fd3924d8544fb474e4efd50,0,10,0,0,0,10
4848,1702,2022-10-18 01:06:00,22dd7c023c9fbd0f0ec952263cbb985e,0,10,0,0,2,12
4849,1702,2022-10-18 01:12:00,14a95a4dcc230489a2f7486d82f1ef5f,0,7,0,0,0,7
4850,1702,2022-10-18 01:17:00,6e3e909481770f5cf1e3dbef0b00bb84,0,5,0,0,1,6
4851,1702,2022-10-18 01:21:00,8e4cdf8d274f9486e093fb852db96d60,0,7,0,0,0,7
4852,1702,2022-10-18 01:27:00,90e1f81e0cfd2010cee20316d9a58736,0,9,0,0,0,9
4853,1702,2022-10-18 01:32:00,03f565595ee5f53ba34e5f21e2767801,0,5,0,0,0,5
4854,1702,2022-10-18 01:36:00,fb3670c9661a5c15d2af171a99116118,0,7,1,1,0,9
4855,1702,2022-10-18 01:41:00,a9d22b042c0c88b686814bc9f762eca1,0,6,1,0,0,7
4856,1702,2022-10-18 01:47:00,da74b42f98012cf57b2280bbbc90c6da,0,8,0,0,0,8
4857,1702,2022-10-18 01:52:00,55b0b347638efabe826ac0bab826174e,0,7,0,0,0,7
4858,1702,2022-10-18 01:56:00,aa20d4edf1b72e10d7b135d18ef46089,0,6,1,0,0,7
4859,1702,2022-10-18 02:01:00,1ae2f24381b9287f39b74ebd07f273cb,0,7,0,0,0,7
4860,1702,2022-10-18 02:08:00,d95e8270447dd059a6baf6ab44616090,0,2,0,0,0,2
4861,1702,2022-10-18 02:12:00,8b0b5ef9f3da75222319aedb65d4fdd2,0,8,0,0,1,9
4862,1702,2022-10-18 02:16:00,815ed8ce5c58f375ccc30c57b1e96ba4,0,7,1,0,0,8
4863,1702,2022-10-18 02:22:00,deba98eab756c2bc1dd0e680ff82b653,0,12,0,0,0,12
4864,1702,2022-10-18 02:26:00,471defffbf51703d3d4b2c95f1923100,0,0,0,0,0,0
4865,1702,2022-10-18 02:32:00,48647bb32a774c104bf478b13f6b96c6,0,1,0,0,0,1
4866,1702,2022-10-18 02:37:00,469ac7d0c147470c0905ee64f75a8b9a,0,8,0,0,0,8
4867,1702,2022-10-18 02:41:00,75188cf9541f05fe0752e3f0cd98cb54,0,4,0,1,0,5
4868,1702,2022-10-18 02:47:00,e0f0bea5cf500d740ed33d10acd07c8b,0,5,0,0,0,5
4869,1702,2022-10-18 02:52:00,e4527d18836bb35b1bb003fa20c84537,0,6,4,0,0,10
4870,1702,2022-10-18 02:56:00,887702e53ac0f378485b53c60fbe6e4c,0,6,0,0,1,7
4871,1702,2022-10-18 03:02:00,a49bdf35edac5bbde76c337336ebe4fd,0,2,0,0,0,2
4872,1702,2022-10-18 03:07:00,afee9032124b83859ebf572cfb7458db,0,6,0,0,0,6
4873,1702,2022-10-18 03:11:00,9fb8271436991b86d8078612ad5fbc46,0,7,0,0,0,7
4874,1702,2022-10-18 03:17:00,b26831796af4f64b063cf71484367136,0,6,1,0,0,7
4875,1702,2022-10-18 03:21:00,3d9e1a347489fde78c3fb464538028fa,0,4,0,0,1,5
4876,1702,2022-10-18 03:26:00,a7231f0d48627be45d548c2b7b6cd5bc,0,8,0,0,0,8
4877,1702,2022-10-18 03:31:00,c4c159367c3ea47a2c213043fe2b1012,0,5,0,0,0,5
4878,1702,2022-10-18 03:36:00,2fe7d6dc0fdca9404c0dd25842542d52,0,7,0,0,0,7
4879,1702,2022-10-18 03:42:00,54cd18ddf06a884ea790c62af0fb81b7,0,4,0,0,0,4
4880,1702,2022-10-18 03:46:00,a710fbddb76e9649e622f38fd32cb386,0,2,0,0,0,2
4881,1702,2022-10-18 03:52:00,4e3d751a95614540078e4a4b59d9c8bb,0,7,2,0,0,9
4882,1702,2022-10-18 03:56:00,e8e1f08c9b6fc56c92687c115681b810,0,9,0,1,1,11
4883,1702,2022-10-18 04:02:00,f55e4c48c35fb52b84d30e801386d4de,0,5,0,0,1,6
4884,1702,2022-10-18 04:06:00,225a4ec32d2d25992d8581242ae3cba9,0,3,0,0,1,4
4885,1702,2022-10-18 04:13:00,faedca167b562378a59849aeae54571d,0,10,0,0,2,12
4886,1702,2022-10-18 04:17:00,1551f2b9231092c4e7b852ad6f42eb22,0,5,0,0,1,6
4887,1702,2022-10-18 04:22:00,4b585572c36dfcc517a012e5198f55d4,0,7,0,1,0,8
4888,1702,2022-10-18 04:27:00,fd7d537a5be36333a654cf21247a97b5,0,4,0,0,2,6
4889,1702,2022-10-18 04:32:00,4c8f9dac03c5f43e4e1f18c08adade2e,0,4,0,0,1,5
4890,1702,2022-10-18 04:38:00,206cf816bab2fba580952f5d98448bde,0,5,0,0,1,6
4891,1702,2022-10-18 04:41:00,9ef3bfde8fb98d5640c1bec132a27baa,0,2,0,0,0,2
4892,1702,2022-10-18 04:47:00,6e10ef81b706032f029d13e1f3e4bac0,0,4,0,2,0,6
4893,1702,2022-10-18 04:52:00,cc48eb278bb6cae8d4496f655f854ddc,0,4,0,0,0,4
4894,1702,2022-10-18 04:56:00,efcdf01d3356a52e098ccf66550b3318,0,2,0,0,0,2
4895,1702,2022-10-18 05:02:00,f26027aa1881b78c76207b8459353639,0,4,0,0,0,4
4896,1702,2022-10-18 05:07:00,efb2c04148d5fef32fb887c371e4ce2c,0,3,0,0,0,3
4897,1702,2022-10-18 05:11:00,d86286c998f3fe47a917bcb532190e9d,0,8,0,0,1,9
4898,1702,2022-10-18 05:16:00,14221ecfb986a8b4aa80cf0e913a93b1,0,5,0,0,1,6
4899,1702,2022-10-18 05:21:00,6bd991a8e673500afc7dce842c894a3a,0,7,1,1,0,9
4900,1702,2022-10-18 05:26:00,5b98e1da2e24fc15a7451d4924cabacc,0,1,1,0,1,3
4901,1702,2022-10-18 05:31:00,29bf0a8ff35ba19a618abd097e5abdf8,0,5,0,0,2,7
4902,1702,2022-10-18 05:37:00,960609213cafd6991b41518d6963b6db,0,4,0,1,0,5
4903,1702,2022-10-18 05:41:00,e2694958ce9be67c53beee4b1720e588,0,2,0,0,1,3
4904,1702,2022-10-18 05:46:00,06ecec9e69a78c75a41805e8cc78a10f,0,2,0,0,0,2
4905,1702,2022-10-18 05:53:00,b3a101740f71340a2b35b1ebcea36815,0,6,0,0,0,6
4906,1702,2022-10-18 05:56:00,064242e9e5fe4b7e349319f77123ee0d,0,4,1,2,1,8
4907,1702,2022-10-18 06:01:00,57ab28f6d56ec5a56d448506e04d1b35,0,4,0,1,1,6
4908,1702,2022-10-18 06:07:00,220e3f37c3d1ec1363828157d3e7e5ba,0,6,2,0,0,8
4909,1702,2022-10-18 06:11:00,2e983dad1ee9c5a8448d9a3401c2648b,0,3,1,2,2,8
4910,1702,2022-10-18 06:17:00,37ecb717118f5b2a73f89a45098bd940,0,8,1,1,1,11
4911,1702,2022-10-18 06:22:00,0f13d6fd080efc7ea41d1a6ac4d1d07f,0,9,1,1,0,11
4912,1702,2022-10-18 06:28:00,792dc5dea1023ef92541b082f294990a,0,5,0,1,0,6
4913,1702,2022-10-18 06:31:00,0e106e5ac1685c924a53fdfb3f16bc81,0,14,0,1,1,16
4914,1702,2022-10-18 06:36:00,25db436917f900468c7ae8246d9ddfef,0,9,1,5,1,16
4915,1702,2022-10-18 06:41:00,537ab1792b731f2b0d90e8d4fa0391aa,0,15,2,2,1,20
4916,1702,2022-10-18 06:47:00,ced54065064ba56339f477eb0217adde,0,11,1,1,1,14
4917,1702,2022-10-18 06:52:00,3cb53af175056911c075d52b6725bcb0,0,14,1,1,6,22
4918,1702,2022-10-18 06:57:00,3b298791571950c8020edd1d2bebe2b4,0,19,0,0,9,28
4919,1702,2022-10-18 07:02:00,f325190e5c6dd19342eaca4b1817fa63,0,13,0,2,5,20
4920,1702,2022-10-18 07:07:00,f74438738f69a8752b34c9094fc16062,0,14,1,1,9,25
4921,1702,2022-10-18 07:12:00,8dc59fac6e96c424f918d69c547b6695,0,18,0,0,9,27
4922,1702,2022-10-18 07:17:00,3858a0b87fc2085b7f6da8184c54e7c6,0,18,0,1,7,26
4923,1702,2022-10-18 07:22:00,f5e549221ca5c99a7a61e5accaae17c5,0,18,0,0,7,25
4924,1702,2022-10-18 07:28:00,b9710794c7180b28e7b4093e555c02a2,0,20,0,0,9,29
4925,1702,2022-10-18 07:33:00,f44af461a9ff73e77f8d23249d77a6f3,1,14,0,3,8,26
4926,1702,2022-10-18 07:36:00,1debf7cd876d5e679ec47d57884b6d47,1,12,1,5,6,25
4927,1702,2022-10-18 07:42:00,198d93b5dca55bf1eaba70d0c70bd1a3,3,17,0,2,12,34
4928,1702,2022-10-18 07:47:00,c9864269e76c56bf912ddda778b02012,0,13,0,3,10,26
4929,1702,2022-10-18 07:53:00,553920e4f6650d5d4850787eaa8dee6a,1,15,0,0,8,24
4930,1702,2022-10-18 07:57:00,b6de1a44789f2da0d1291fd26bb8f6f1,0,16,0,1,12,29
4931,1702,2022-10-18 08:01:00,cb93f79c45bca22d74e65a1f0c44ee3b,0,10,0,0,16,26
4932,1702,2022-10-18 08:06:00,4a3a1ef53bcb53bff44dd58596a1ddf9,0,13,0,2,12,27
4933,1702,2022-10-18 08:11:00,75e9b80a736c0e1ea3ea5ef55a721532,0,6,0,1,2,9
4934,1702,2022-10-18 08:18:00,49b5c5cca635281e9c1232a842d6c42f,0,10,0,2,9,21
4935,1702,2022-10-18 08:22:00,370c9639b6c879711d7b8a30cd8e5a66,0,9,0,0,12,21
4936,1702,2022-10-18 08:26:00,bc9c83d9c2d11056db859e64f34a86b3,0,13,0,3,7,23
4937,1702,2022-10-18 08:33:00,13c2ccbbd85a9599372bb32babc1e6a5,0,12,0,1,11,24
4938,1702,2022-10-18 08:37:00,e6c5d51b35d587a34dd9a752a3c4cf67,0,16,0,2,8,26
4939,1702,2022-10-18 08:42:00,68af80d3b2c8284a670398163a4b68ac,0,14,0,2,9,25
4940,1702,2022-10-18 08:48:00,1243109c47bff9dd3d347c456941e207,0,14,0,1,4,19
4941,1702,2022-10-18 08:57:00,aef4b92ebf08c830c353f18042d73991,1,13,0,2,11,27
4942,1702,2022-10-18 09:02:00,e34e7789f4052ba892dc4650f1273481,2,19,0,3,3,27
4943,1702,2022-10-18 09:07:00,4091af8f024caea331f2bf253db6c730,0,17,0,2,9,28
4944,1702,2022-10-18 09:11:00,97587e0632be6a728ad8e4238c7409fb,0,15,2,2,5,24
4945,1702,2022-10-18 09:17:00,b08230d01026938fcd185f71f22efa6e,0,20,0,2,5,27
4946,1702,2022-10-18 09:23:00,7561e2eda3b6f407fbd4865393334c30,1,14,0,0,10,25
4947,1702,2022-10-18 09:27:00,6ba75907089680ae1c3ed3fc58d62f99,0,12,0,3,3,18
4948,1702,2022-10-18 09:32:00,e9fda4473517b14e8d99f106d699f5cc,0,11,0,1,14,26
4949,1702,2022-10-18 09:37:00,ac479e3b60e9a2543fdac5ee6c5663f6,1,16,1,2,7,27
4950,1702,2022-10-18 09:41:00,ca0ff5a5c364a6799cd4952c28dbba58,0,14,0,2,10,26
4951,1702,2022-10-18 09:48:00,cd414b4643094d68cd08a64280ca727b,0,14,0,4,6,24
4952,1702,2022-10-18 09:53:00,b054f6d477339f676dfc08819ea12f11,0,16,0,4,12,32
4953,1702,2022-10-18 09:57:00,43c9a59165f9f676293c76180fc23865,0,14,1,3,7,25
4954,1702,2022-10-18 10:03:00,c67110f5ccf31f128f9b59ba4d25bab9,0,12,0,1,11,24
4955,1702,2022-10-18 10:08:00,5f645a51d69cdce14b59d2534c70c45c,0,14,0,3,17,34
4956,1702,2022-10-18 10:12:00,681f2bbe190a76717cc2d56b2e7d1847,1,9,0,10,11,31
4957,1702,2022-10-18 10:18:00,a4351d70feb2914a4b42816f5ac2cdfd,0,11,0,5,13,29
4958,1702,2022-10-18 10:22:00,fb9ffc5375da88d641f65790325c60a9,0,13,0,3,9,25
4959,1702,2022-10-18 10:28:00,ca3d0d4677a1ee2d815605bd9ba711fe,0,14,0,6,9,29
4960,1702,2022-10-18 10:31:00,f36b930f3fe4e2bb244a3f94827aea34,0,17,1,1,7,26
4961,1702,2022-10-18 10:37:00,e030d42086f7de9dee8c8ac9f2c0ab96,0,15,1,1,12,29
4962,1702,2022-10-18 10:42:00,f596d5bf2bf3e0c03e9c9879d83b0ee8,1,3,1,1,13,19
4963,1702,2022-10-18 10:47:00,0e948f2bb39537c44ee32e0d60421365,0,11,0,1,13,25
4964,1702,2022-10-18 10:53:00,b813af86ca9efe0df9ffe5e1b907f33b,0,13,0,2,7,22
4965,1702,2022-10-18 10:56:00,dad100ce636255bd21b585ef2896f5fe,0,10,0,2,8,20
4966,1702,2022-10-18 11:02:00,3975e1d0fc3b65c58a37656283f82c7f,2,10,0,3,9,24
4967,1702,2022-10-18 11:07:00,f1cf2750bfe19506e5cf1bda9a7b9323,1,14,0,4,7,26
4968,1702,2022-10-18 11:12:00,6663ff988010a3fdd2c200953b53a233,0,16,0,5,6,27
4969,1702,2022-10-18 11:17:00,d13dc9db49a128e92812289249ff3bc7,0,15,0,2,8,25
4970,1702,2022-10-18 11:22:00,bc8fcf7f44b0d96f474b166f0ab2de6a,0,13,0,6,10,29
4971,1702,2022-10-18 11:27:00,e49e46aa373864d1067c39bd200e6aec,0,9,0,3,7,19
4972,1702,2022-10-18 11:32:00,47fe7139388ea993e3fb6f50747d1b95,0,15,0,1,6,22
4973,1702,2022-10-18 11:38:00,4de1c87db6e37429ac9d4c80fd41f949,1,16,0,3,8,28
4974,1702,2022-10-18 11:42:00,86cae36d687ee8f2e06b8bb5dc354d5d,0,19,0,2,8,29
4975,1702,2022-10-18 11:49:00,0de451d8f4b20b884cfc79142c831ccb,0,12,1,1,9,23
4976,1702,2022-10-18 11:53:00,199049843d494f419a8633f7b34004af,1,15,0,0,13,29
4977,1702,2022-10-18 11:57:00,66347b77c85f7574cc504f2dde2112be,0,10,0,5,11,26
4978,1702,2022-10-18 12:02:00,caa645ffc3ff926685b3700a8b96a7dd,0,14,0,2,9,25
4979,1702,2022-10-18 12:06:00,7cd59435c96f12dda8c1dba89ac463ee,0,10,0,0,11,21
4980,1702,2022-10-18 12:12:00,4084b9d3b891870c4b34c9322485e135,0,10,0,2,15,27
4981,1702,2022-10-18 12:17:00,db2a78f303a81e0f5649f333939bce44,0,14,0,5,10,29
4982,1702,2022-10-18 12:23:00,f5ff1d86bdfe54aabf2d3cf51cc236c7,1,13,0,1,8,23
4983,1702,2022-10-18 12:27:00,7234238a80ad21d416343b06ff85786d,1,18,0,2,3,24
4984,1702,2022-10-18 12:32:00,4660b52bd1eb64abc00cbc92d0af1451,0,14,0,6,4,24
4985,1702,2022-10-18 12:39:00,d2b3923b592f3b4f83ed1694c85892b0,0,12,0,2,9,23
4986,1702,2022-10-18 12:42:00,a93f88bd5b5f282a6a13d9fd15013baf,0,15,0,3,7,25
4987,1702,2022-10-18 12:47:00,72856a6f6628067eb6852c4ace173665,1,16,1,3,6,27
4988,1702,2022-10-18 12:52:00,164a1b940e35635bf99cb979042c542b,0,11,0,1,13,25
4989,1702,2022-10-18 12:57:00,5075d10251d8881695adad2fb4b9f01f,0,12,0,1,10,23
4990,1702,2022-10-18 13:02:00,077a70678fce85af5681eac7106b1277,0,13,0,1,9,23
4991,1702,2022-10-18 13:07:00,0a617da0d7c65c341e053991120bbbba,0,7,1,0,9,17
4992,1702,2022-10-18 13:12:00,8d9247d73eb3d26107e86c8f37745686,0,18,0,1,3,22
4993,1702,2022-10-18 13:17:00,407d4fe6415d8c1ea283ad3acb83f544,0,10,0,0,9,19
4994,1702,2022-10-18 13:23:00,20b7e45ce132a7af4778663768cb2dd3,1,8,0,1,9,19
4995,1702,2022-10-18 13:27:00,beb74b68b9514b374d79910a59df1182,0,12,0,3,13,28
4996,1702,2022-10-18 13:32:00,d0b86448fc00bc03f8b0ee5f57182891,0,17,1,5,6,29
4997,1702,2022-10-18 13:37:00,3c820b7adab4e08994cd71a865c5e61f,0,12,0,1,10,23
4998,1702,2022-10-18 13:42:00,98914b1497054848394205730d68455c,0,17,0,6,7,30
4999,1702,2022-10-18 13:48:00,5b6ecafba90e51b7181357e4e652af12,0,20,0,6,3,29
5000,1702,2022-10-18 13:52:00,e8a97128b5f4ba1f2c16a3cbba22ae2f,1,19,1,5,4,30
5001,1702,2022-10-18 13:57:00,a439bd93dae80f9b509ce30ed65375b0,0,17,0,0,9,26
5002,1702,2022-10-18 14:03:00,92b017e4c18be19ae1087334404aa477,0,15,0,9,5,29
5003,1702,2022-10-18 14:07:00,54d78c46a8add090e8bb296a7a2b902a,0,13,0,2,11,26
5004,1702,2022-10-18 14:12:00,112f188e818bc72b621602d4c9ad7e28,0,17,0,3,8,28
5005,1702,2022-10-18 14:17:00,95db565de7cda6a9eef6350dfd46ad33,0,9,0,2,13,24
5006,1702,2022-10-18 14:22:00,0a974bfe2ce27b06cef780fd9d3d5261,3,14,1,4,7,29
5007,1702,2022-10-18 14:26:00,74cfaa955657a38672ef5b60cc0e1de6,0,8,0,1,10,19
5008,1702,2022-10-18 14:32:00,e187767b045d1cc8fa44f9d827b4a59f,0,11,0,2,12,25
5009,1702,2022-10-18 14:37:00,977a9e2cd79d0ba26f3ef41695db9aae,0,6,0,1,12,19
5010,1702,2022-10-18 14:42:00,2732cbe936364373b8459db96804d5b5,0,13,0,2,8,23
5011,1702,2022-10-18 14:47:00,6d74e3d2faa73e4376a89b6b50066245,0,13,0,3,14,30
5012,1702,2022-10-18 14:53:00,8587a101d0316829d4f158c912c4ac3e,0,7,0,1,14,22
5013,1702,2022-10-18 14:56:00,25e361cc0774a69f81c9aeaeb52a5a23,1,21,0,1,7,30
5014,1702,2022-10-18 15:03:00,bdbf464f5a237782dcfdf49c624fb73c,0,14,0,0,10,24
5015,1702,2022-10-18 15:07:00,376d6be9b392b6b92bdecd4881c538a9,2,12,1,2,8,25
5016,1702,2022-10-18 15:11:00,3d94c886a51be7cbe4fbd3c9654cdb80,0,15,0,2,9,26
5017,1702,2022-10-18 15:18:00,e94a7eea82830575f8bf516c3d1b4e92,0,14,0,1,13,28
5018,1702,2022-10-18 15:22:00,8893997d6338f8d245b388e5f39772ce,0,12,0,2,16,30
5019,1702,2022-10-18 15:27:00,9839b8a2d830e9bd77ba492bc112172a,1,8,0,1,7,17
5020,1702,2022-10-18 15:33:00,7b2a5fb4b353e636a1813826c0f09171,0,6,0,2,11,19
5021,1702,2022-10-18 15:38:00,75764fcdb31caddfb4c2323111f9ca4f,0,10,0,0,12,22
5022,1702,2022-10-18 15:41:00,1be73aa5b6ce65fac10460a417f36cb8,0,8,1,6,6,21
5023,1702,2022-10-18 15:47:00,9859339bb3eab5e4cb3821622cb5d1a5,0,10,0,0,7,17
5024,1702,2022-10-18 15:53:00,cd1f75d2360a264ba3a9c22b5858e8b0,3,6,0,3,17,29
5025,1702,2022-10-18 15:56:00,4ac0c7ac6655271264ef09fa045f50ff,1,11,1,3,7,23
5026,1702,2022-10-18 16:02:00,b80d952f5584b6dc3b20d76b0d2eac81,0,13,0,2,6,21
5027,1702,2022-10-18 16:07:00,62ea5e4d02fc07b86ba225d488676269,0,8,0,1,10,19
5028,1702,2022-10-18 16:13:00,8af78a99d119d016241bbd41723881f1,0,12,0,5,16,33
5029,1702,2022-10-18 16:18:00,009edec031cba684a1deea3a6f7509e5,1,10,2,3,10,26
5030,1702,2022-10-18 16:22:00,1c9126d393276352f7d2e66f71fab1a6,0,16,0,2,9,27
5031,1702,2022-10-18 16:27:00,c46e6a6dcce37b7017c8deb2e10d3e1d,0,6,1,4,7,18
5032,1702,2022-10-18 16:32:00,2858deb813f7704fce6d9c9c485ef9ed,1,9,1,1,13,25
5033,1702,2022-10-18 16:37:00,31171d753a8e47f995d9ac08f65bcc0d,0,13,0,2,12,27
5034,1702,2022-10-18 16:43:00,e3e98bbe5d2522096727eb1cdd58b546,0,7,0,0,15,22
5035,1702,2022-10-18 16:47:00,637cb42703595de28810fc92588c6520,1,17,0,3,11,32
5036,1702,2022-10-18 16:52:00,8b4891b3d0e973da52ff537f45abd3ef,0,15,0,5,6,26
5037,1702,2022-10-18 16:57:00,ed33c9b305893c633abeac9c3c7fba6b,0,12,1,1,9,23
5038,1702,2022-10-18 17:02:00,d83e70bb0184d7ddcc8a989c8e37e160,0,12,0,0,10,22
5039,1702,2022-10-18 17:07:00,f9390400d5a39c4211bc7f465c972977,0,14,0,1,11,26
5040,1702,2022-10-18 17:12:00,6b8b3c844da38cedcd69f2b4dba29fef,0,15,0,1,9,25
5041,1702,2022-10-18 17:17:00,1f82bb9ce9989cd74b4f6d2bfafb04c3,0,10,0,3,14,27
5042,1702,2022-10-18 17:22:00,781825af76eb8724f6efca14af4e5756,1,19,0,4,5,29
5043,1702,2022-10-18 17:26:00,da6ac02bb170af1af812cb6cd6ae5f79,0,15,0,6,12,33
5044,1702,2022-10-18 17:32:00,82bbad7bd24f901b4f0ff32e75773cf2,0,13,0,8,11,32
5045,1702,2022-10-18 17:36:00,0c7776d4f57a4d294251c82dd3622734,0,15,0,4,13,32
5046,1702,2022-10-18 17:42:00,1793b3831696799c95da1b63da7546fe,0,16,0,5,13,34
5047,1702,2022-10-18 17:47:00,6379df349c8876cd2ed3e3dc60e4e5cb,2,16,1,1,14,34
5048,1702,2022-10-18 17:52:00,55a48130bb4b4979198fa6425fa1aee4,0,22,2,2,7,33
5049,1702,2022-10-18 17:57:00,609bcda2658fb3e4b854216a39f7dd91,1,18,0,3,12,34
5050,1702,2022-10-18 18:02:00,a433b1d77f2dc8682f8ed19cdb2da488,0,19,0,9,11,39
5051,1702,2022-10-18 18:06:00,3200ed8f2f1adefcfadf7a6d4cb02fac,0,12,1,6,14,33
5052,1702,2022-10-18 18:12:00,9bd22cbe5c8e31e7d76e444f8ff04507,0,13,2,0,16,31
5053,1702,2022-10-18 18:18:00,ae2d444800ae0cd1c89306d6f1f261e0,0,24,0,1,5,30
5054,1702,2022-10-18 18:22:00,22b269ee8c010fe1d67f6a0a3c4fee72,1,20,0,6,6,33
5055,1702,2022-10-18 18:26:00,d99a0c3a6b9ffa229fb5278a66030834,0,17,0,3,9,29
5056,1702,2022-10-18 18:32:00,cd56a4f56a36b8f124f984937f3fb821,2,12,0,1,14,29
5057,1702,2022-10-18 18:37:00,5d97f62c1c7ce26070cd9545da795890,0,12,0,3,11,26
5058,1702,2022-10-18 18:41:00,378a418b1c28be534579a2fe6ba6a56a,0,17,1,1,8,27
5059,1702,2022-10-18 18:47:00,fd2b4397687087769f5deb8224d6228f,1,21,0,0,9,31
5060,1702,2022-10-18 18:52:00,938202cbd0a039bffeb610cb90c3e5d3,0,18,0,0,9,27
5061,1702,2022-10-18 18:57:00,e21facb59f3fa4aebcf0f23a40dee1f2,0,20,1,1,2,24
5062,1702,2022-10-18 19:02:00,9fbced49d83c1d775bfceafdb285834a,0,20,0,1,6,27
5063,1702,2022-10-18 19:07:00,548728c3d36d0a5887ccc23e810aefec,0,17,1,1,0,19
5064,1702,2022-10-18 19:12:00,298550787d808dfb8804666180e29f8e,0,21,0,1,1,23
5065,1702,2022-10-18 19:17:00,7904ac91c8c05287331836f03cd4bfd0,0,25,2,0,1,28
5066,1702,2022-10-18 19:22:00,bb4ff5015f4f883124b0b2c01a4277b3,0,16,1,0,1,18
5067,1702,2022-10-18 19:27:00,e8d27834c8d23c29489e0c3a1c87ece5,0,20,0,1,1,22
5068,1702,2022-10-18 19:32:00,0e6f4ed15cc180e090e59ac07fc6b1da,0,19,0,1,1,21
5069,1702,2022-10-18 19:37:00,fbcc03e8b9ba80c080890cf23307a256,0,13,0,0,5,18
5070,1702,2022-10-18 19:42:00,f053ffdb2dd2cf8f84a20e989ce6be33,0,19,0,0,0,19
5071,1702,2022-10-18 19:47:00,ded51e579d044f3f7dc0d45bb1ae39b0,0,14,0,1,0,15
5072,1702,2022-10-18 19:53:00,93166186be1baf1e41d774fd48e5a8e2,0,20,3,1,0,24
5073,1702,2022-10-18 19:56:00,55a413e0ccf2b3b0003f3fb09f1a6561,0,10,0,0,2,12
5074,1702,2022-10-18 20:02:00,707fa08e2fb2f09963be8870d473afbc,0,13,2,0,1,16
5075,1702,2022-10-18 20:08:00,e92dc10d7fafcfa33ba8257a9dacc7bc,0,9,0,0,1,10
5076,1702,2022-10-18 20:12:00,e1b3b0bad5b5bae0a57e93330d47c0f5,0,14,0,2,1,17
5077,1702,2022-10-18 20:17:00,2f43784376bcfb3a6a0f314a0d8ff0f4,0,19,0,3,0,22
5078,1702,2022-10-18 20:22:00,380ce713a9f9a0b3bc869129a4868b30,0,14,1,0,0,15
5079,1702,2022-10-18 20:27:00,b58ea8228e499b0c35e5de63ff9c4af5,0,13,0,0,1,14
5080,1702,2022-10-18 20:32:00,4aa287c941e3b10be888ac2b866ad315,0,18,0,2,1,21
5081,1702,2022-10-18 20:37:00,a8f92dfe0e827d141a2fa8d0b29cd0f7,0,22,0,0,1,23
5082,1702,2022-10-18 20:41:00,02b3fc9d71d26107c8677f66ccb48f50,0,17,0,0,2,19
5083,1702,2022-10-18 20:47:00,39365077d17ce536c048dbf5eb50d460,0,12,0,3,1,16
5084,1702,2022-10-18 20:52:00,7bf6a6d4eb335e74a28512db163c6d34,0,21,0,0,0,21
5085,1702,2022-10-18 20:56:00,2ed8ca3108951309589c73a86ce74c3b,0,16,1,0,1,18
5086,1702,2022-10-18 21:02:00,7b50797850cb8034c00f0b34fc5fe465,0,16,0,0,2,18
5087,1702,2022-10-18 21:07:00,298d1c68fbd9e4eefb2e31a0d5111ec4,0,21,2,0,0,23
5088,1702,2022-10-18 21:11:00,ed0f34fc712466812689fae3dcc1b6de,0,16,0,2,0,18
5089,1702,2022-10-18 21:17:00,ce049575f37c5e498a9bf80fb0ae323e,0,8,2,2,0,12
5090,1702,2022-10-18 21:21:00,2d8d4d25a28100701e6ae4aaa58586c3,0,12,0,1,1,14
5091,1702,2022-10-18 21:26:00,c7455d31a0db7d43a5a0783d15d0e4a7,0,20,0,2,0,22
5092,1702,2022-10-18 21:32:00,fb171a3a5f3f1abed5d849565ba9a339,0,20,0,0,0,20
5093,1702,2022-10-18 21:37:00,fb1ac5bf0cc3edbf5813e20ed515b1cf,0,15,0,0,0,15
5094,1702,2022-10-18 21:41:00,04a8ec3c217c2eedddb3948f9237ea96,0,20,0,1,1,22
5095,1702,2022-10-18 21:46:00,672b632b731ad1ddf66669d1427edd0b,0,15,0,0,0,15
5096,1702,2022-10-18 21:52:00,9142c08fb91a1f4c4eecbd3159c557fa,0,15,0,0,0,15
5097,1702,2022-10-18 21:57:00,f383122f972ab49328dc15c8ac48a314,0,11,0,0,2,13
5098,1702,2022-10-18 22:02:00,025a541ed7c46f6f89628813e921e4e1,0,16,0,1,0,17
5099,1702,2022-10-18 22:06:00,bed0acec1f38e84eacf1908a099254de,0,15,0,1,0,16
5100,1702,2022-10-18 22:11:00,bdc36dab00b1f31405501b7cd5b7f3de,0,3,1,0,1,5
5101,1702,2022-10-18 22:18:00,aeb35b99f403e69a6737ea609e2c4f35,0,18,0,0,0,18
5102,1702,2022-10-18 22:22:00,aa24230149e77d7284b247f36e04c7d6,0,15,0,1,1,17
5103,1702,2022-10-18 22:27:00,d7e7dde173e387fb6abd2e5783078d18,0,17,0,1,0,18
5104,1702,2022-10-18 22:32:00,f582197fa304fa1cf919cc32e16fb7bb,0,9,0,1,2,12
5105,1702,2022-10-18 22:37:00,b8e4a9ac3934e4afe1eae358f994aaba,0,11,1,0,2,14
5106,1702,2022-10-18 22:42:00,8328c74c2e3b888c729f4f176c062ca4,0,13,1,0,0,14
5107,1702,2022-10-18 22:47:00,4607ea521a9023ce2ae06d06e481feab,0,17,0,0,1,18
5108,1702,2022-10-18 22:51:00,606d632eaddf4e5291348a55c017df92,0,9,1,0,2,12
5109,1702,2022-10-18 22:56:00,183e828cad13b9fd0817290b737a4a92,0,8,0,0,1,9
5110,1702,2022-10-18 23:02:00,72015832681ec02b5bbc373fe44ebea8,0,12,0,0,3,15
5111,1702,2022-10-18 23:07:00,9e4f30b058e1ca46e4fc0e44722ca804,0,1,0,0,0,1
5112,1702,2022-10-18 23:12:00,ddfbb67d77c5f0256eee95e29d295a71,0,20,0,0,0,20
5113,1702,2022-10-18 23:17:00,d6e2fdd9bf73748fd90126afabd80688,0,12,0,0,0,12
5114,1702,2022-10-18 23:22:00,7a16ebbe2f7d1cc2a69b74311bdc9875,0,14,0,1,0,15
5115,1702,2022-10-18 23:27:00,3b5e4ca4ca6a8c994fe7260c402316dc,0,8,1,0,1,10
5116,1702,2022-10-18 23:33:00,170a2c6add2a4d1f67543b20f47408fb,0,10,1,0,1,12
5117,1702,2022-10-18 23:36:00,b0b88023049caa4c9a47208cdcf4c2a8,0,7,1,1,1,10
5118,1702,2022-10-18 23:41:00,82b7365f5477677946c8a69a04dc8fb1,0,10,1,2,2,15
5119,1702,2022-10-18 23:47:00,eb6d61836d77bf1dd3892b25342612a8,1,8,1,0,0,10
5120,1702,2022-10-18 23:51:00,73aa3d5a613a461ce316440341baca45,0,5,5,0,0,10
5121,1702,2022-10-18 23:56:00,ab7a51894a0962a5edd27c06bbe3dcfc,0,2,0,0,1,3
5122,1702,2022-10-19 00:01:00,6435cd68f1be95289569e77da5b0696a,0,9,0,0,0,9
5123,1702,2022-10-19 00:07:00,db3eec04ca7a100359dc0cf0e936937a,0,2,1,0,0,3
5124,1702,2022-10-19 00:11:00,e47561d6434222d1cd7e0458c4a860c5,0,13,0,0,1,14
5125,1702,2022-10-19 00:17:00,aa18ab8940b6c9744a85a60e419daf85,0,7,2,0,0,9
5126,1702,2022-10-19 00:21:00,7a63c82b41ea5917331d0b8482ab608f,0,8,0,0,0,8
5127,1702,2022-10-19 00:27:00,5f8916ec387c51436139fde13bc68624,0,12,0,0,0,12
5128,1702,2022-10-19 00:31:00,3d5cc90d01c068aae1e5640e8ef02742,0,5,0,0,0,5
5129,1702,2022-10-19 00:37:00,e9a7e997b77ff47acb391b94a8b91e34,0,10,1,0,0,11
5130,1702,2022-10-19 00:41:00,85b978595c34004064e076fd5ce834c3,0,8,0,0,1,9
5131,1702,2022-10-19 00:47:00,eab9617c530a203a8e773437889eeb2b,0,7,1,0,1,9
5132,1702,2022-10-19 00:51:00,2677156e908207332da709f048903f48,0,8,0,2,0,10
5133,1702,2022-10-19 00:57:00,8cf020cf7c258747c84a6979d332ae8d,0,3,2,0,2,7
5134,1702,2022-10-19 01:02:00,49948fc2bee273bdf5f253a06463030d,0,3,2,0,1,6
5135,1702,2022-10-19 01:07:00,b6ba58fac78eb94516d1bad84ab834cb,0,7,0,0,0,7
5136,1702,2022-10-19 01:11:00,6e28ac9de5da031ec557255505e83801,0,10,0,0,0,10
5137,1702,2022-10-19 01:17:00,cd710643943e65c9afd8144c42b2261d,0,7,0,1,0,8
5138,1702,2022-10-19 01:22:00,5d1ce1beb5c2969800208bb479d6eaac,0,9,0,1,0,10
5139,1702,2022-10-19 01:26:00,4308c2504b5312c491c068c711ca1f79,0,6,0,1,0,7
5140,1702,2022-10-19 01:31:00,fcb373bf666d10cbd5f9f85f534835bd,0,3,0,1,0,4
5141,1702,2022-10-19 01:36:00,f9d8a224851391a8fa6479fd54c8dad4,0,3,1,1,0,5
5142,1702,2022-10-19 01:41:00,d4818e516a666302ff722b37492a17be,0,5,0,0,1,6
5143,1702,2022-10-19 01:47:00,872192b4345e730c2056af70cd9210ee,0,4,0,1,0,5
5144,1702,2022-10-19 01:51:00,442104c72d5bb5e8b878bd04004b2793,0,9,0,1,1,11
5145,1702,2022-10-19 01:56:00,7ffc1f483d8b0b2b50ffe439a354945b,0,6,0,0,1,7
5146,1702,2022-10-19 02:01:00,6f1151f27f8838ee8fb172a1d0b7586f,0,6,0,0,0,6
5147,1702,2022-10-19 02:07:00,e0cd1915fe09eaae8c5c2519a718368c,0,2,0,0,0,2
5148,1702,2022-10-19 02:11:00,16a7d33aa751cec8d6fdeea00607c408,0,4,0,0,1,5
5149,1702,2022-10-19 02:17:00,4cf23cb25a90609e1f3dce8a8eec57cb,0,8,0,1,0,9
5150,1702,2022-10-19 02:21:00,532f0a087aeefb02d30377a21872dd3c,0,6,1,0,0,7
5151,1702,2022-10-19 02:27:00,8425962f9d0e7bef8718c800704d1a9f,0,4,0,0,1,5
5152,1702,2022-10-19 02:32:00,43f22ef76aab64f6e46c29afb926ca56,0,5,0,0,0,5
5153,1702,2022-10-19 02:37:00,89493ec8cce15c9836381e803570a577,0,6,0,0,0,6
5154,1702,2022-10-19 02:41:00,41b3ded3ccfa977c488097c850e75a47,0,14,0,0,0,14
5155,1702,2022-10-19 02:47:00,35a4e026da56ed6b0036e50ddcdd3035,0,5,0,0,0,5
5156,1702,2022-10-19 02:51:00,d31e68ffdbc8fc881cd56395af84f0b3,0,9,0,0,0,9
5157,1702,2022-10-19 02:56:00,fd29f943d7734b29cdff89a7961c8496,0,2,0,0,0,2
5158,1702,2022-10-19 03:01:00,df5781df3612834ae9323711ff1f495d,0,2,0,0,0,2
5159,1702,2022-10-19 03:07:00,bffe48c0fba185ff90a27497657087bf,0,9,0,0,0,9
5160,1702,2022-10-19 03:11:00,9819ba9ec192c6125419fc71f489e6ec,0,4,0,0,1,5
5161,1702,2022-10-19 03:17:00,c6145eb30f3616d22dce816a2bb33ce2,0,2,0,1,0,3
5162,1702,2022-10-19 03:22:00,0f185b38b84d930543ec9a754a0c90a7,0,3,0,0,0,3
5163,1702,2022-10-19 03:26:00,746450acfa307cec0b80e57bce5a7ade,0,9,0,1,0,10
5164,1702,2022-10-19 03:32:00,6d1f69eea78612c8e5c07d59f34cecaf,0,6,1,1,0,8
5165,1702,2022-10-19 03:37:00,a8346cdc75f61e59c659fc3a2cf476bd,0,2,0,0,0,2
5166,1702,2022-10-19 03:41:00,0059c2c0a638df67e91608cbe487b882,0,4,0,0,0,4
5167,1702,2022-10-19 03:47:00,0cb06a2e4a6d39e4ab83541b322b1b55,0,6,0,0,0,6
5168,1702,2022-10-19 03:52:00,22ea9216fd21efe6ab32a47ede64d329,0,0,0,0,0,0
5169,1702,2022-10-19 03:56:00,8ffaad38526a966b29f0b4b3146ebae1,0,1,0,0,0,1
5170,1702,2022-10-19 04:02:00,f250a6176eceb3313d75f9dc6593e521,0,5,0,0,1,6
5171,1702,2022-10-19 04:06:00,8b1c33296c349c0b2d32c09b9cf3c27c,0,6,1,0,1,8
5172,1702,2022-10-19 04:12:00,3274c1c1b5609d4f934f55caba4ae9f3,0,7,0,0,0,7
5173,1702,2022-10-19 04:17:00,d4233badf93ca40e52d893e46c1089a6,0,1,0,0,0,1
5174,1702,2022-10-19 04:21:00,6f7e1fc5d4b0473a558bfb995c101799,0,1,0,0,0,1
5175,1702,2022-10-19 04:26:00,6cbe330c2efa1cd8cc36606b1cbd43bb,0,5,0,0,0,5
5176,1702,2022-10-19 04:32:00,600a14129b39738bfe22523e2e4934a9,0,2,0,0,0,2
5177,1702,2022-10-19 04:36:00,a8ca4e41d14e9cc8d4428389c6efe733,0,3,0,1,0,4
5178,1702,2022-10-19 04:41:00,8ddb53a70702e3514369081e70eccb82,0,1,0,0,1,2
5179,1702,2022-10-19 04:47:00,88f70ff7fd94b5406aee8a3ac2184901,0,6,0,0,0,6
5180,1702,2022-10-19 04:51:00,a5563959a303431a43dd00e27acf6ded,0,1,0,0,0,1
5181,1702,2022-10-19 04:57:00,99616e3ab56d897df5a95b2f1c7a04d6,0,8,0,0,1,9
5182,1702,2022-10-19 05:01:00,07642225e57e46bd41d8a113d7082479,0,7,0,0,0,7
5183,1702,2022-10-19 05:06:00,89ebd5f22d475ad38ff44ca8f4ef73fd,0,4,0,0,0,4
5184,1702,2022-10-19 05:11:00,e45799ce281cc2553cad584a516bf912,0,5,0,1,0,6
5185,1702,2022-10-19 05:16:00,f80388c828dc4bf4a960c29f770b68e8,0,2,0,0,0,2
5186,1702,2022-10-19 05:22:00,7c3cb8cf24428d952db71e2b58708c3b,0,1,0,2,0,3
5187,1702,2022-10-19 05:27:00,d1e844befe34018adf5882df9bf3b784,0,8,0,0,1,9
5188,1702,2022-10-19 05:32:00,cf42704a788643ec85e00504c336901e,0,0,0,0,0,0
5189,1702,2022-10-19 05:36:00,dec76bd012e4cbff84298c09f9ee3836,0,4,3,2,0,9
5190,1702,2022-10-19 05:42:00,c9d05ca0ad4d8e1dd1cfc660d4e8c77d,0,4,1,0,0,5
5191,1702,2022-10-19 05:46:00,a6c42dd89c0d457eef269890d03d41b9,0,4,0,2,0,6
5192,1702,2022-10-19 05:52:00,2e5acb1cb17d71e5ca1fb4e46967408e,0,8,0,0,0,8
5193,1702,2022-10-19 05:57:00,c327251c58edccbb699fec605afc8f28,0,6,0,1,0,7
5194,1702,2022-10-19 06:01:00,b44e652dffbf8393a081e7c6b96d73cb,0,9,0,0,0,9
5195,1702,2022-10-19 06:07:00,d03b49721bc30f73949d81eec3da81e9,0,4,0,0,0,4
5196,1702,2022-10-19 06:11:00,7d0a3c7ba6f01657de7c48713da6ed4d,0,6,1,0,1,8
5197,1702,2022-10-19 06:17:00,f88b4f45030281df9236fe03a030d47d,0,3,2,0,1,6
5198,1702,2022-10-19 06:22:00,83ce83a600f2abe10aaa7626822618ad,0,8,1,1,0,10
5199,1702,2022-10-19 06:27:00,dc111bfbfc8dd104fb18a30d5e6208f5,0,8,0,0,1,9
5200,1702,2022-10-19 06:31:00,5d530be2b587d12a53b1baedc505ccee,0,3,1,2,1,7
5201,1702,2022-10-19 06:36:00,fe5cb507ad33c3e02ffaa611a8ae9fc6,0,15,0,0,0,15
5202,1702,2022-10-19 06:41:00,a7c36f14a6477a4535c39235c743dd1a,0,15,1,2,2,20
5203,1702,2022-10-19 06:47:00,8c14f32a30f4c17e0249bedec0d5a287,0,12,1,0,0,13
5204,1702,2022-10-19 06:52:00,e7aa24cc9913623fb05ddb143625d65a,0,15,1,1,6,23
5205,1702,2022-10-19 06:58:00,0c0649056ce5e9782299bc66f8bed476,0,16,0,0,6,22
5206,1702,2022-10-19 07:02:00,90ac75f528f288f198abfe2e5293f536,0,13,0,2,5,20
5207,1702,2022-10-19 07:07:00,ac759558f89865ea21d6945cf70f6d82,0,19,0,2,5,26
5208,1702,2022-10-19 07:11:00,f703b0a089e5eb47e6ee09478bd097d7,1,19,0,0,7,27
5209,1702,2022-10-19 07:17:00,63b884d3fcf6494f0d96818ffeb51a94,0,16,2,0,6,24
5210,1702,2022-10-19 07:23:00,b5163c8058c6a331796eb0611b46ebb6,1,18,0,0,10,29
5211,1702,2022-10-19 07:27:00,bf5c94cdafa5fdb712c75c8957aad136,1,14,2,0,8,25
5212,1702,2022-10-19 07:32:00,a3fb40d3ee237708077bea7f3dac816a,0,15,0,2,11,28
5213,1702,2022-10-19 07:37:00,f00bbb81f1a015174da0bc670ea03e38,1,17,1,1,5,25
5214,1702,2022-10-19 07:42:00,8419c751dcccae1f4d18cf1ca4f75597,0,13,0,1,10,24
5215,1702,2022-10-19 07:47:00,35c95ee201f806d5ad03421b4abe0732,0,16,0,2,10,28
5216,1702,2022-10-19 07:53:00,edb3291972c7951bc4ea66a19c970afd,1,10,0,0,12,23
5217,1702,2022-10-19 07:56:00,c9a5de0261118b06a6807ca6ab71233d,1,16,0,2,12,31
5218,1702,2022-10-19 08:02:00,606430f4f4b91e13207858b9f40cf3f6,0,22,0,2,4,28
5219,1702,2022-10-19 08:07:00,b9474c558598ec31b9ed5ff413c2b979,0,17,1,5,5,28
5220,1702,2022-10-19 08:12:00,99a71d3e8fa2da90e9fb1874c10e1f39,0,14,0,2,5,21
5221,1702,2022-10-19 08:17:00,74736782bc062bfae6f8ec9ab63be94c,0,13,1,0,11,25
5222,1702,2022-10-19 08:22:00,7dc145102663d4b6ad094a86557c8fed,1,20,0,1,7,29
5223,1702,2022-10-19 08:28:00,8ee5bed4cf57830183567519caa69d13,1,12,2,4,10,29
5224,1702,2022-10-19 08:32:00,c5fa830d289afe2c18902c925537d711,0,12,0,2,8,22
5225,1702,2022-10-19 08:37:00,0060cb8698cb21173b4ea842a236c21c,0,13,0,0,12,25
5226,1702,2022-10-19 08:42:00,84a901ec3c9fe12c8e00fa3f64f34763,0,22,1,1,4,28
5227,1702,2022-10-19 08:47:00,eea9432d7aef2089d4b7fbf10bb05bd5,0,17,0,3,6,26
5228,1702,2022-10-19 08:53:00,f58a22f3fffdcf353f486532edd3842f,1,14,0,1,9,25
5229,1702,2022-10-19 08:57:00,f890e91d0c0da7784fce1015dc5416fe,1,24,0,3,2,30
5230,1702,2022-10-19 09:02:00,c10ed9e5f676e9c010c8af87a1ca09c6,0,25,0,0,0,25
5231,1702,2022-10-19 09:07:00,63ea3a98c2ffe22c675d9bdfc76813c4,0,17,0,0,4,21
5232,1702,2022-10-19 09:12:00,e78f6d3ca86e3aafc93d213e96a9d289,0,19,0,0,3,22
5233,1702,2022-10-19 09:17:00,ce276cd6c7b73b554d3ada99ce87875b,0,15,0,3,10,28
5234,1702,2022-10-19 09:22:00,a9a8d5c1557462237635b6b1012c5be1,1,13,0,0,11,25
5235,1702,2022-10-19 09:27:00,baf0d46c4599002943b30b83b4a30b7a,0,13,0,1,7,21
5236,1702,2022-10-19 09:32:00,d36a4bc2514fb200fa35271b1ddfda47,0,19,0,1,7,27
5237,1702,2022-10-19 09:38:00,169ae3edd18b38a9bdc9c945b2650a68,0,12,0,1,9,22
5238,1702,2022-10-19 09:42:00,7c6b2134b3dd659bfefd1b719f49aca8,1,12,0,2,14,29
5239,1702,2022-10-19 09:47:00,7c5f31cfe71d123549ac524b914881df,1,17,0,2,9,29
5240,1702,2022-10-19 09:52:00,237c0f08e89fe60fb04c5377a55202b2,0,14,1,3,12,30
5241,1702,2022-10-19 09:57:00,d2df24f1ebdda0f5c750ed151bf69953,0,10,0,0,10,20
5242,1702,2022-10-19 10:02:00,6e3f3ff38a9e5870d4dff51284a4efea,0,12,0,2,13,27
5243,1702,2022-10-19 10:07:00,9be498e808e9740e4e7541424f4150d4,0,15,0,3,11,29
5244,1702,2022-10-19 10:12:00,7e8502ca1e4530975efa05c8f74500ee,0,9,0,0,20,29
5245,1702,2022-10-19 10:17:00,d7c69b88461312124fb55600ae407045,0,15,0,0,16,31
5246,1702,2022-10-19 10:22:00,d81af7463ebb4fec069c14bd95335524,3,10,1,2,12,28
5247,1702,2022-10-19 10:28:00,297b56bdfdfca0f04fa94fd77918c5f4,0,17,1,1,10,29
5248,1702,2022-10-19 10:32:00,0f5817718c9257b1d42c2f459cf24817,1,13,0,1,9,24
5249,1702,2022-10-19 10:37:00,9a33d7c3652a73c912ed3dfc74510b15,0,14,0,9,12,35
5250,1702,2022-10-19 10:42:00,5b2aa14f63814e598c9998ad0c38c946,0,12,0,1,14,27
5251,1702,2022-10-19 10:47:00,06e671f08ba1356c255041257b77fb2f,0,13,0,4,13,30
5252,1702,2022-10-19 10:52:00,cff0746fc535da918250464f98daaf79,1,16,1,2,12,32
5253,1702,2022-10-19 10:57:00,8c3d684b22958610150c82e5797a1543,0,8,0,4,9,21
5254,1702,2022-10-19 11:02:00,251feeceeed4d59d96d3028f95874cc1,0,11,0,2,9,22
5255,1702,2022-10-19 11:07:00,4581adf56e7fea6deb7fb46088351841,0,17,0,2,8,27
5256,1702,2022-10-19 11:12:00,1dba8f4c14a03c9465cbb161e9a621d0,1,18,0,1,8,28
5257,1702,2022-10-19 11:16:00,86bbfa8b9cf78d6e212533da9b873f5d,0,10,0,4,10,24
5258,1702,2022-10-19 11:22:00,f22f8ab0bee74f6b7286d76b995b52d9,0,15,0,0,10,25
5259,1702,2022-10-19 11:27:00,2d8f8119991cc88690978ab0d35c1f14,1,12,0,3,14,30
5260,1702,2022-10-19 11:32:00,5f6f0a6139d021bb667e472759b2137e,0,8,0,6,8,22
5261,1702,2022-10-19 11:38:00,daf01b6def85ec1b0f1f59ce8ba9bea1,0,15,0,7,7,29
5262,1702,2022-10-19 11:41:00,bc1c078074284a3301a3e1c082bfcd1c,0,10,0,5,13,28
5263,1702,2022-10-19 11:47:00,b29171697ed1713dd6b3e3775117acc4,0,13,0,6,4,23
5264,1702,2022-10-19 11:53:00,5f9ca62b1bed732f80452f6b75594733,0,8,0,3,5,16
5265,1702,2022-10-19 11:56:00,4015ccb0da6e853d7d8d773dad1d7106,1,20,0,0,6,27
5266,1702,2022-10-19 12:01:00,4bf9c9fb28582f1146c8483cb32e69ec,0,16,0,2,6,24
5267,1702,2022-10-19 12:08:00,5d47e3c74af41096eccf5cda35a667d9,1,15,0,1,6,23
5268,1702,2022-10-19 12:12:00,62d95d7a280393af828f12eee3177393,0,13,0,1,9,23
5269,1702,2022-10-19 12:17:00,3aa0bbd876da9609cec98fff50044999,0,11,1,4,9,25
5270,1702,2022-10-19 12:22:00,b76e0d1edb3e56d8541cc08f50a1a49d,0,14,0,1,9,24
5271,1702,2022-10-19 12:27:00,9249d30f2dadc2d88d5d5ca13b7507bf,0,13,0,1,12,26
5272,1702,2022-10-19 12:32:00,2990444c3d504c442f17dd438e0419d2,0,19,0,2,4,25
5273,1702,2022-10-19 12:37:00,f8d5cf52fb80b8a840289c8515e69ee3,0,16,0,3,8,27
5274,1702,2022-10-19 12:42:00,d764f5ca56a5ec7e4253d53d6224299a,0,11,0,1,8,20
5275,1702,2022-10-19 12:47:00,6927b8ec85fb3757eabd2f2f8b767824,0,12,0,1,12,25
5276,1702,2022-10-19 12:53:00,4ffbf003da05b359c74dacb7fc384f49,1,17,0,1,5,24
5277,1702,2022-10-19 12:57:00,75791cb7b692a4aa4f8e8a92744ce5a4,0,11,0,1,12,24
5278,1702,2022-10-19 13:02:00,61a5d877e688d18e933f22d5e40f4be5,0,17,0,1,4,22
5279,1702,2022-10-19 13:07:00,1343b6b7def80084b2071d874b5a1409,0,23,1,0,5,29
5280,1702,2022-10-19 13:11:00,dfad0ddad468f3d1d56b441d0ea18550,0,13,0,1,10,24
5281,1702,2022-10-19 13:17:00,2afecc2602b69edf503856787fbc9c5f,0,16,0,1,11,28
5282,1702,2022-10-19 13:22:00,24070fcf47e5d46efb0423611902487b,0,9,1,8,9,27
5283,1702,2022-10-19 13:27:00,cb5a1e742f6cbdc2bcbc5f5773e60165,0,18,0,2,7,27
5284,1702,2022-10-19 13:32:00,96ce927f1863032b9abb699a2a7c59fd,0,16,0,0,7,23
5285,1702,2022-10-19 13:37:00,72a42b0347d8a4c2414e5fe6fd28efd7,0,15,0,0,9,24
5286,1702,2022-10-19 13:42:00,803dcae109d6e139d9a79a2f2d0b7f3f,0,13,0,5,7,25
5287,1702,2022-10-19 13:49:00,4aaec2663d33f31ad6f9ab62c8c5fdac,0,14,0,3,10,27
5288,1702,2022-10-19 13:52:00,1e73eca01f96084b89ed81ac99fa6877,0,14,0,2,7,23
5289,1702,2022-10-19 13:57:00,d708f2e00ced6e0c9c602cf3df1772ce,0,20,0,3,14,37
5290,1702,2022-10-19 14:01:00,66602f4570c20d3740a1e90c33e453ec,0,15,0,1,5,21
5291,1702,2022-10-19 14:07:00,cf048002922653f05937275e16c5ce16,0,12,0,3,5,20
5292,1702,2022-10-19 14:12:00,7c44874252ad916b53e0d7d33e4a5aa8,0,14,0,5,8,27
5293,1702,2022-10-19 14:17:00,71118a7bf084f488add85df1ef6a4a5b,0,14,0,5,13,32
5294,1702,2022-10-19 14:22:00,3759402424bb1eafad360455b9dbcc85,0,18,0,2,7,27
5295,1702,2022-10-19 14:27:00,0c1b518c012641e3d16e1d746adfc279,1,18,1,7,10,37
5296,1702,2022-10-19 14:32:00,2dc0c45daec16d75c7e7808a7a6204a3,0,17,1,3,6,27
5297,1702,2022-10-19 14:38:00,0954b732d30fd33a67c80b597ed713eb,0,12,0,3,10,25
5298,1702,2022-10-19 14:42:00,bb4367f88b44f6a54e939466e94b18a3,0,17,0,5,4,26
5299,1702,2022-10-19 14:46:00,7f391c596df1999816bd1e4f461742ea,0,14,0,9,2,25
5300,1702,2022-10-19 14:52:00,d214f81819f93867c2100378c1de61d7,0,14,0,5,7,26
5301,1702,2022-10-19 14:57:00,c51a9f50905c67af2c4c86ad92858b38,0,11,0,3,11,25
5302,1702,2022-10-19 15:01:00,26a8eb6c18dec4f4afba70360355378a,0,13,0,2,7,22
5303,1702,2022-10-19 15:08:00,ac9e2994fba5a4dc1c5fa9856eac62cf,0,20,1,7,0,28
5304,1702,2022-10-19 15:12:00,1508d8b076ef966fd9bd8da20c7c0ad4,0,11,0,3,13,27
5305,1702,2022-10-19 15:17:00,8c4f6f28c4e0df5b8088f4594ffb4b8e,2,10,0,4,8,24
5306,1702,2022-10-19 15:22:00,e99f7adb1433b8497ac69aacc4aa9101,0,12,0,2,8,22
5307,1702,2022-10-19 15:27:00,8facbf10c6cc06cebc59a806012a054d,0,11,0,9,8,28
5308,1702,2022-10-19 15:32:00,92be8785c6d46b35a2c4c802b6921157,0,18,0,1,8,27
5309,1702,2022-10-19 15:42:00,f0c2268053846db97c21a08773bb3ed4,1,14,0,2,7,24
5310,1702,2022-10-19 15:48:00,e5cac4ae7c35d576a89236dcbdbd7336,1,11,0,0,9,21
5311,1702,2022-10-19 15:52:00,099e43ac452a16d043035942348ac58b,0,12,0,6,6,24
5312,1702,2022-10-19 15:58:00,9c157c93fa33d2619e7e76d711f87c08,1,16,1,2,6,26
5313,1702,2022-10-19 16:02:00,af7eb072195f11d7b8cb6ac5f77af2c9,0,14,0,8,6,28
5314,1702,2022-10-19 16:08:00,1093b060be5e9c40733494aabb1a2221,0,13,0,12,2,27
5315,1702,2022-10-19 16:12:00,ed044960c97e2b4a1a2a805705ad1a15,0,12,0,4,4,20
5316,1702,2022-10-19 16:17:00,310ccb44a11d1afeeb57b41ef48869a0,0,10,0,0,13,23
5317,1702,2022-10-19 16:23:00,97e331706ecb32d9d795f0476c959fbe,0,11,1,0,9,21
5318,1702,2022-10-19 16:27:00,6d7e6e5d1347866252d5b1878d04d038,0,17,0,4,8,29
5319,1702,2022-10-19 16:32:00,e89b10aa6c5b1f29694c2c39cf38251a,0,9,0,4,7,20
5320,1702,2022-10-19 16:38:00,b77c748d2fd3c7304f6d0adf8f16a343,0,10,2,1,14,27
5321,1702,2022-10-19 16:42:00,75dac6ff08de4eeffc541e926fe40c60,0,9,1,3,8,21
5322,1702,2022-10-19 16:47:00,85cfaf1842597c09d6b23d1b73cae07c,0,17,0,3,10,30
5323,1702,2022-10-19 16:53:00,66a453886d8272667db22afab79a6405,0,10,0,1,15,26
5324,1702,2022-10-19 16:56:00,563e52357e446157099de08adee4a6b3,0,13,0,4,15,32
5325,1702,2022-10-19 17:03:00,a87057f7144b1caa5ee11d0deae0a909,0,15,0,9,10,34
5326,1702,2022-10-19 17:07:00,9136e112426cf80f64bc95e96bffaae4,0,18,1,1,4,24
5327,1702,2022-10-19 17:13:00,f14bbabf5e7ac7437172f4687df90a19,0,15,0,7,7,29
5328,1702,2022-10-19 17:18:00,b3b833052800f21b4b4d51a889c0f45a,0,22,0,4,9,35
5329,1702,2022-10-19 17:22:00,4a14063d5af75cfb8b04857707453e4f,2,13,0,4,12,31
5330,1702,2022-10-19 17:27:00,07c138ac5d2fcfd072cc75b8bfa588fd,0,16,0,6,3,25
5331,1702,2022-10-19 17:32:00,7a99507136c5d5eaaf79d35a1b472edd,0,16,0,3,10,29
5332,1702,2022-10-19 17:37:00,1f045fcbeb7d96aaa4a33894693788b5,0,19,0,5,13,37
5333,1702,2022-10-19 17:42:00,67f702b060213fd1dfd3aa7735fb8ec2,0,19,0,2,10,31
5334,1702,2022-10-19 17:47:00,c62e0360656f748e15977472f8a9cc3e,0,24,0,2,9,35
5335,1702,2022-10-19 17:53:00,66646ea86515883947e13ebf3d42ecb1,2,15,1,2,10,30
5336,1702,2022-10-19 17:57:00,953f95736947521a4fa1934816e72ff1,3,20,0,2,8,33
5337,1702,2022-10-19 18:03:00,62bf08519b3d177914bb6319ddafbec6,0,15,0,1,13,29
5338,1702,2022-10-19 18:12:00,0b58ee083b1cc91daf4c2eb67182999c,0,16,2,8,7,33
5339,1702,2022-10-19 18:17:00,d3a38a6870537c71a4fc0cad959d9ee6,1,20,1,3,9,34
5340,1702,2022-10-19 18:22:00,1df404c3828d6c063d4706fefffef0ed,0,14,0,3,8,25
5341,1702,2022-10-19 18:27:00,2f6acba764b35f6f18e26333173e8354,0,23,1,0,5,29
5342,1702,2022-10-19 18:33:00,6aa3cac46f936bd01f20678814003224,0,17,0,3,8,28
5343,1702,2022-10-19 18:37:00,6f66f15167e89fcc5b978cd2d9cfb50f,0,16,0,2,5,23
5344,1702,2022-10-19 18:42:00,dbf610f6c9c4c9b7d2f9582e497ebb85,1,16,0,0,12,29
5345,1702,2022-10-19 18:47:00,caa37bb9e7fe475ff38753636d376d95,0,13,0,1,10,24
5346,1702,2022-10-19 18:52:00,5862eedfcd1dde55bfccc2fb84b11a60,0,18,0,1,12,31
5347,1702,2022-10-19 18:56:00,f691f2fb1d6c5e3d7ab61b250041fde9,1,21,0,1,7,30
5348,1702,2022-10-19 19:02:00,e8b1668a209cdfe5572d4da9382cacc0,0,22,0,1,3,26
5349,1702,2022-10-19 19:06:00,2936f4a645d3d17e70a5c482decc1d6f,0,16,2,1,2,21
5350,1702,2022-10-19 19:11:00,e0b511f6684681e62e9dee3494f83ec8,0,28,2,1,0,31
5351,1702,2022-10-19 19:16:00,7f24987761c2dc34105b9739ae8ee5d1,0,22,0,0,0,22
5352,1702,2022-10-19 19:22:00,29131427cda69031b33236769b393536,0,17,0,2,3,22
5353,1702,2022-10-19 19:26:00,d7fac5ff70465ffa28c4b2d026c12cc2,0,21,0,1,0,22
5354,1702,2022-10-19 19:32:00,8ce7df1bd65642daf4168df48f0ff8a9,0,24,0,2,1,27
5355,1702,2022-10-19 19:37:00,76c2b5c4ec52f10dd0dd6b37caeb5dba,0,23,0,0,0,23
5356,1702,2022-10-19 19:41:00,ae140583cc27c0a4e771c933c5bf85f9,0,18,0,1,1,20
5357,1702,2022-10-19 19:46:00,174dbed99835870819a0b53fe9142504,0,27,1,1,0,29
5358,1702,2022-10-19 19:52:00,765af5f16471ee4c3b511682c4b4e0d1,0,15,0,1,0,16
5359,1702,2022-10-19 19:57:00,6384b6f178321972bf8ec98198996d46,0,11,0,2,0,13
5360,1702,2022-10-19 20:02:00,b9b501e8e2dadbf661fa9845858e2ab2,0,12,0,0,0,12
5361,1702,2022-10-19 20:07:00,b45aac7a5d878b68bb0f3653e5d4229a,0,22,3,0,1,26
5362,1702,2022-10-19 20:11:00,93c03ad539b99e51c678c91a498a0d2a,0,17,0,1,1,19
5363,1702,2022-10-19 20:17:00,e7fd9b13b8588b3875ddedb38092f2e2,0,13,0,1,0,14
5364,1702,2022-10-19 20:21:00,4ff2779afb3e3b491001d8c5de017229,0,27,1,0,0,28
5365,1702,2022-10-19 20:26:00,af1e9103286ba5b0642b07f9d97a4c14,0,17,1,0,1,19
5366,1702,2022-10-19 20:32:00,b14ac928edfbb589f79d0255b507fa47,0,11,2,0,3,16
5367,1702,2022-10-19 20:37:00,5db39ae3382768d542a33923b2bc1ebf,0,18,1,0,1,20
5368,1702,2022-10-19 20:41:00,1441aaf3d3f2be2e2736b8358bb8f9b2,0,15,3,0,0,18
5369,1702,2022-10-19 20:47:00,f2a84a3069dc2bba0cc950b239c5d8ef,0,18,1,0,1,20
5370,1702,2022-10-19 20:52:00,da47283fa4a44f81366cd0a6dd526b1c,0,18,1,1,1,21
5371,1702,2022-10-19 20:57:00,038b3015a3c6f5ef38621edabd777909,1,16,0,0,0,17
5372,1702,2022-10-19 21:02:00,b0426b79c4032b31c6e549ba20903439,0,14,4,1,1,20
5373,1702,2022-10-19 21:07:00,4041287ef8ba5567d0de81bdd2254b1d,0,15,0,0,0,15
5374,1702,2022-10-19 21:11:00,c4bda4f78c40b18db0a2a7e248ef36e5,0,11,1,0,1,13
5375,1702,2022-10-19 21:17:00,5af5f946d274655490fc4b904c89ca0f,0,22,0,0,0,22
5376,1702,2022-10-19 21:22:00,8d49ad352a178a26655ef702ec922d51,0,20,0,0,1,21
5377,1702,2022-10-19 21:26:00,6ac86a60964351b319bd7879d3acabd5,0,17,3,0,0,20
5378,1702,2022-10-19 21:32:00,7e8bbbc6c80e813405fc7102c6c810ac,0,18,2,1,2,23
5379,1702,2022-10-19 21:38:00,4672841e65bf18ad958ba5c52c33b13f,0,23,0,0,1,24
5380,1702,2022-10-19 21:42:00,34581a9b1953238917ed95ebb35fe48d,0,5,0,0,1,6
5381,1702,2022-10-19 21:47:00,ba5d5296caa4a15588f0d96fba01291b,0,11,0,0,1,12
5382,1702,2022-10-19 21:52:00,89af15cb55b98e944ce31382c841fe7c,0,16,1,0,0,17
5383,1702,2022-10-19 21:57:00,7247f3387ac9bf293ee6a03ce156da93,0,14,4,0,0,18
5384,1702,2022-10-19 22:02:00,9d39f3a6ba3d77cfff8d8e741d03f442,0,10,2,0,0,12
5385,1702,2022-10-19 22:07:00,30bb9b4d3f8dd95fc7abbf21d3071b81,0,11,3,0,0,14
5386,1702,2022-10-19 22:12:00,f04ec67e4c56f036b290af4104ac74b4,0,9,0,0,0,9
5387,1702,2022-10-19 22:17:00,87036adb2c62f47dc60dee76f8f190aa,0,15,0,0,0,15
5388,1702,2022-10-19 22:22:00,5ae44e6a0d765bab1db8e3e75f722fc5,0,3,3,0,0,6
5389,1702,2022-10-19 22:28:00,1229042b1f19f54fef6512b96693aa95,0,10,2,0,1,13
5390,1702,2022-10-19 22:32:00,efa72a992ea400120205140d1dbb0f11,0,11,0,0,0,11
5391,1702,2022-10-19 22:37:00,8c78d9f68019144a5c27908ffe71238e,0,13,0,1,0,14
5392,1702,2022-10-19 22:42:00,f132d9676c91b070bf1489b7ab990d6f,0,5,1,0,0,6
5393,1702,2022-10-19 22:47:00,64181e4a27b95fe5125537cf5bd84283,0,13,0,0,0,13
5394,1702,2022-10-19 22:52:00,02467e3cdbcdd4dfa3d4bb17e5790a0b,0,21,0,0,0,21
5395,1702,2022-10-19 22:56:00,2fbf18d03b3419fc333face49783f869,0,5,0,0,0,5
5396,1702,2022-10-19 23:01:00,71ea679cf1039338d5053320c0f45c65,0,5,0,0,2,7
5397,1702,2022-10-19 23:07:00,bca5ea706a3f0eaadb9e9fc3f0ca39fa,2,14,3,0,1,20
5398,1702,2022-10-19 23:12:00,170bf8fe095850ed9f70fa348a12247b,0,4,1,1,0,6
5399,1702,2022-10-19 23:17:00,5bf11be9e4b4ba8cdcc4e2d5faab26aa,0,14,2,0,0,16
5400,1702,2022-10-19 23:22:00,9dc0fcf5610bb01d1a2b1191408129b7,0,9,0,0,0,9
5401,1702,2022-10-19 23:26:00,53352c20d9bcfd1c6ee239b219be68eb,0,15,0,0,1,16
5402,1702,2022-10-19 23:32:00,ab7e9d8d45be9a3da897c22654bf35f9,0,9,0,0,0,9
5403,1702,2022-10-19 23:36:00,bb65a2f7a9c6d4a9190a2f8890c4aee5,0,9,0,0,0,9
5404,1702,2022-10-19 23:42:00,72ab85ce76764bba114da015e5c59d0a,0,8,0,0,0,8
5405,1702,2022-10-19 23:46:00,af918ce6ca8b562c7c4e880fa1309590,0,8,2,0,0,10
5406,1702,2022-10-19 23:52:00,6c64af4f726b959e8f05b2b61e397795,0,10,0,0,0,10
5407,1702,2022-10-19 23:57:00,2bf714ec61c1436df2012ab548d3c5a8,0,5,0,0,0,5
5408,1702,2022-10-20 00:02:00,2e71bc8cd99d87191a8e927d597ecd3f,0,4,0,0,1,5
5409,1702,2022-10-20 00:06:00,817f3575688867b4bef5701afc12f97b,0,16,0,0,0,16
5410,1702,2022-10-20 00:12:00,d7600f205e91c27d3709525081d86000,0,5,0,2,0,7
5411,1702,2022-10-20 00:17:00,77b39deee825752aba55664e2b9ead28,0,6,1,0,0,7
5412,1702,2022-10-20 00:22:00,2d2a96ae7a224fe2a57b195bc673ebab,0,18,0,0,0,18
5413,1702,2022-10-20 00:27:00,7245498e7b8555ba49cfbe3c44048152,0,8,1,1,1,11
5414,1702,2022-10-20 00:32:00,827d8b185134499bc2ff2330479e880f,0,6,0,0,0,6
5415,1702,2022-10-20 00:36:00,9d2375293765a4f62d34f3307eeaaee8,0,1,0,1,0,2
5416,1702,2022-10-20 00:41:00,f7dc0f1e42ae5bb3672aa32cd4dc4f86,0,13,0,0,0,13
5417,1702,2022-10-20 00:47:00,bacc9bed4fafdded2ee29634f350874f,0,8,0,0,0,8
5418,1702,2022-10-20 00:51:00,908086aa97ebda064be384a37fa1da69,0,2,0,0,0,2
5419,1702,2022-10-20 00:56:00,b6e0eab6b1d75cf6dbec30a8dd370d06,0,6,0,0,0,6
5420,1702,2022-10-20 01:02:00,bae2dc04b8723c32651f3fc6d5cd2e09,0,6,0,0,0,6
5421,1702,2022-10-20 01:16:00,1ee9eba9eb1ac7a8af3f8f757b6b89a4,0,3,0,0,0,3
5422,1702,2022-10-20 01:22:00,009a6b68bdacf11162262beca1dd98c7,0,6,0,0,0,6
5423,1702,2022-10-20 01:27:00,742a0e1b5424bc9d850f0d67377402ca,0,7,1,0,1,9
5424,1702,2022-10-20 01:31:00,e9ba785f20870ea7765841c2d1c51401,0,5,0,0,0,5
5425,1702,2022-10-20 01:37:00,2c4380129f57d9fc1bff650114e701d3,0,9,0,0,0,9
5426,1702,2022-10-20 01:41:00,f8354752fb32418fc138994532458edd,0,2,0,0,0,2
5427,1702,2022-10-20 01:46:00,4c220b972d3db187c5077cdc4ef5b1a7,0,9,0,0,0,9
5428,1702,2022-10-20 01:51:00,51a4744eb339825967dc84f450469671,0,6,0,0,0,6
5429,1702,2022-10-20 01:56:00,c2f61d45a35c5250bc4524470d71b22e,0,2,0,0,0,2
5430,1702,2022-10-20 02:01:00,016c97d7e890d91fe3886dcc532783db,0,3,0,0,0,3
5431,1702,2022-10-20 02:07:00,6629f89c5eb5d31829b6e0dc58c69c45,0,5,0,0,0,5
5432,1702,2022-10-20 02:16:00,7af78cbfece97e7d94e8c4b13ae25534,0,9,1,0,0,10
5433,1702,2022-10-20 02:22:00,9176e829bd16a330e34cfb9bdf241cff,0,6,1,0,1,8
5434,1702,2022-10-20 02:26:00,90f1c2cf892f65bd1f36a8d050771111,0,1,2,0,1,4
5435,1702,2022-10-20 02:32:00,626050848ffccde8f04148084206a2e0,0,8,1,0,0,9
5436,1702,2022-10-20 02:36:00,c8cdb87215bbe9b70cd589d9434b8b28,0,7,0,0,0,7
5437,1702,2022-10-20 02:41:00,bd1da12fcd778b1aae307848a6c3d979,0,5,0,0,0,5
5438,1702,2022-10-20 02:46:00,98c415155bda6646a0a9b8dab5f221ef,0,4,0,0,0,4
5439,1702,2022-10-20 02:53:00,46fdbcb728a7001cd506b39cbd7ceb61,0,6,0,0,0,6
5440,1702,2022-10-20 02:57:00,364779a4dbcd51387491db1fedfea6ad,0,0,1,0,0,1
5441,1702,2022-10-20 03:02:00,0f166b9e73c7854f960808413aed76ee,0,3,0,0,0,3
5442,1702,2022-10-20 03:07:00,8614a65259b19ffec814f3da8b191945,0,12,1,0,0,13
5443,1702,2022-10-20 03:11:00,a15e3f11258be5077a0aa776473795c9,0,6,0,0,0,6
5444,1702,2022-10-20 03:17:00,430d0c5b45478c4124a88a4a54ca9261,0,3,0,0,0,3
5445,1702,2022-10-20 03:21:00,957fe6d9ec7d97f1c948babf4304cc6f,0,5,1,0,0,6
5446,1702,2022-10-20 03:26:00,73113c2c90833b9db67129c83470fb1b,0,4,1,0,0,5
5447,1702,2022-10-20 03:32:00,445a2d20278a150d1785e1b334b95416,0,4,0,0,0,4
5448,1702,2022-10-20 03:36:00,b13f42578aee9f95fc242c001b3591ab,0,6,0,0,0,6
5449,1702,2022-10-20 03:41:00,18d6264533ecbcac742537aacaa2404c,0,3,1,0,0,4
5450,1702,2022-10-20 03:47:00,567dfdfd83a54561f38f237cb8deaa30,0,3,0,0,0,3
5451,1702,2022-10-20 03:51:00,2da4928a685e3acc9e4ef66572b12dbf,0,5,0,0,1,6
5452,1702,2022-10-20 03:57:00,cd4e77fff434f872e0fc00dcac7d8117,0,3,0,0,0,3
5453,1702,2022-10-20 04:02:00,86c0b500736f74ab5d00c3622d75faba,0,2,0,0,0,2
5454,1702,2022-10-20 04:07:00,6891d9a4771c5d9ecf9bded1dc883e38,0,1,0,1,0,2
5455,1702,2022-10-20 04:11:00,3e404d50a5d41baf92ab47d514e24e0e,0,2,0,0,1,3
5456,1702,2022-10-20 04:16:00,096e8e78c10be6def51b28904abad1e0,0,4,1,0,0,5
5457,1702,2022-10-20 04:21:00,9eee27a3a73bf4c8b454ac27c6f26ed2,0,5,0,0,0,5
5458,1702,2022-10-20 04:27:00,35753551d99bc88940afb33041ca20a1,0,6,0,1,0,7
5459,1702,2022-10-20 04:32:00,6096feeec536be8532abcd0d38d7e0c6,0,8,0,0,1,9
5460,1702,2022-10-20 04:37:00,a6d7c7f8afe39e369111e064c69e0213,0,6,0,1,0,7
5461,1702,2022-10-20 04:41:00,18b6d4cee9a2e20bf0c8fabcd9269ccb,0,1,0,0,0,1
5462,1702,2022-10-20 04:47:00,d43883fd611b661da430213e0b2aa911,0,1,0,0,0,1
5463,1702,2022-10-20 04:52:00,5c8754ffd01c3246fc0ad177dbf89971,0,5,1,0,0,6
5464,1702,2022-10-20 04:57:00,404a4f113bd50485e2a6746913d750d2,0,4,0,0,0,4
5465,1702,2022-10-20 05:02:00,df4c482011f637360179e32f863bfe93,0,0,0,0,0,0
5466,1702,2022-10-20 05:07:00,beb709ef0dd9350437f0ae8ded4b84ba,0,2,0,0,0,2
5467,1702,2022-10-20 05:11:00,f4a7da8edcbc4360d233216c883be6f7,0,2,0,1,0,3
5468,1702,2022-10-20 05:17:00,47905373c91135858b1122a9006ca5ff,0,2,0,2,1,5
5469,1702,2022-10-20 05:22:00,a96f7d97d4763dc316451ac1d408395d,0,4,0,1,1,6
5470,1702,2022-10-20 05:26:00,ca32ae60bfdb79c5488066c57b2b7639,0,8,0,1,0,9
5471,1702,2022-10-20 05:32:00,26f9340ecf1d89a1c647d0d17a042e09,0,3,0,1,2,6
5472,1702,2022-10-20 05:37:00,8d6093b5adde062c7a262d54c8643bec,0,3,0,0,0,3
5473,1702,2022-10-20 05:41:00,58ea9b084fc6cd9970c37d59d290cca2,0,0,0,1,0,1
5474,1702,2022-10-20 05:46:00,128ae4fb51028c8da5e45b7cc0b31a81,0,4,0,1,0,5
5475,1702,2022-10-20 05:51:00,6519d4d81c913b2b351052e04003b7d2,0,4,1,0,1,6
5476,1702,2022-10-20 05:56:00,c42e3556fab6ae2cb02566257cd4de27,0,0,0,1,0,1
5477,1702,2022-10-20 06:02:00,48fd37a742c0cbe6d2fa24eb6472826b,0,2,0,0,1,3
5478,1702,2022-10-20 06:07:00,62c94ecb084342716e2a555a5f24ec9c,0,4,0,0,0,4
5479,1702,2022-10-20 06:11:00,c837535a5773ec804e63ca519324dd3e,0,5,1,0,0,6
5480,1702,2022-10-20 06:17:00,6a0bd65a86cb9110421288c0cbf73e3e,0,2,5,0,1,8
5481,1702,2022-10-20 06:22:00,a196eed78d36fbf4597c86199693cf6e,0,2,0,0,1,3
5482,1702,2022-10-20 06:27:00,390ea400c3e960d5743c45996167f399,0,12,0,1,0,13
5483,1702,2022-10-20 06:31:00,a304562bc87a88685dff8d1a7a3a428c,0,2,3,1,1,7
5484,1702,2022-10-20 06:37:00,890976b67d69a9c54611f1d31897339c,0,7,0,1,1,9
5485,1702,2022-10-20 06:42:00,08308621f255672ae5b37fd4d0f7c390,0,13,0,3,3,19
5486,1702,2022-10-20 06:48:00,3c969578a925c469747141897def2003,0,18,0,1,1,20
5487,1702,2022-10-20 06:52:00,4c9ce77dc8515c5cd08a8b60f9a27e7a,0,17,1,1,3,22
5488,1702,2022-10-20 06:56:00,836f06697649caf9a021ac4bcb0a6db5,1,18,0,1,4,24
5489,1702,2022-10-20 07:03:00,ea058e16087985dc0da33534355a0dda,0,19,0,1,3,23
5490,1702,2022-10-20 07:07:00,0954842d0ad796576bb594b9b82f2ab6,0,12,0,1,4,17
5491,1702,2022-10-20 07:12:00,19fc0c3fa85a832263c55285b154661a,0,20,0,0,5,25
5492,1702,2022-10-20 07:17:00,54830aa4cbd3193b8ed1bf94abcfafbb,0,13,0,0,12,25
5493,1702,2022-10-20 07:22:00,f7c79bdbc58afb8ce4267d89d27e200c,0,15,0,3,11,29
5494,1702,2022-10-20 07:26:00,6234f2f610daee271d1c590fa366dde3,0,7,0,1,13,21
5495,1702,2022-10-20 07:32:00,2c083172316af4eb4da63dbde77d25e2,0,9,0,7,11,27
5496,1702,2022-10-20 07:37:00,61520057d2ff598b800cba35ba8f03d1,0,16,0,2,7,25
5497,1702,2022-10-20 07:41:00,c7198128c59982cbd8b8e60a359c18cb,0,14,0,1,8,23
5498,1702,2022-10-20 07:47:00,7dafa88079a856d6ed5ad158926686e6,0,21,0,3,4,28
5499,1702,2022-10-20 07:52:00,2e8444c9ef3292059d276b7e8054d9a3,1,15,0,2,11,29
5500,1702,2022-10-20 07:57:00,fdbd3652fe8bfe44c569ccbcc49188d9,0,19,2,0,13,34
5501,1702,2022-10-20 08:02:00,ff8c662646864f51c870fb6b2ac3ee80,0,12,0,0,7,19
5502,1702,2022-10-20 08:08:00,6e435975bb3c3ff9ef4c216e0d27d8b2,0,11,0,1,10,22
5503,1702,2022-10-20 08:12:00,7fdab648603afb314820e439ecd75c91,0,13,0,3,8,24
5504,1702,2022-10-20 08:17:00,343c11a63ef3a8b0a65f301420077539,0,11,0,0,12,23
5505,1702,2022-10-20 08:23:00,4b77a10d9ea6c6675cd9a526cb4a0e52,0,13,0,0,7,20
5506,1702,2022-10-20 08:26:00,e980367ffdd8669a7437a485a9446a80,0,9,0,1,16,26
5507,1702,2022-10-20 08:32:00,f9d3bafcb69720b77db2710cd0db7a67,0,20,0,0,5,25
5508,1702,2022-10-20 08:38:00,84f14a46722ccf748735b1bcfb727ae4,1,18,3,4,7,33
5509,1702,2022-10-20 08:42:00,e66b8686ba689ab7132c4a3abb86af9c,0,12,0,3,8,23
5510,1702,2022-10-20 08:47:00,0693b34592a5a2fc599cef07049df842,2,8,0,2,8,20
5511,1702,2022-10-20 08:53:00,431b7b4c8010d4f97caa877a6f23a86f,0,14,0,0,7,21
5512,1702,2022-10-20 08:57:00,a0ea126795e3fdfa256cc3809759fd9e,0,15,1,4,4,24
5513,1702,2022-10-20 09:02:00,a9e2f7fb1176be9c4ab54cc0ec20dee2,0,16,0,4,8,28
5514,1702,2022-10-20 09:07:00,474b2538a023ee9b0651044875836a72,0,15,0,0,6,21
5515,1702,2022-10-20 09:12:00,eafc969768ee9372da525f4bb4baec4a,0,12,0,0,9,21
5516,1702,2022-10-20 09:17:00,2bdbe717257dc4d47600f2b468c83292,0,12,0,1,10,23
5517,1702,2022-10-20 09:22:00,f67d7b48fc67bd293e875600615d42c5,0,10,1,0,9,20
5518,1702,2022-10-20 09:26:00,1dba91aed82ce254cdd3c29716b29f7d,0,11,1,2,6,20
5519,1702,2022-10-20 09:32:00,8f2e6a33e9d8455e7bc67905d6e93a03,0,13,0,1,8,22
5520,1702,2022-10-20 09:37:00,9e00c4bb53817ce08adad2f47f905394,0,11,0,0,4,15
5521,1702,2022-10-20 09:42:00,f280db1a7bea5e74416db35b50450687,0,11,0,1,4,16
5522,1702,2022-10-20 09:47:00,a255deab72b90955d136cff5a0aa9faa,0,16,0,2,7,25
5523,1702,2022-10-20 09:52:00,75a8bb844795940bd6acdc0ef64f9533,0,9,1,2,8,20
5524,1702,2022-10-20 09:56:00,dc6c6802e8c5f25a93fd3bb402341c0d,0,10,0,0,4,14
5525,1702,2022-10-20 10:03:00,0988b668bc283933d6bc773a63ca2fc1,0,7,0,3,7,17
5526,1702,2022-10-20 10:07:00,7decff4e7a7a59770c745cc6524079ff,0,10,0,4,9,23
5527,1702,2022-10-20 10:11:00,08839cbba3b27694cefe96263ecd5cfa,0,11,0,1,18,30
5528,1702,2022-10-20 10:17:00,99f93abb9df8ccebb63a0e18d193a17f,1,18,0,1,8,28
5529,1702,2022-10-20 10:22:00,7f696d2b1c56188bee92f45a3f120b2f,0,10,0,7,10,27
5530,1702,2022-10-20 10:27:00,ce5eb9ed53dd8368f2c6f8ea5a0b8afc,0,18,0,3,11,32
5531,1702,2022-10-20 10:33:00,49beeaf805387e5a32b7044f672e0695,1,10,0,5,13,29
5532,1702,2022-10-20 10:37:00,052d7d640c2232845f7d4a409fd608a7,0,15,0,0,13,28
5533,1702,2022-10-20 10:43:00,20517dad0b0959da941adc8505a6ea86,0,13,0,2,10,25
5534,1702,2022-10-20 10:48:00,5484d9b8481bddc584c86ad0cc2ca87d,0,19,0,1,7,27
5535,1702,2022-10-20 10:51:00,1cc7f4e16f6b584b033a5570bf7cc21d,0,11,1,5,12,29
5536,1702,2022-10-20 10:57:00,02bfff4f5f76652c0e9250c39784d62a,0,16,0,4,15,35
5537,1702,2022-10-20 11:02:00,c943e86366b6167d9d25e11f58657712,0,17,0,5,8,30
5538,1702,2022-10-20 11:07:00,dd387392bbab56709903269fd2f91d62,1,21,0,1,11,34
5539,1702,2022-10-20 11:12:00,b7ee961d615fa6ac885b7d4f5259bf0f,1,16,0,9,10,36
5540,1702,2022-10-20 11:17:00,0c60d4c59d6a13447f30b239672009d1,0,10,1,1,13,25
5541,1702,2022-10-20 11:23:00,a32df959c88e03407f3008936a08ee07,0,17,0,2,11,30
5542,1702,2022-10-20 11:26:00,63323722c81811ed02c3152527049821,0,10,0,4,14,28
5543,1702,2022-10-20 11:33:00,ad7ac51a26fc144d70aa206262cb6f69,0,9,2,0,10,21
5544,1702,2022-10-20 11:37:00,294d66c39b0359cbd85e077662bd4a9d,0,10,0,1,13,24
5545,1702,2022-10-20 11:43:00,c38cfb3c9ba767b98e23146a3a532559,0,12,0,1,7,20
5546,1702,2022-10-20 11:47:00,a3a472f76a903debb59dbeeeae5c6d89,0,14,1,1,11,27
5547,1702,2022-10-20 11:52:00,a2f5a912f72c8e286b0b566cb7ee8c11,0,8,0,6,13,27
5548,1702,2022-10-20 11:57:00,a765c3dad1072a435696014b9f977496,0,15,0,2,8,25
5549,1702,2022-10-20 12:02:00,de08b95b14d8e689415e8c07106e788e,2,15,0,5,5,27
5550,1702,2022-10-20 12:07:00,3a62ec3533c17b7df9609e34050f264d,0,9,0,4,6,19
5551,1702,2022-10-20 12:13:00,617c15c3d4bb69d72e758dfb81c1feee,0,14,0,3,6,23
5552,1702,2022-10-20 12:17:00,16c2d090abcb0ca99970ef293eb7b36d,0,22,0,1,5,28
5553,1702,2022-10-20 12:23:00,1c970f0759a0dadeb4c98dfb68151ea1,1,15,0,3,2,21
5554,1702,2022-10-20 12:26:00,24d04e7ba626e3ccfef57fc09a861cfb,0,15,1,3,5,24
5555,1702,2022-10-20 12:33:00,a58cf380656adf8add5d94f51aaee83a,0,14,0,2,2,18
5556,1702,2022-10-20 12:37:00,a19dacfc6deb1fb3059fc176bc41e0d1,0,13,0,3,4,20
5557,1702,2022-10-20 12:43:00,9746acd2e944973836f0edccb87f3f6a,0,14,0,3,1,18
5558,1702,2022-10-20 12:47:00,89e4cf6365777d0baf73fb271ce84709,0,19,0,4,4,27
5559,1702,2022-10-20 12:51:00,7e58f8d249b841686e16a68ef243e603,0,9,0,0,8,17
5560,1702,2022-10-20 12:56:00,f114e9d5d67ada5b695edb9b5b62eab4,0,11,0,2,8,21
5561,1702,2022-10-20 13:02:00,70775e84c6767f68d590435adc3eb65c,0,16,0,1,7,24
5562,1702,2022-10-20 13:07:00,fa8d97c2dca91ec94adf4b9ba9f62375,0,20,0,4,4,28
5563,1702,2022-10-20 13:12:00,fe5ac8695845f5a31ed5a90368a6102d,0,19,1,0,1,21
5564,1702,2022-10-20 13:17:00,b7a80ce11950020a14a3332dbf93b188,0,15,1,6,8,30
5565,1702,2022-10-20 13:21:00,72e3c960dbccb251c791008a45ddcc3f,0,8,1,6,11,26
5566,1702,2022-10-20 13:26:00,cc5f0a57dca77aa6ee7e877a8b884adf,0,6,0,2,12,20
5567,1702,2022-10-20 13:32:00,a724bbd40770d8e0d18ed38497dbc28e,0,13,0,2,7,22
5568,1702,2022-10-20 13:37:00,d1a2702aa7971128bae2c766eebfacc5,1,14,0,4,6,25
5569,1702,2022-10-20 13:42:00,bcc8c721961f6ceae5c8ac291ec40a4e,0,13,0,6,10,29
5570,1702,2022-10-20 13:47:00,f44575f86183e3423e8efa46a4b67233,0,17,2,0,4,23
5571,1702,2022-10-20 13:52:00,a91e76fd7b2813f9ecfeb9b42af534ad,0,26,0,3,3,32
5572,1702,2022-10-20 13:57:00,e93da17a889e7e55e6464eb6f2696d3f,0,14,0,4,3,21
5573,1702,2022-10-20 14:02:00,f5cd2d69a598277b21a36e32e84c578d,0,17,0,9,2,28
5574,1702,2022-10-20 14:07:00,59afa9ea74b383515354a44df5bd9f8d,0,17,1,3,5,26
5575,1702,2022-10-20 14:12:00,24a2caec79be751a1fa9e7e98ba1fe4b,0,14,0,0,1,15
5576,1702,2022-10-20 14:17:00,80bca36e99b04b556c831ec144889b27,0,17,0,5,3,25
5577,1702,2022-10-20 14:22:00,ceac409b2f0eae31ed475b3d58f1e119,0,19,0,0,4,23
5578,1702,2022-10-20 14:28:00,fc0d23306db000918095fdfc5af5e73f,0,14,0,6,5,25
5579,1702,2022-10-20 14:32:00,b09d659525ce9bfc3633244e397cb016,0,10,0,6,2,18
5580,1702,2022-10-20 14:37:00,3b189304676a41bcbe06423a4263b4eb,0,14,0,4,8,26
5581,1702,2022-10-20 14:42:00,81e15f0e8ad9b2d2d4aca9926661a7d7,0,14,0,1,6,21
5582,1702,2022-10-20 14:47:00,eb621fe59976e177bee783001c1eaa81,0,17,0,0,9,26
5583,1702,2022-10-20 14:53:00,475dbd57bd299f5cdb725165189dd877,0,12,0,4,14,30
5584,1702,2022-10-20 14:58:00,a1bde64920a36108b2ac4237daf2dfb7,1,12,0,1,9,23
5585,1702,2022-10-20 15:02:00,cb38cc8db7bc70354c3705ab39df8f99,1,11,0,1,9,22
5586,1702,2022-10-20 15:08:00,98ba6ebea1f437c71ee69f0e6e433019,0,16,0,1,2,19
5587,1702,2022-10-20 15:11:00,75d52a874486db3254b37e4ccfe7c9e9,0,12,0,7,8,27
5588,1702,2022-10-20 15:17:00,f674a5a860f7926a3aff241103f8ab25,0,19,0,0,5,24
5589,1702,2022-10-20 15:22:00,8ee52d9b943db98156ad29d35415c927,0,11,0,6,8,25
5590,1702,2022-10-20 15:27:00,c87aa0ab219c91c121f7f829a6d45461,0,14,0,2,8,24
5591,1702,2022-10-20 15:32:00,8a776def3ca02951e1d9e7363a956a6e,0,13,0,3,11,27
5592,1702,2022-10-20 15:36:00,937c0c5c3227d9caeaa4f6d80c57e73b,0,16,0,2,8,26
5593,1702,2022-10-20 15:41:00,967c60ff37b1ef261a9227758a53dd33,0,17,0,1,8,26
5594,1702,2022-10-20 15:47:00,b394a96ea06736c0dec61de54e811fb5,0,12,0,0,7,19
5595,1702,2022-10-20 15:52:00,e0ce8d47786314a12ff65c4820913a03,0,6,0,0,17,23
5596,1702,2022-10-20 15:57:00,dcff58276b913496d1aaaa16995afa4f,0,6,0,2,5,13
5597,1702,2022-10-20 16:03:00,920d0733060fae922ba5e69cf46a0ac6,0,10,0,3,10,23
5598,1702,2022-10-20 16:07:00,7428b059a9ff72bf1e0c2e9ff43755e2,0,12,0,3,10,25
5599,1702,2022-10-20 16:12:00,de986b394e04316de0f8a133ae5f9be4,0,16,0,0,10,26
5600,1702,2022-10-20 16:16:00,174b876da89e3d36bf0253acb8362fc5,0,10,1,0,9,20
5601,1702,2022-10-20 16:23:00,d667dd695bcef5b55121f87f0aab28c1,0,15,0,1,10,26
5602,1702,2022-10-20 16:27:00,d6da7c73a0006f89852bc9d922cd7507,0,16,0,3,7,26
5603,1702,2022-10-20 16:38:00,5a438b1ff37b4613e99e725a4cb36347,0,7,0,1,15,23
5604,1702,2022-10-20 16:42:00,772be27e6be83ebdfbe8f44ccd4922bf,0,4,0,3,10,17
5605,1702,2022-10-20 16:47:00,64b822bc49153c8aaf85a429fdcfa0b1,3,10,0,2,13,28
5606,1702,2022-10-20 16:54:00,6da349a79b0e80fab1996378e066bd8f,0,14,0,4,15,33
5607,1702,2022-10-20 16:56:00,e92d90b7103a003fefdb2f321297d0b8,0,9,0,1,15,25
5608,1702,2022-10-20 17:03:00,1dc10f99fbde1eadddba09a647cbb41f,0,9,0,3,9,21
5609,1702,2022-10-20 17:09:00,5945296691bd3f04b3893e4639c36e2c,1,8,0,0,12,21
5610,1702,2022-10-20 17:13:00,0d16ea2acce3556eb1f783d4eefb8a11,0,13,1,1,8,23
5611,1702,2022-10-20 17:17:00,343040f77eff880b80c82f443805afae,1,16,0,2,11,30
5612,1702,2022-10-20 17:23:00,f2793dbc0e05611da749e0b4a4a6f919,0,21,1,3,4,29
5613,1702,2022-10-20 17:27:00,03baabefb9010d60667adeda5f8d3b50,2,14,0,1,10,27
5614,1702,2022-10-20 17:32:00,87f83b4169ec054e6e1c99b58935e9e6,0,16,0,2,12,30
5615,1702,2022-10-20 17:38:00,b4d2fa5c12477ae69ece616ca0eb5ea7,1,14,0,1,12,28
5616,1702,2022-10-20 17:41:00,a9d3d4ab4b54b80d5608c63d14ae8bf5,2,15,0,4,10,31
5617,1702,2022-10-20 17:48:00,b3fa96bdb029640d2d9b70c4568eec74,0,18,0,3,8,29
5618,1702,2022-10-20 17:52:00,91419102d64d39d150999e6f7ae0a4f6,0,12,0,3,11,26
5619,1702,2022-10-20 17:57:00,aa14811fb601ba4f4e16b384223190c9,2,24,0,4,10,40
5620,1702,2022-10-20 18:02:00,ec4816d22fc168078bc47cde634ad49a,0,13,2,3,13,31
5621,1702,2022-10-20 18:08:00,0d27fa02de4aeb95ef48f6c1ac358f3e,0,13,0,3,8,24
5622,1702,2022-10-20 18:12:00,89859e57c9eb87a6a5c613f636a18c53,1,12,1,2,13,29
5623,1702,2022-10-20 18:17:00,1e9e2c29c443e6a815e094b9426acfdb,0,21,1,1,6,29
5624,1702,2022-10-20 18:22:00,637109c4aa92783c766ed3d28b5763ad,0,16,1,1,12,30
5625,1702,2022-10-20 18:27:00,0ea9f26178f8add138b9b567c39378a9,0,17,0,4,9,30
5626,1702,2022-10-20 18:32:00,eb4ef735c81815cb38cab0bc74ef8e5c,0,24,0,0,9,33
5627,1702,2022-10-20 18:37:00,b7875f4741a6e9a882103ee07323a53f,0,15,0,0,12,27
5628,1702,2022-10-20 18:42:00,69432de91d88f9140eb78d4f06e92a16,2,24,0,1,6,33
5629,1702,2022-10-20 18:46:00,690d2de4ede0c598d251bbd352b75efa,0,17,0,0,11,28
5630,1702,2022-10-20 18:53:00,1c6baf8ee62f58052a6ea43b2f10c9ef,0,18,0,1,10,29
5631,1702,2022-10-20 18:59:00,ee083d4e8ccc8e427ce128213b185dd5,0,21,0,2,5,28
5632,1702,2022-10-20 19:02:00,01180606ec4c03dfde697fbf6baab000,1,17,0,0,7,25
5633,1702,2022-10-20 19:07:00,05fe9a4c636b5ef28c3615c608122a4f,0,26,1,1,0,28
5634,1702,2022-10-20 19:11:00,f8fff3ffb09b513ef7856f5c1ea4a86b,0,10,0,1,3,14
5635,1702,2022-10-20 19:17:00,f389aa5715035d6b9faaa3b2974d06a4,0,20,2,2,0,24
5636,1702,2022-10-20 19:22:00,f7ec6203f3a06df0119de1c3ac5bf560,0,13,1,1,0,15
5637,1702,2022-10-20 19:26:00,3224cfc0e7d34757bf9398b013cb8d84,0,17,1,1,0,19
5638,1702,2022-10-20 19:32:00,83cd1b6766bc8350604f669cdb21e573,0,15,1,0,0,16
5639,1702,2022-10-20 19:37:00,d15b403e82e3ba040f519656ea70496b,0,16,0,2,0,18
5640,1702,2022-10-20 19:41:00,671132a241ba087daeee68c180fe4a2b,0,19,1,0,0,20
5641,1702,2022-10-20 19:47:00,0dda629f0ec2d68ecbe343ff11449133,0,13,0,4,0,17
5642,1702,2022-10-20 19:51:00,633099a6d161d72a6cdeb1d3b3b88e1b,0,9,0,0,0,9
5643,1702,2022-10-20 19:56:00,dc9674eee907e00d553ff559afd1dad0,0,8,1,1,1,11
5644,1702,2022-10-20 20:02:00,0dc621c0ac55b4f17d5c67780a5de4c0,0,16,0,0,1,17
5645,1702,2022-10-20 20:07:00,33a045a6cb9ff04256f8018570256681,0,15,1,1,0,17
5646,1702,2022-10-20 20:12:00,34e77102c35a6acb207a6ac1cf32e7fb,0,18,1,0,1,20
5647,1702,2022-10-20 20:17:00,c9eea42e9b19a396fad224412f763d2d,0,22,0,0,0,22
5648,1702,2022-10-20 20:22:00,ac5fe761280922409415196353a5c8f8,0,17,0,2,1,20
5649,1702,2022-10-20 20:27:00,5a5b3075a8273cfcc9854352eea47b74,0,15,0,0,1,16
5650,1702,2022-10-20 20:32:00,dd09feab0f850318987a347da4dce825,0,17,1,0,2,20
5651,1702,2022-10-20 20:37:00,c2e89db7fc8258f9a76d54184142a7ee,0,14,0,0,0,14
5652,1702,2022-10-20 20:41:00,9d849446de4bb5c9ad964b45c1f0aff9,0,17,1,0,1,19
5653,1702,2022-10-20 20:47:00,36174eee124b3387c38ad831697a3d0f,0,11,0,0,1,12
5654,1702,2022-10-20 20:52:00,bc96d7309a375f740621ca9fda96907c,0,16,0,3,1,20
5655,1702,2022-10-20 20:56:00,ff166e31e6172a824393efd37f57c626,0,17,0,1,2,20
5656,1702,2022-10-20 21:03:00,108b32764d7d4b1a2daafaa42060febf,0,6,1,0,0,7
5657,1702,2022-10-20 21:07:00,1d752393e9158a6622b3d3e7d2045f8e,0,28,0,0,0,28
5658,1702,2022-10-20 21:11:00,7374c951a649f1cef5ec8ab4e93076c6,0,12,3,0,1,16
5659,1702,2022-10-20 21:17:00,fc59ab0f93e93e847c30542e3f43ca17,0,11,0,0,1,12
5660,1702,2022-10-20 21:21:00,dfc8803139d1461a0331f2ed61ddb14f,0,17,0,1,0,18
5661,1702,2022-10-20 21:27:00,fc4d7314303e083a213e1fa0d2e6fbc0,0,13,0,1,2,16
5662,1702,2022-10-20 21:31:00,b4a4d98b179463c318660b1519a0203d,0,21,1,0,1,23
5663,1702,2022-10-20 21:37:00,7cc728a9304a372383a516736055db4b,0,15,0,1,1,17
5664,1702,2022-10-20 21:42:00,637ec9f7b980855dc9fc918b0533b809,0,16,0,0,1,17
5665,1702,2022-10-20 21:47:00,fa9eb9f5131d0673493b1fd75b53905c,0,20,0,0,1,21
5666,1702,2022-10-20 21:51:00,e5af6edcfedebae8893cf0fe8d14342c,0,12,0,0,0,12
5667,1702,2022-10-20 21:57:00,8adc2ace085f05134f91351cece1e739,0,14,0,0,0,14
5668,1702,2022-10-20 22:02:00,5c0cfd484f2374fe0cb3749ba35da6df,0,18,0,1,0,19
5669,1702,2022-10-20 22:07:00,26a6bf0c3c8a5e2e59b7411d31443b5b,0,11,0,0,0,11
5670,1702,2022-10-20 22:11:00,0184468992f1471f6a5b410ffa65bbe5,0,13,0,0,1,14
5671,1702,2022-10-20 22:17:00,63160dd3b5d5483273aeb3e9221598ec,0,12,3,0,1,16
5672,1702,2022-10-20 22:22:00,3df59501e8e4b7c02ef4049853dddda7,0,23,0,1,1,25
5673,1702,2022-10-20 22:26:00,a4d92bb4fe8b86d0ba737c0f06ac9fc2,0,24,0,0,0,24
5674,1702,2022-10-20 22:31:00,61649e746807af65efed17043b9bb15c,0,17,0,1,0,18
5675,1702,2022-10-20 22:36:00,c342d820b1b46492ad3e998d44337b2a,1,14,0,0,0,15
5676,1702,2022-10-20 22:42:00,e86cbaad980aa1b9d3d3bad02aa7820e,0,9,0,1,0,10
5677,1702,2022-10-20 22:48:00,be11bfbc5edca1302293e06b597305b5,0,17,0,0,1,18
5678,1702,2022-10-20 22:52:00,49f5452901411d3ecb288ab444dbec35,0,11,0,1,1,13
5679,1702,2022-10-20 22:56:00,b825230b11f8c8f7fbbe2b02ba48d65a,0,12,0,1,1,14
5680,1702,2022-10-20 23:01:00,5370ac8732132e6ee68fe42216629381,0,12,0,0,1,13
5681,1702,2022-10-20 23:07:00,9231a11912224add8aca3e853a1e9362,0,11,0,0,0,11
5682,1702,2022-10-20 23:11:00,8abed860fbe7cba9735cc3981ba3408c,0,12,0,0,1,13
5683,1702,2022-10-20 23:16:00,b6942756d031eaa2a647c2ee0344f878,0,13,0,0,0,13
5684,1702,2022-10-20 23:22:00,6d12dad924963c95ada9a7b3c70af37c,0,4,0,0,0,4
5685,1702,2022-10-20 23:26:00,c0a46f184d3423efa9bf054861254b3f,0,8,1,0,0,9
5686,1702,2022-10-20 23:31:00,d03e42a91bf576ce3078b2c23a3377cc,0,7,0,0,1,8
5687,1702,2022-10-20 23:36:00,0a04f9d78a99ede9ebbbe5e62f3f5f95,0,12,0,0,2,14
5688,1702,2022-10-20 23:41:00,97065a987249e816ccef57074145d140,0,6,0,1,0,7
5689,1702,2022-10-20 23:46:00,12c4cefc9d154d731521ab9a65094afa,0,10,0,0,1,11
5690,1702,2022-10-20 23:51:00,f7e1a9030cd48ec11f5f2846efe1722c,0,6,0,0,0,6
5691,1702,2022-10-20 23:56:00,ef30ff8b0d8092ba11ac68e524980bc8,0,8,0,0,0,8
5692,1702,2022-10-21 00:02:00,91dcb4797172f6522a2597ef6a1580f6,0,9,0,1,0,10
5693,1702,2022-10-21 00:07:00,1d73577cc741db2b6e562d956cf0ab3c,0,8,0,0,1,9
5694,1702,2022-10-21 00:12:00,9876620cff91418f5041a9377e1486e0,0,8,0,0,0,8
5695,1702,2022-10-21 00:16:00,6612e309be0c7950916151cf778b0cab,0,14,0,0,0,14
5696,1702,2022-10-21 00:27:00,fef809d7ab6b49cf209ccb9a10af842b,0,13,1,0,2,16
5697,1702,2022-10-21 00:31:00,aee5f66e6aaec3835cf7dddd043e41c7,0,11,1,0,0,12
5698,1702,2022-10-21 00:36:00,9a4ee776ae0f50c87ae38581c7ded97a,0,0,0,0,0,0
5699,1702,2022-10-21 00:41:00,e584c3c7ec04a67f7a2c5de47b60140e,0,4,0,1,1,6
5700,1702,2022-10-21 00:47:00,214f90f8d7324ad87deadc22b8a16737,0,13,0,0,0,13
5701,1702,2022-10-21 00:52:00,56007b63b25e72b31f1952daafd15fdc,0,6,1,0,0,7
5702,1702,2022-10-21 00:57:00,03e5213f282999cb279d60154e92e5a4,0,10,1,0,0,11
5703,1702,2022-10-21 01:02:00,4a6de67513c204deffbd98aef47b5e08,0,11,0,0,0,11
5704,1702,2022-10-21 01:17:00,395448a1b0f5ddcd152574e26546b37e,0,6,0,0,1,7
5705,1702,2022-10-21 01:22:00,5b446bde28845ae1f06d1a6873ceb5eb,0,10,1,0,1,12
5706,1702,2022-10-21 01:26:00,c08ff78317064b7c4dc35435b3490f8c,0,5,1,0,0,6
5707,1702,2022-10-21 01:31:00,eeec8471c7adf0ac27625f0b23b64379,0,10,0,0,1,11
5708,1702,2022-10-21 01:37:00,081064906a27f6cefb9f7f3d3bdaaa2d,0,3,1,0,0,4
5709,1702,2022-10-21 01:42:00,82aeebb9b0085b5485a0d7c9eb680e9f,0,5,0,0,2,7
5710,1702,2022-10-21 01:47:00,badb60b61377465cc2ba2a7100207b77,0,11,1,0,0,12
5711,1702,2022-10-21 01:52:00,0e5f7033988756376c240f43c5c126db,0,8,0,1,1,10
5712,1702,2022-10-21 01:56:00,48f1910d6a7f63132619616011229651,0,6,0,1,0,7
5713,1702,2022-10-21 02:01:00,6d9cdd675608a5253253abb413a0ef26,0,9,0,0,0,9
5714,1702,2022-10-21 02:06:00,1207ff6f69ca0aa0e274135ff5c0feaf,0,5,0,0,0,5
5715,1702,2022-10-21 02:11:00,ddc34f99fa5d2d6750ae2498e865901e,0,5,0,0,1,6
5716,1702,2022-10-21 02:17:00,6c9ce0a50360ce941dc38c05f3779063,0,13,0,0,1,14
5717,1702,2022-10-21 02:22:00,dac9160e654614e32b4ad35ffc96ba91,0,0,0,1,0,1
5718,1702,2022-10-21 02:26:00,b2a291bc724c75765da57ec88db9aa53,0,11,0,0,0,11
5719,1702,2022-10-21 02:32:00,56d77e518c303dc4b5d30fb78c81d43a,0,3,0,0,0,3
5720,1702,2022-10-21 02:37:00,db7b7dbc65bb6b4d01ebf0639ceaeaec,0,7,0,0,1,8
5721,1702,2022-10-21 02:41:00,b24c7d7c3a3b5221edc31be7a6b2e662,0,9,1,0,0,10
5722,1702,2022-10-21 02:47:00,290cbceed3ed73b9da9450bed03ad511,0,9,0,0,0,9
5723,1702,2022-10-21 02:51:00,4df1a2080c5b0351a3afadad00c08075,0,1,0,0,0,1
5724,1702,2022-10-21 02:57:00,571d6ccb7e7aa6d5ca0f94294c3bf755,0,3,0,0,0,3
5725,1702,2022-10-21 03:01:00,8457fbd7ca01935dda5f6d46f76a8497,0,6,0,0,0,6
5726,1702,2022-10-21 03:06:00,40a63a4face6aa286cda38eff62184ae,0,4,0,0,0,4
5727,1702,2022-10-21 03:11:00,7b0825da7e1d81884e3047868a1dda43,0,1,0,0,0,1
5728,1702,2022-10-21 03:16:00,139fcda3577e79a3dd04b3e3795a6347,0,4,0,1,0,5
5729,1702,2022-10-21 03:21:00,aad2191b05632aaafb20210951183e32,0,0,0,0,0,0
5730,1702,2022-10-21 03:26:00,6927794303e94c5224d6cb7c30ac393d,0,8,0,0,0,8
5731,1702,2022-10-21 03:32:00,156fe42cc0259857b0dc48ed8a1fdebb,0,4,1,0,0,5
5732,1702,2022-10-21 03:36:00,a08b8f87a0993ec77abf005f6e4ec833,0,6,0,0,1,7
5733,1702,2022-10-21 03:41:00,5cb588838bce87a3c12f6f25a055d797,0,2,0,0,0,2
5734,1702,2022-10-21 03:47:00,1a1089a736e69ce731eeb320075b664e,0,1,0,0,0,1
5735,1702,2022-10-21 03:52:00,3be9275ce260b2241c1dd5d4e3bc8e19,0,11,0,0,1,12
5736,1702,2022-10-21 03:56:00,e8cbb1000da9d6bf0c1efe8dce346509,0,3,0,0,0,3
5737,1702,2022-10-21 04:02:00,88913d0c4cc1e353b34754cc67c217ec,0,1,1,0,0,2
5738,1702,2022-10-21 04:07:00,cc60cb37e49e58bec66269dcde6f6c92,0,1,0,0,0,1
5739,1702,2022-10-21 04:11:00,af94a26fb69f91c20db7f8e77c565bb4,0,7,1,0,0,8
5740,1702,2022-10-21 04:16:00,a67e0b2c1a9390ce5f127e81cf03e66e,0,3,0,0,0,3
5741,1702,2022-10-21 04:21:00,5899ecdff2a8d7717e40e7cdbc812994,0,3,0,0,0,3
5742,1702,2022-10-21 04:26:00,1b739116a12f6c352bdefaa6a682ac80,0,7,1,0,0,8
5743,1702,2022-10-21 04:32:00,d14b9f6aa9ec159b84f60ad4f4b38a72,0,3,0,0,0,3
5744,1702,2022-10-21 04:37:00,3ba871688797a8523b2b48ae32e1eeec,0,6,0,0,0,6
5745,1702,2022-10-21 04:41:00,62298499cb8c3f4d97592954e74011b1,0,0,0,0,1,1
5746,1702,2022-10-21 04:47:00,92838202cf4013b7f5587c990e0550ae,0,9,0,0,1,10
5747,1702,2022-10-21 04:51:00,ae124fc21d65d238e8b6f20060c4893b,0,0,0,0,0,0
5748,1702,2022-10-21 04:56:00,a447ed91fa1e0ff41eeeb4c0b975ad92,0,5,1,0,0,6
5749,1702,2022-10-21 05:02:00,19f205bda5aad4f812c85336aaaac55b,0,5,0,1,0,6
5750,1702,2022-10-21 05:06:00,0b19c92f74989ef5a9abeba03bccd253,0,2,0,0,0,2
5751,1702,2022-10-21 05:11:00,03fe13c5f4ef4fc3d0eb2943d10d131d,0,1,0,0,1,2
5752,1702,2022-10-21 05:16:00,24f79d9ed9f1b6331b4fb13fe46cdb3e,0,6,0,0,1,7
5753,1702,2022-10-21 05:21:00,f4226a709db1aaafe236f41e5af9012f,0,6,0,0,0,6
5754,1702,2022-10-21 05:26:00,e6a0e0747fd5642b4cccd56fd44f1fb6,0,4,0,0,0,4
5755,1702,2022-10-21 05:32:00,436abae5f718dcf91ecd2373cd76a1cd,0,6,0,0,0,6
5756,1702,2022-10-21 05:37:00,422b61556bccfa90c8d693e268502d01,0,3,0,1,0,4
5757,1702,2022-10-21 05:41:00,b78ff0ac46733cdbd66cd9c47986ac47,0,1,0,1,0,2
5758,1702,2022-10-21 05:47:00,35c42aad4eda170374d49cf0ba374e7a,0,3,0,0,2,5
5759,1702,2022-10-21 05:51:00,fde7ea8176a873947d64834295529a4b,0,9,0,0,1,10
5760,1702,2022-10-21 05:57:00,f13a1d71b0a8058ee7aaced8ccc1be72,0,3,0,0,1,4
5761,1702,2022-10-21 06:02:00,e4c61187df449b0a57dddbf6b42e21df,0,3,0,0,0,3
5762,1702,2022-10-21 06:07:00,d6c29fa48b8b6b86403fd40949b3fccd,0,5,1,0,1,7
5763,1702,2022-10-21 06:11:00,6f0f6c439da159880c22652da92c0657,0,3,0,1,1,5
5764,1702,2022-10-21 06:16:00,6514e9f527ef614d22d51134d99988b3,0,8,1,0,4,13
5765,1702,2022-10-21 06:22:00,13893dc8e95572cb5a491040540fb4c8,0,8,0,0,1,9
5766,1702,2022-10-21 06:26:00,e4ce359ec9811e5dd58d83c70b137925,0,4,4,0,1,9
5767,1702,2022-10-21 06:31:00,c0a4afeba763c05d6229f043843f432f,0,7,0,3,0,10
5768,1702,2022-10-21 06:36:00,3065d98386691c761ccf09d81f6859e3,0,14,0,0,0,14
5769,1702,2022-10-21 06:41:00,39cab988406f69600dc07180baa1f199,0,10,0,0,4,14
5770,1702,2022-10-21 06:46:00,7a4fa512d278f91b2e6d8ab8d04d12f2,1,11,0,1,5,18
5771,1702,2022-10-21 06:51:00,4af2f6919b4863119902c37edab24393,0,22,1,0,8,31
5772,1702,2022-10-21 06:57:00,7e8ebd53d432339026bf6711b8c71121,1,15,0,4,11,31
5773,1702,2022-10-21 07:02:00,713be5f2f012f70b99769b4525f1e1b3,0,17,0,4,5,26
5774,1702,2022-10-21 07:07:00,979216841ab07255c29f80df7cfe92bb,1,14,0,2,8,25
5775,1702,2022-10-21 07:12:00,a490b9be4adc84a8bcbefb759e37d167,0,8,0,1,9,18
5776,1702,2022-10-21 07:17:00,c055df51db4bc8257bdbb51f09d1b329,0,15,1,3,9,28
5777,1702,2022-10-21 07:22:00,bbb753500f2aa43e5ec817c2adf37298,3,13,1,2,7,26
5778,1702,2022-10-21 07:27:00,47c1a57c059c64096046a14a1700bebf,0,11,0,2,12,25
5779,1702,2022-10-21 07:32:00,8f763de2e35659f8bb1989d0e954f9d7,0,14,0,0,13,27
5780,1702,2022-10-21 07:38:00,677868c638eecbc3298608542ec6a941,2,16,0,1,11,30
5781,1702,2022-10-21 07:42:00,ef5f41b4538a150c310df3a73f502e1e,0,20,0,1,8,29
5782,1702,2022-10-21 07:47:00,c9310b2ee9b0611f666e93974212d3a1,2,13,0,2,9,26
5783,1702,2022-10-21 07:53:00,63db26f25eea670c8a8bd4319b48e6e8,2,12,0,1,8,23
5784,1702,2022-10-21 07:57:00,7e72d30b95ee6a37ecb67a8ff077f32d,0,13,1,0,11,25
5785,1702,2022-10-21 08:03:00,57fc39838902c3a19ad6b21f7404fa03,0,17,0,3,6,26
5786,1702,2022-10-21 08:07:00,42308977afe8f89ad3476bb15f0ef497,0,14,2,5,5,26
5787,1702,2022-10-21 08:12:00,409b3b552c660978bdbb9e44b12fe248,0,9,0,2,9,20
5788,1702,2022-10-21 08:16:00,7900a51f28db6935d7f8791bf3a329d7,0,12,0,3,10,25
5789,1702,2022-10-21 08:21:00,d86930ecc4ed8c998391a66439eef452,0,15,0,3,11,29
5790,1702,2022-10-21 08:27:00,b2b4a85d11f7d658c7672eec504f576e,0,17,0,1,7,25
5791,1702,2022-10-21 08:32:00,408d4a2fb28f6959e84b12f3d79a09b8,0,16,0,0,4,20
5792,1702,2022-10-21 08:36:00,cfc4fb60c6c265a8b410342a7f1815dc,0,11,0,1,7,19
5793,1702,2022-10-21 08:42:00,3055ddf1871043f30cb43a16407cc57f,0,7,0,3,11,21
5794,1702,2022-10-21 08:47:00,4d3fe2b3524ab23d2d04bf5a6bfb2944,2,10,0,0,9,21
5795,1702,2022-10-21 08:52:00,cc75d65422cc590c953b843b2202bec0,0,17,0,2,5,24
5796,1702,2022-10-21 08:56:00,04d66eab135e536aaf3351ede9c31d55,0,20,0,3,10,33
5797,1702,2022-10-21 09:01:00,268a4552fbe5b8e3dd628604f29ccd20,0,18,1,0,6,25
5798,1702,2022-10-21 09:08:00,93adaa8516efa0b0b55383e3a70cb65f,1,8,0,3,8,20
5799,1702,2022-10-21 09:12:00,3e3a4c9b0f38dc5f16d915cd88cd2225,0,10,0,0,6,16
5800,1702,2022-10-21 09:18:00,f7d23f03a66ac22f5bf4de2f522700e5,0,17,0,2,10,29
5801,1702,2022-10-21 09:23:00,00443109e26e935adb6c682135be86fe,0,9,0,4,10,23
5802,1702,2022-10-21 09:27:00,90624f22380b7b0dbe116daf7deca558,0,15,0,2,8,25
5803,1702,2022-10-21 09:32:00,b35893e1dca88dcef63b63af45bd6a28,0,19,0,7,4,30
5804,1702,2022-10-21 09:38:00,4c5fea0c9af8ff9529a7d88533d30e6b,0,17,0,1,8,26
5805,1702,2022-10-21 09:41:00,514efd0f41d4110f15bd9c2993ee1b82,0,13,0,1,7,21
5806,1702,2022-10-21 09:47:00,b9813ca7d12a3d959f8f4645be246d8a,0,5,0,3,14,22
5807,1702,2022-10-21 09:52:00,de81c81a6fee538b30be8abd9f2a8dc5,0,11,0,3,9,23
5808,1702,2022-10-21 09:57:00,021990e32e9ce3c590407e7488092b56,0,10,3,1,14,28
5809,1702,2022-10-21 10:02:00,f9dd2048295107e8e584970888ec55aa,1,17,0,0,4,22
5810,1702,2022-10-21 10:07:00,a3fe3891272790f2049e514ea8e8c3ee,1,8,0,3,21,33
5811,1702,2022-10-21 10:12:00,582b0d8a4eacdd0a48ddf438580bed96,0,9,0,0,15,24
5812,1702,2022-10-21 10:17:00,ad50cd39e34442bb704194e02759b183,0,12,3,3,10,28
5813,1702,2022-10-21 10:22:00,aaf9e74a7f41d2b40b81825d120f0933,0,14,0,4,10,28
5814,1702,2022-10-21 10:27:00,8a67ad6ec23bb57d50dac9c705a266bb,0,15,0,7,8,30
5815,1702,2022-10-21 10:32:00,c61dad9dcc3f56aaec29442986bb1c56,1,10,0,1,12,24
5816,1702,2022-10-21 10:37:00,ab2a754fc044d6bc963326709eeea292,1,16,0,5,6,28
5817,1702,2022-10-21 10:42:00,102c9f6f975c3efa10b5941888b7fe99,0,10,0,2,10,22
5818,1702,2022-10-21 10:47:00,02f5fc1398c625753c0ae263e85f36d7,0,9,0,2,12,23
5819,1702,2022-10-21 10:53:00,486e202d9cf5ff715d6b5452cf5ceff8,0,14,0,3,8,25
5820,1702,2022-10-21 10:57:00,1349a79e8b2acc653f0eb3ccc6b22560,0,12,0,2,10,24
5821,1702,2022-10-21 11:02:00,e7995fdac6f6d91d8e80b346597b4833,0,23,0,3,7,33
5822,1702,2022-10-21 11:08:00,6c8365b18a03fd40e8dd7a0ce1ba860b,1,12,0,1,12,26
5823,1702,2022-10-21 11:12:00,46b10e9adba5a10630d3372ed3585ef7,0,13,0,2,9,24
5824,1702,2022-10-21 11:17:00,e65a910690352c39df4928c1e6843555,0,8,0,2,10,20
5825,1702,2022-10-21 11:22:00,e6fff9639cf9dee5f6a9f171ef6782af,1,10,1,2,13,27
5826,1702,2022-10-21 11:27:00,4b56b09453a4ec699c952acb88e6e7f5,0,15,0,1,9,25
5827,1702,2022-10-21 11:32:00,94671aab85c6e906c0e7e314bdd30cb1,1,16,0,4,6,27
5828,1702,2022-10-21 11:38:00,27d73563fc6bf0fa207dded91e6ff8d9,0,15,0,7,6,28
5829,1702,2022-10-21 11:41:00,9f832d961c5421587bb509767f4aba4b,0,13,0,1,13,27
5830,1702,2022-10-21 11:47:00,2379f009b11ab6090257b54b625b15db,1,15,0,1,11,28
5831,1702,2022-10-21 11:52:00,cb32cc817a6aa8143866a3b8dfb27917,0,7,0,6,13,26
5832,1702,2022-10-21 11:57:00,21072e8cfda7a7c1865a14f2ec990b65,0,13,0,1,14,28
5833,1702,2022-10-21 12:02:00,bb431228ae5b60b3f3e0f830493757d7,0,11,0,1,11,23
5834,1702,2022-10-21 12:08:00,045fbe0c3defd72a8a3b5d80a7046594,0,13,0,1,11,25
5835,1702,2022-10-21 12:12:00,242e59e56fcea1987c64d6a287743cfe,0,22,0,2,6,30
5836,1702,2022-10-21 12:17:00,b8130242c9d131a8da726ebfce35ad18,0,15,0,5,9,29
5837,1702,2022-10-21 12:22:00,8a1340058475af5a0d83beb09779ec3a,0,16,0,3,6,25
5838,1702,2022-10-21 12:27:00,19ee4c034d20ae5376d78154a88b1930,2,12,0,2,4,20
5839,1702,2022-10-21 12:33:00,9ed4854e4e0f9a9e3823f94fcc0ad03c,0,19,0,1,7,27
5840,1702,2022-10-21 12:37:00,51185b0af3f360f95fd22d4c295b6821,0,15,0,3,6,24
5841,1702,2022-10-21 12:42:00,369334a7e1578876ded966b7acd3ab47,0,11,1,1,7,20
5842,1702,2022-10-21 12:48:00,36ecbf9ff6864fa91c618cde48def012,0,12,1,4,3,20
5843,1702,2022-10-21 12:52:00,4ad3efb15596e50f65c529ce321feaa0,0,15,0,2,11,28
5844,1702,2022-10-21 12:57:00,d0c6a32ecf18ece76a0d2dcfc27afd16,0,12,1,1,10,24
5845,1702,2022-10-21 13:02:00,c92dbdb4d6c697495e6715b6439cfcb6,0,11,0,1,13,25
5846,1702,2022-10-21 13:07:00,45329aa6ddcd0f27594fb4e9a75b41c1,1,14,0,3,11,29
5847,1702,2022-10-21 13:12:00,579cdb2b44295bd8e90a361545493364,0,15,0,0,11,26
5848,1702,2022-10-21 13:18:00,7a1e2271e817c8bfa2c6d5ce3b6cf022,1,18,0,3,5,27
5849,1702,2022-10-21 13:22:00,91f6ed7e75da819899966907c156f675,0,16,0,2,10,28
5850,1702,2022-10-21 13:27:00,21ed589604fd27905e6cb8ce9eb53294,0,24,0,2,3,29
5851,1702,2022-10-21 13:32:00,95f2bd712fc19094e175f2f800594832,1,18,0,11,4,34
5852,1702,2022-10-21 13:36:00,529441a7467c23b2fd33d4c0f74634d1,0,15,0,5,9,29
5853,1702,2022-10-21 13:42:00,8a26ab8f6d2538d88ba219a155db01e1,0,14,0,0,12,26
5854,1702,2022-10-21 13:47:00,e43a54b1e69d6df761bc2ab41f4c40a5,0,12,0,1,9,22
5855,1702,2022-10-21 13:52:00,66f5e20a33af99cb960f9f4e610e0f25,0,16,1,0,13,30
5856,1702,2022-10-21 13:57:00,a6485b01de74d54c29bba46ae4b273d7,0,22,0,3,10,35
5857,1702,2022-10-21 14:02:00,409d3c727635b26933a5964465de6d0d,0,20,0,0,8,28
5858,1702,2022-10-21 14:07:00,ffa362e343e0354b16159f05c29e48d3,1,33,0,0,4,38
5859,1702,2022-10-21 14:12:00,6404226000e27069a5c305dfb5fec4c7,1,16,0,7,3,27
5860,1702,2022-10-21 14:17:00,66287350f16a63ede300df6045ffe818,0,18,1,9,3,31
5861,1702,2022-10-21 14:22:00,80a07306dd6cc06afe9ca7673d178370,0,18,0,6,4,28
5862,1702,2022-10-21 14:27:00,854b476a8f343367c072702045cc7827,0,25,0,6,6,37
5863,1702,2022-10-21 14:32:00,9ff85e39dd2164d13a6675b2b626f4c0,0,18,0,5,7,30
5864,1702,2022-10-21 14:37:00,e009f8a4d061e7f75f7f25de8b6406a6,0,21,0,8,6,35
5865,1702,2022-10-21 14:41:00,e428e0d5397a8eb06a16d46f0248e926,0,20,0,7,7,34
5866,1702,2022-10-21 14:46:00,36694fcb9162f6b5adad547bcc4c5453,0,20,0,3,3,26
5867,1702,2022-10-21 14:51:00,31ae260a262c71f7659f8752e7c28204,1,18,0,5,1,25
5868,1702,2022-10-21 14:57:00,e9c17b4dc94bf71a36f3399e46bb0e39,0,13,0,2,3,18
5869,1702,2022-10-21 15:01:00,f59321f03ef3a8a5825bc8f9e959b60b,0,11,0,2,2,15
5870,1702,2022-10-21 15:06:00,477524963c39dbea685f6a240c953cd0,0,17,0,1,3,21
5871,1702,2022-10-21 15:11:00,8ca71d130d358bcf363771e800f66eed,0,17,0,3,3,23
5872,1702,2022-10-21 15:16:00,302d00fd79f4cebd2efe90501fcba696,0,25,0,7,6,38
5873,1702,2022-10-21 15:21:00,f8d9e10453008cb4f1099c7903a4a3b5,0,22,0,4,5,31
5874,1702,2022-10-21 15:26:00,ae1f6979d3040439b4d4cb57ecbee7da,0,23,0,1,4,28
5875,1702,2022-10-21 15:33:00,a2487cdc1ccca205be2c3fd9989bea7a,1,16,0,4,6,27
5876,1702,2022-10-21 15:37:00,0befdfeea49068082721dc297ba0e4eb,0,16,0,7,3,26
5877,1702,2022-10-21 15:43:00,8dd28fff2d509a6582aacf85ee97a73e,1,25,0,4,6,36
5878,1702,2022-10-21 15:47:00,7264e09b2a088770d9bf27fa252c569c,0,20,0,3,7,30
5879,1702,2022-10-21 15:52:00,cfe10b7292b902e2b1d2ae87dd8647e8,0,15,0,6,2,23
5880,1702,2022-10-21 15:56:00,cda80d4043b4b60bfa3b25f2eae3b634,1,24,0,5,3,33
5881,1702,2022-10-21 16:02:00,3c6a648e2e87a57de8fd5f5b56943693,0,24,0,3,4,31
5882,1702,2022-10-21 16:07:00,942a212575c28d1734f1396324575ec7,0,12,0,7,5,24
5883,1702,2022-10-21 16:12:00,54660cec4dfbec4732b160c7039e9c2a,1,27,0,5,2,35
5884,1702,2022-10-21 16:17:00,bd8cec364eb70d9c175d7a9c6f9ffdf8,0,22,0,2,6,30
5885,1702,2022-10-21 16:22:00,d69c89c7a50f417caa4339458235ddfb,0,22,0,3,8,33
5886,1702,2022-10-21 16:27:00,1b147be88d59baee3e1bd6d5743b063b,0,17,0,3,10,30
5887,1702,2022-10-21 16:31:00,e0c5338a1d74f97d92f0ce71a23b17e6,0,18,0,4,8,30
5888,1702,2022-10-21 16:37:00,496f47199e01f0da5f7c5c807223f354,0,20,0,4,11,35
5889,1702,2022-10-21 16:42:00,8d7fdfcf01ed1a5a45ef66dbfe54cd23,0,16,0,5,10,31
5890,1702,2022-10-21 16:47:00,f96996b479356ace3025773d42f2ca26,0,20,0,3,7,30
5891,1702,2022-10-21 16:52:00,bc51b219837bb85e37c8cd49486febc6,0,15,0,18,6,39
5892,1702,2022-10-21 16:57:00,0e013c93fc1e945f926e767fe6c16e66,0,14,0,8,19,41
5893,1702,2022-10-21 17:02:00,44fb0aca2b3b2e4dc611c1ea2f3ce320,0,18,0,4,8,30
5894,1702,2022-10-21 17:07:00,683256fe234d67f6718738c9eca92503,1,23,0,4,10,38
5895,1702,2022-10-21 17:13:00,17e7c2f479296bb81cf49c34d0209941,0,20,1,4,8,33
5896,1702,2022-10-21 17:17:00,a81cd0d0ca53993d160d07d1902ed2d9,0,25,0,3,9,37
5897,1702,2022-10-21 17:22:00,532cf00192bbd94acd6199f145a9836d,1,17,1,6,15,40
5898,1702,2022-10-21 17:27:00,9085a7d23bbfc149e8af21ab6cd1527a,0,20,1,1,11,33
5899,1702,2022-10-21 17:31:00,cf04fccec09ccd5fab46a79a0e6f711b,0,22,0,6,9,37
5900,1702,2022-10-21 17:38:00,f6ca5ba125765fe94c64ccf7365c86bf,0,19,0,7,16,42
5901,1702,2022-10-21 17:42:00,bdf1efb98b2c48f34221b28a1bdfd16c,0,10,0,4,19,33
5902,1702,2022-10-21 17:47:00,9fcd029d86ceaa006b19bc8a9c1ec594,0,14,0,4,13,31
5903,1702,2022-10-21 17:52:00,73cca3bbdeb5ea962cfd9f2838c13807,1,17,2,4,13,37
5904,1702,2022-10-21 17:57:00,c20091d083db71984aec23be640879aa,1,17,1,2,13,34
5905,1702,2022-10-21 18:02:00,f3e32023c18be5a4b1dfb7b9154b3291,0,22,0,5,9,36
5906,1702,2022-10-21 18:07:00,272ddcc0356bc61f3c8bc89f39ae44a1,0,15,0,9,13,37
5907,1702,2022-10-21 18:12:00,26234db77fc89afc6fa5b045842f0c6d,0,19,1,4,6,30
5908,1702,2022-10-21 18:17:00,4b87e6e0eb824882216f8005eeeb594f,0,20,0,4,9,33
5909,1702,2022-10-21 18:22:00,d722e1faa1a6095a6d5425fffc4046b0,0,20,0,3,8,31
5910,1702,2022-10-21 18:27:00,55428677f770ae5ea59245519ecfeb24,0,21,0,4,8,33
5911,1702,2022-10-21 18:31:00,924d06cc6ae6f024cf235d0ff7d64cc8,0,19,1,1,11,32
5912,1702,2022-10-21 18:37:00,3eef4bbbb831c7b7a05999a924e8c9e9,0,13,0,4,13,30
5913,1702,2022-10-21 18:42:00,0d203c9be263b53d3092ef7dfbe237d4,0,17,1,0,12,30
5914,1702,2022-10-21 18:47:00,ba8751ba711d9be47952cafcedb0d885,0,11,0,2,11,24
5915,1702,2022-10-21 18:52:00,d24205c2e799ba1f148b41b9b1aaebf8,0,23,0,0,9,32
5916,1702,2022-10-21 18:57:00,d632da8aba29c7cc381df8d6ba9e7692,0,19,0,1,5,25
5917,1702,2022-10-21 19:02:00,ef21c286a15b8de60b0e0848562c4bcc,0,21,1,1,2,25
5918,1702,2022-10-21 19:07:00,f0f6ba8a4cce53970c692249b44c550b,0,25,0,1,1,27
5919,1702,2022-10-21 19:12:00,aa90b97819e544c9746e74968fc6277f,0,21,0,0,0,21
5920,1702,2022-10-21 19:17:00,ab0b8ac924f6682b4439224d9332fed8,1,21,0,0,2,24
5921,1702,2022-10-21 19:21:00,169bbed9ad2ca570455055d72eee9a77,0,15,0,3,2,20
5922,1702,2022-10-21 19:26:00,364ab4f1dfa8469fa5ad948573c52d0a,0,11,3,1,1,16
5923,1702,2022-10-21 19:32:00,cca63d2a77bb1d858b4bd1eec71257d1,0,18,1,0,1,20
5924,1702,2022-10-21 19:38:00,63fd8f4a715af4721055e9aa8cfa36da,0,20,0,1,2,23
5925,1702,2022-10-21 19:42:00,9efc1d93d019f9ce5599bb2c7a6da99a,0,16,0,1,4,21
5926,1702,2022-10-21 19:46:00,818ce4d113430630a20f496d7ef0e93e,1,24,0,0,2,27
5927,1702,2022-10-21 19:51:00,ee697e3a6a16a042496e7c8422058488,0,14,0,3,1,18
5928,1702,2022-10-21 19:56:00,45dbb27b78f19431fb42febfda45e7e6,0,19,1,0,1,21
5929,1702,2022-10-21 20:02:00,f9e02aeda7a6930135438b1d4ac9473f,0,16,0,0,1,17
5930,1702,2022-10-21 20:07:00,df0dbde598a9bd89de4f87dee894432f,0,20,1,0,1,22
5931,1702,2022-10-21 20:12:00,4b944a5d848f06d4092a03c185ec1bfb,0,16,0,0,1,17
5932,1702,2022-10-21 20:17:00,de2692ca81d44069ab4cae014044d4d9,0,9,0,0,3,12
5933,1702,2022-10-21 20:22:00,372bef7f53a146672265a1351c4b3db7,0,11,1,1,2,15
5934,1702,2022-10-21 20:27:00,029a1f748707daa27defd7cf09a058f8,0,11,0,1,3,15
5935,1702,2022-10-21 20:32:00,35bd48de4158c586d6e7e155d4255739,2,8,0,2,3,15
5936,1702,2022-10-21 20:37:00,b8d314ca8c7b8888c9e0d9b668878d2a,1,16,0,0,2,19
5937,1702,2022-10-21 20:41:00,64a5fbb768736abbf000c3481d11259e,0,16,0,0,0,16
5938,1702,2022-10-21 20:47:00,49b217b2764f1f79d64e3add4ae3c4f7,0,17,0,1,0,18
5939,1702,2022-10-21 20:52:00,ca3d2b2d05fa98938530e332b07288cd,0,15,0,4,0,19
5940,1702,2022-10-21 20:57:00,881d66aac8aa05392aa22e053210abeb,0,16,0,2,0,18
5941,1702,2022-10-21 21:02:00,10aaa87c6d1c57e30c8f7ca80c2c23a5,0,19,0,1,1,21
5942,1702,2022-10-21 21:07:00,ac95e15d56f971b273a67305b923e180,0,12,0,0,0,12
5943,1702,2022-10-21 21:12:00,1725224c6de23a6b2c03e03dab0f10c6,0,20,1,2,1,24
5944,1702,2022-10-21 21:17:00,a49f2be8bde251ad1359410d6f4e070b,0,20,1,0,0,21
5945,1702,2022-10-21 21:21:00,bcadf9ce32935250b46fb3ba767c4288,0,17,1,0,1,19
5946,1702,2022-10-21 21:27:00,0281151c93a11a058f21bfc4975d310c,0,19,0,0,1,20
5947,1702,2022-10-21 21:31:00,770a9fb081b75b43b5217aa3e1e87636,0,21,0,1,1,23
5948,1702,2022-10-21 21:37:00,019a4d95d11ed009b3257b7d4034ebc5,0,14,0,1,2,17
5949,1702,2022-10-21 21:41:00,babf56554c357df47a7df127348ea69f,0,21,0,0,0,21
5950,1702,2022-10-21 21:47:00,ba668a9a6bdf00d3927aea02ce4bd3fe,0,20,2,0,1,23
5951,1702,2022-10-21 21:52:00,933481659ce339e4b655f14d2bbb10b0,0,19,2,0,2,23
5952,1702,2022-10-21 21:57:00,6d009363beebae3707a184eb13aae5d0,0,22,0,0,0,22
5953,1702,2022-10-21 22:02:00,8391c4c74422cd1525d3aca7f1e7f3db,0,19,1,0,1,21
5954,1702,2022-10-21 22:07:00,df731246d07ad3dfb14ef814b889587a,0,13,1,0,0,14
5955,1702,2022-10-21 22:11:00,c094dcd8ddf0b4f2d7e256452e3720d7,0,22,0,0,1,23
5956,1702,2022-10-21 22:17:00,ae60858b6969bc19ad3624fe4126d6d2,0,19,0,0,0,19
5957,1702,2022-10-21 22:22:00,cfd4c0c7e377bc0364717b8727517b27,0,21,0,0,2,23
5958,1702,2022-10-21 22:31:00,857c19a1eee2803667a1ef71c47d9c83,0,23,0,0,1,24
5959,1702,2022-10-21 22:37:00,f433fc5fa443da892de6bdaa5a7cd08a,0,23,1,0,3,27
5960,1702,2022-10-21 22:42:00,249accf48422235ec09f8b195830dcca,1,25,0,0,1,27
5961,1702,2022-10-21 22:47:00,09523abe9ebc9dca14004f9f282f998f,0,23,0,0,1,24
5962,1702,2022-10-21 22:51:00,e30c799879467df38e7dd16b70037c78,1,22,3,0,0,26
5963,1702,2022-10-21 22:57:00,a81ed86f7835a12617055def7b7286eb,0,18,1,0,0,19
5964,1702,2022-10-21 23:01:00,74cc471efec9683043c93fa833630076,0,25,0,0,2,27
5965,1702,2022-10-21 23:08:00,c67cfa41e0b851f4eb16fccfd061d177,0,21,0,0,2,23
5966,1702,2022-10-21 23:12:00,2bc7cfc98ce76c484faf35dee21e0861,0,17,1,0,0,18
5967,1702,2022-10-21 23:17:00,dfc98b92d0fbc77364c9aaf032804089,0,11,0,0,2,13
5968,1702,2022-10-21 23:21:00,1cd5ebcecafe6eb1e9cddcc364c11cbe,0,14,0,0,0,14
5969,1702,2022-10-21 23:26:00,719f883a6a2532914f60810a8088f282,0,13,0,0,0,13
5970,1702,2022-10-21 23:31:00,2d9508b1d2926e6fb6c2e15f16cfa967,1,16,2,1,1,21
5971,1702,2022-10-21 23:37:00,d6dff6f974713c899912dc91dade2bb0,0,15,2,0,1,18
5972,1702,2022-10-21 23:41:00,3b20e226f5bba1632e13930bc6db82fc,0,14,0,0,0,14
5973,1702,2022-10-21 23:47:00,91bd23466d1b417e58f17cc99dbe2907,0,18,0,0,0,18
5974,1702,2022-10-21 23:53:00,b01e1b942bc1774bb260171eff70e5a8,0,13,0,2,1,16
5975,1702,2022-10-21 23:56:00,d02d7baffbdf5801615b190a213fa7b0,0,26,1,0,1,28
5976,1702,2022-10-22 00:01:00,b95388c58a0b079e875fdd3ab207eb0d,0,15,0,2,0,17
5977,1702,2022-10-22 00:07:00,42e16efdbbe4782e1ecc3846aa015b2c,0,15,0,1,0,16
5978,1702,2022-10-22 00:12:00,e6ae0ad2776337de75f7aeed107430b9,0,5,1,0,0,6
5979,1702,2022-10-22 00:16:00,db550747e66cbf45edc9a36b722312a7,0,10,0,0,0,10
5980,1702,2022-10-22 00:22:00,1f8e840b38094c4043ff7245722a011f,0,7,0,1,1,9
5981,1702,2022-10-22 00:27:00,b404660be49793745cb92ce23e8bdeb3,0,15,0,0,0,15
5982,1702,2022-10-22 00:31:00,b2777b9422cfa9e50f5456cb2828e92b,0,12,0,0,0,12
5983,1702,2022-10-22 00:36:00,04cc45cc145270a7f0f8f576b861d38c,0,15,0,0,0,15
5984,1702,2022-10-22 00:42:00,ebf29904c104b7e65d8cc1701ad1beef,0,7,0,0,0,7
5985,1702,2022-10-22 00:47:00,61a2a8344517c70f3bb8867d5d68b9e9,0,6,0,0,0,6
5986,1702,2022-10-22 00:51:00,1121ef5cb36f926e067584dc3790230c,0,9,1,1,1,12
5987,1702,2022-10-22 00:56:00,150958138327a2b7316ec6f4c65ba8a6,0,11,0,0,0,11
5988,1702,2022-10-22 01:02:00,d6e02a41f302ffcf901668a6829117e7,0,13,1,0,1,15
5989,1702,2022-10-22 01:11:00,81617f948f084dbf00df910075f7c109,0,12,1,0,0,13
5990,1702,2022-10-22 01:17:00,70f782d68c2f347ad9e83f1405c71edc,0,15,0,0,0,15
5991,1702,2022-10-22 01:21:00,490070ed8e9d736757f0f65ee41ea51c,0,11,0,0,0,11
5992,1702,2022-10-22 01:27:00,547bda5252d1216e7a7e039b94d35b4e,0,13,2,0,0,15
5993,1702,2022-10-22 01:31:00,d15d5daf316f9732d512164968bac912,0,6,0,0,1,7
5994,1702,2022-10-22 01:37:00,5f9fd11c5a99dbf7584eac05b169b325,2,13,0,0,0,15
5995,1702,2022-10-22 01:41:00,f647485d76c672b0c707280682dced08,0,11,0,0,0,11
5996,1702,2022-10-22 01:47:00,bd30055a5b855ecfe5c343a8495c11b9,0,8,0,0,0,8
5997,1702,2022-10-22 01:52:00,60374065d80400b5ed671f1c3593a27c,0,14,0,0,0,14
5998,1702,2022-10-22 01:57:00,520968dfb3f82578797c161a298bad20,0,17,1,0,0,18
5999,1702,2022-10-22 02:02:00,77e956d1efad283aebd2c28a31f41555,0,16,0,0,2,18
6000,1702,2022-10-22 02:06:00,feee97ebe5a1e680b50d075fa14af196,0,12,0,0,0,12
6001,1702,2022-10-22 02:12:00,0dcf42a8637f19bcfb70f7ddfa1b6ad0,0,11,0,0,1,12
6002,1702,2022-10-22 02:17:00,526a2a808b23e7cf9b3064d4cdb6b93c,0,4,0,0,1,5
6003,1702,2022-10-22 02:22:00,38fcfe4500220a44fb10c4185191a034,0,16,0,0,0,16
6004,1702,2022-10-22 02:27:00,9a63ec22bc14ff3f4c8da1beee9c0aa1,0,20,0,1,0,21
6005,1702,2022-10-22 02:32:00,52a8b106aad290b5b7767680ba4f950f,0,11,0,0,0,11
6006,1702,2022-10-22 02:37:00,81e30919c8ffdf55152fb60809c6f666,0,9,0,0,0,9
6007,1702,2022-10-22 02:41:00,4c1269b39968486b0ea433a01124f1df,0,5,0,0,1,6
6008,1702,2022-10-22 02:47:00,ac3780530217fe48de3e1b7e7637d3ab,0,5,0,0,0,5
6009,1702,2022-10-22 02:52:00,1625290c496bcaf7df68e359f5818032,0,7,0,0,0,7
6010,1702,2022-10-22 02:56:00,4dbd48655a91678583390ecf4dd57856,0,6,0,1,0,7
6011,1702,2022-10-22 03:01:00,9074dc56152d59ac8d8e3389fb463d86,0,14,1,0,0,15
6012,1702,2022-10-22 03:06:00,8daebc572e6808d9e0003ff451733d0f,0,3,0,1,2,6
6013,1702,2022-10-22 03:12:00,d414901bac5f20797816b11551e1208d,0,7,0,0,0,7
6014,1702,2022-10-22 03:17:00,69c47897371a51f053fc96b1a441f3b2,0,8,1,0,0,9
6015,1702,2022-10-22 03:22:00,ad0d74f84e258edc700740f3873fc375,0,9,0,0,0,9
6016,1702,2022-10-22 03:27:00,fd924d37b69bdf5796f2efa619fabea2,0,10,0,0,0,10
6017,1702,2022-10-22 03:32:00,c813becc88d1c8fbcf584d59dab81d77,0,7,0,0,0,7
6018,1702,2022-10-22 03:37:00,c7226acc646cafccd1bf152efb9c2c86,0,6,0,1,0,7
6019,1702,2022-10-22 03:41:00,8c73940106416dacfdb566cbb020e1a8,0,9,0,0,0,9
6020,1702,2022-10-22 03:46:00,8120a39d85f1e43a9fa39ae92421ad8b,0,10,0,0,1,11
6021,1702,2022-10-22 03:51:00,46cd5c55e302958af820daf24897fe6e,0,6,0,1,1,8
6022,1702,2022-10-22 03:56:00,1c7a6d34cc4cf75713de5fafcd2d05eb,0,5,0,0,0,5
6023,1702,2022-10-22 04:02:00,c14cfeee323ac92fd05af785ecd1f01c,0,2,0,0,0,2
6024,1702,2022-10-22 04:06:00,9e58a137e4c1b8c57b3ad5df097cece3,0,3,0,0,0,3
6025,1702,2022-10-22 04:12:00,2592dc192aa2d06285f60ba799351de3,0,3,0,0,0,3
6026,1702,2022-10-22 04:17:00,7ff3b03680da673006615211f2c7af51,0,9,0,0,1,10
6027,1702,2022-10-22 04:22:00,7c7e4e61dddda3e41ce31686b82121d2,0,18,0,1,0,19
6028,1702,2022-10-22 04:27:00,6950b4627bddc8583b4ea4cbd5b53297,0,8,0,0,0,8
6029,1702,2022-10-22 04:32:00,5fd35b16ace25c24031bfd6aab766bf6,0,4,0,0,0,4
6030,1702,2022-10-22 04:37:00,e81ee142aaffc52de35faeccf118248b,0,7,0,0,0,7
6031,1702,2022-10-22 04:41:00,adc67446484656d323ff33f1767ee0e9,0,3,0,0,0,3
6032,1702,2022-10-22 04:47:00,5a22691e42e4cf9c15ec6fbb46968ad6,0,3,0,0,0,3
6033,1702,2022-10-22 04:52:00,72916451617f0d212c2f3dd784e2cb77,0,4,0,1,0,5
6034,1702,2022-10-22 04:56:00,225350604653f113717a0b4a5957c9d9,0,4,1,0,1,6
6035,1702,2022-10-22 05:02:00,7799caa0d56afb09e351e6109181d804,0,6,1,0,0,7
6036,1702,2022-10-22 05:07:00,887cbb109d98aa1cad3088cda037d9ab,0,0,0,0,0,0
6037,1702,2022-10-22 05:11:00,219a24ddc12457549180975f6e8e916a,0,7,0,1,0,8
6038,1702,2022-10-22 05:17:00,c0cc51cac39fca6ca4dc9a75d11139f3,0,8,0,0,0,8
6039,1702,2022-10-22 05:22:00,2429ad04ca12d399bea5ff632bf2d16b,0,5,1,0,1,7
6040,1702,2022-10-22 05:27:00,5a1110c36e4ea6cef5c4f03041cad131,0,3,0,0,0,3
6041,1702,2022-10-22 05:32:00,b0fefcb6f73c64e624a3dfbd0a3bba7c,0,7,0,1,1,9
6042,1702,2022-10-22 05:37:00,3fbe39d9ad4d682dcb34b6aadf8fb01d,0,3,0,1,0,4
6043,1702,2022-10-22 05:41:00,95d749fec0b595e492c5239f1af05223,0,3,0,0,0,3
6044,1702,2022-10-22 05:47:00,dc7a91fa57260229a411379f9215827f,0,3,0,1,0,4
6045,1702,2022-10-22 05:52:00,2aa4580f43778c7738cb64cc7665a098,0,3,2,0,1,6
6046,1702,2022-10-22 05:56:00,d9233bb3dc6aed68cd7bba7d7e55990d,0,5,1,1,2,9
6047,1702,2022-10-22 06:02:00,b964b87a1c825836f41864f583046680,0,4,0,2,0,6
6048,1702,2022-10-22 06:07:00,df5ae3811824e1526f3840ba047fa5a0,0,1,0,0,0,1
6049,1702,2022-10-22 06:11:00,62cc8dc1848a12058e4ae22a7b663b45,0,3,0,1,1,5
6050,1702,2022-10-22 06:16:00,917ae1015f7eadbb30410b47cb1333d3,0,9,2,1,0,12
6051,1702,2022-10-22 06:21:00,18207ae797728bd237c31d3f5fe4455d,0,2,0,0,1,3
6052,1702,2022-10-22 06:27:00,e6edb98dfc7df7c0ceecd7146a6a5822,0,8,0,1,0,9
6053,1702,2022-10-22 06:32:00,9332074bd091fc844a8573e21213341f,0,13,0,1,1,15
6054,1702,2022-10-22 06:36:00,0d9c4c93124e9fa2b7e498aeb3c27ac0,0,14,2,0,1,17
6055,1702,2022-10-22 06:42:00,53494789d6336009facf8c3f32c70016,0,13,0,0,3,16
6056,1702,2022-10-22 06:46:00,2530d6655c04dee6cd2e9b226b782456,0,8,0,1,0,9
6057,1702,2022-10-22 06:52:00,665ab46ff6feae964e306257bc828cbc,0,2,0,1,9,12
6058,1702,2022-10-22 06:57:00,317ef065405a2735bf3fb7ac3d16c900,0,10,1,1,5,17
6059,1702,2022-10-22 07:02:00,7ed9ba23531e059c07de12e5d81f4bac,0,9,0,0,4,13
6060,1702,2022-10-22 07:06:00,9f95e787fad11f78aded92b3f200c895,0,8,0,0,12,20
6061,1702,2022-10-22 07:11:00,119b9b97dacbc640fa565ee38e07acc2,0,9,0,1,6,16
6062,1702,2022-10-22 07:16:00,9925a6b569fc71e58236e9a711a26c14,3,9,0,2,4,18
6063,1702,2022-10-22 07:21:00,782042200cc3297b0745464971517b07,0,11,0,2,2,15
6064,1702,2022-10-22 07:26:00,9b03e06f2d663d69ed4e37745405bd89,0,7,0,1,8,16
6065,1702,2022-10-22 07:33:00,63cf486f29c324982b6afa32b0e3065d,0,10,0,0,13,23
6066,1702,2022-10-22 07:36:00,d098e638ce41d1fa0b1ef49fa5d6cc51,0,14,0,0,11,25
6067,1702,2022-10-22 07:41:00,fff2e73fc508a50163d49702b250b79a,0,11,2,3,6,22
6068,1702,2022-10-22 07:47:00,10f17d166ca0f5fe2f25315c5b5f4c12,3,12,0,1,9,25
6069,1702,2022-10-22 07:52:00,1bf1a20030c1495210637d3933c0d5f8,0,22,0,0,5,27
6070,1702,2022-10-22 07:56:00,bf056c92e89557c703c9dd5c8126c3ee,2,7,1,4,5,19
6071,1702,2022-10-22 08:02:00,8dc7e32b0a275f312e599c6fb2128f0f,0,7,0,5,8,20
6072,1702,2022-10-22 08:07:00,e9d72567f9fc79023d8ae3d636e4011f,0,11,0,2,11,24
6073,1702,2022-10-22 08:11:00,2badc2aca8590d81c88a055999e3e060,0,14,0,2,8,24
6074,1702,2022-10-22 08:16:00,ded6158920f3a774180e512a93d998dc,0,12,0,0,7,19
6075,1702,2022-10-22 08:21:00,042584d7e58ec5e85acf3d3975719b90,0,12,1,0,10,23
6076,1702,2022-10-22 08:27:00,6912778c1049c2eb44ad490a3c7a867a,0,14,0,1,8,23
6077,1702,2022-10-22 08:33:00,0ba7cc6f5431ea7af12221655c0daa44,0,10,0,1,10,21
6078,1702,2022-10-22 08:42:00,eec1c10f17ea31cf0098e69d38d41217,0,7,0,1,14,22
6079,1702,2022-10-22 08:47:00,f97b116da72bce771fcefa2d336f9380,0,8,1,1,6,16
6080,1702,2022-10-22 08:52:00,49008c4c3bf9081fe5be480b47f26dcf,0,16,0,1,5,22
6081,1702,2022-10-22 08:57:00,4a2a4a5a4b8c3aad1ca095c9ddd4edc5,2,13,0,0,9,24
6082,1702,2022-10-22 09:02:00,be29090582d74c7a12fec2c902fb7631,0,13,0,2,7,22
6083,1702,2022-10-22 09:07:00,bff87c45ad187009d84f45cf053f0c86,0,11,0,1,11,23
6084,1702,2022-10-22 09:12:00,9021420f9cb68d61cf1e5a4144094fb4,0,14,0,2,9,25
6085,1702,2022-10-22 09:18:00,60a4770c08a5a97fa1542aa645f46e1e,0,15,0,0,8,23
6086,1702,2022-10-22 09:22:00,cde78dc6ec4d777117f95294822af447,0,11,0,0,5,16
6087,1702,2022-10-22 09:27:00,bf9c222239a8a1da3ffa87ea15ccad5d,0,12,1,1,10,24
6088,1702,2022-10-22 09:32:00,79802208ff5303d70e9083f9b4de99fd,0,14,0,1,10,25
6089,1702,2022-10-22 09:37:00,db06fb7bed3470f2c73d8943be9e0555,0,12,0,5,6,23
6090,1702,2022-10-22 09:42:00,6ffcab1a090b687cb4e31162f1283212,0,20,0,4,6,30
6091,1702,2022-10-22 09:47:00,7502d3de9a73a2fee9447c2946eb941f,1,10,0,1,8,20
6092,1702,2022-10-22 09:52:00,88a4250588e9c0948d23ef300ed17dfc,0,5,0,1,8,14
6093,1702,2022-10-22 09:57:00,ef5070e515f390185273f04b19844108,0,10,0,3,10,23
6094,1702,2022-10-22 10:03:00,b993a233cb30c23230673d9e9410bf51,0,22,0,0,11,33
6095,1702,2022-10-22 10:07:00,45de43aeba379a221a81623c8eea820a,0,17,0,0,4,21
6096,1702,2022-10-22 10:12:00,5359bed6d5df1d7d61d88954a161f576,0,12,0,2,10,24
6097,1702,2022-10-22 10:17:00,9ed3461291538e6a89e8b6f42e4c93ca,0,18,0,1,4,23
6098,1702,2022-10-22 10:21:00,67851b7258b9d0cad10559cf2a82f697,0,21,0,1,7,29
6099,1702,2022-10-22 10:27:00,0570c920ade78f80eca19d9bfb563790,2,12,0,0,12,26
6100,1702,2022-10-22 10:32:00,cb0d4f12b1a8477367a01a9ba95062a7,0,17,1,1,3,22
6101,1702,2022-10-22 10:37:00,c6adb7c3c6ac07dbc9fdcce6d5cfa5c0,0,18,0,3,7,28
6102,1702,2022-10-22 10:42:00,05fe2a522b4704c4bb8ed68aa641b540,0,7,0,1,14,22
6103,1702,2022-10-22 10:47:00,8d4bfa095b37eb7d3a570b122bf57b82,0,17,0,1,10,28
6104,1702,2022-10-22 10:51:00,3a964e39e91e6b56909d58dfb67413c9,0,10,0,1,13,24
6105,1702,2022-10-22 10:57:00,a7f604dd6792abd3acf743d3e3b33fa4,0,9,0,5,11,25
6106,1702,2022-10-22 11:02:00,add8687a5c52b9df07117b27f0c1b4ed,0,9,0,2,13,24
6107,1702,2022-10-22 11:08:00,38f79f7c7d42ba86b3b8e00f4109b781,0,12,1,3,6,22
6108,1702,2022-10-22 11:11:00,6842e744b92f6b3f36236caccf62a594,0,15,0,2,9,26
6109,1702,2022-10-22 11:17:00,32f962e244c159b35fc7abe49ee57f80,0,14,1,4,6,25
6110,1702,2022-10-22 11:22:00,fe364af81857ea5b99e96337cb316700,0,19,0,4,7,30
6111,1702,2022-10-22 11:27:00,5e6ef33eeb892ee499513025b15ad836,0,22,1,3,9,35
6112,1702,2022-10-22 11:32:00,fe737593bd08fdd6d81c873da74379c4,4,10,1,3,9,27
6113,1702,2022-10-22 11:37:00,5ad22b06f4608cb2171928a482d10dc2,0,12,0,1,9,22
6114,1702,2022-10-22 11:42:00,834ff3c3ffafd04c4d56fb0ea4d51e9f,0,13,0,1,9,23
6115,1702,2022-10-22 11:47:00,93c6e630436540dde7a5ac1f5905a387,0,17,0,4,3,24
6116,1702,2022-10-22 11:52:00,0c9a592b7c724639d45962b29c8502e9,0,14,0,5,9,28
6117,1702,2022-10-22 11:57:00,4a1d78074a0f3b206e88ebbd29fe3656,0,15,0,5,9,29
6118,1702,2022-10-22 12:03:00,aed535a58dca9d028dde2ef158edc3c1,0,18,0,3,7,28
6119,1702,2022-10-22 12:07:00,f2da21397010e5428c27ced6fd03fffe,0,16,0,5,3,24
6120,1702,2022-10-22 12:12:00,6a03135877cdca6c0ece333572dd6656,0,19,1,2,2,24
6121,1702,2022-10-22 12:18:00,ebad8deb6a228d701f439e502a8a0f04,0,12,0,3,14,29
6122,1702,2022-10-22 12:23:00,fac15805868bebf83ffc29e4982c2d4c,0,14,0,5,11,30
6123,1702,2022-10-22 12:27:00,e775873470b454b5049abaad285bfe27,0,13,0,1,13,27
6124,1702,2022-10-22 12:31:00,dffb30e8d35defe8018ec8af16abeb2b,1,13,0,2,4,20
6125,1702,2022-10-22 12:38:00,4713f4b46c28a017a45f9d2c484d8cac,0,9,0,3,13,25
6126,1702,2022-10-22 12:42:00,e8cd66953900e4eb427726ab08e6d77c,0,16,0,4,7,27
6127,1702,2022-10-22 12:47:00,be8a661e959f0b28e95e8781861189ad,0,17,1,3,6,27
6128,1702,2022-10-22 12:52:00,4f18754c61e7a807f57a75d5a5476fb5,0,15,0,1,11,27
6129,1702,2022-10-22 12:57:00,530f7f347edc710459074a564cf4a92d,0,22,0,6,3,31
6130,1702,2022-10-22 13:02:00,3828f0a30ba5095826945f2cacb930e8,0,21,0,1,7,29
6131,1702,2022-10-22 13:08:00,26bd1629719c9ba59d542305068233fb,1,17,1,2,6,27
6132,1702,2022-10-22 13:12:00,aa88627968b331cb2c8e770017587bf8,0,11,0,6,10,27
6133,1702,2022-10-22 13:17:00,8a61d1292ff2e5e61d0373f2255546e1,0,16,0,3,12,31
6134,1702,2022-10-22 13:22:00,f68a0c265ef098be763548861574ed7a,0,11,1,4,10,26
6135,1702,2022-10-22 13:27:00,df3727bd04f30f4f0a5eb549f04301c0,0,16,0,1,9,26
6136,1702,2022-10-22 13:32:00,6483ea5c1c4da9783df6c3fc593e611b,0,16,0,1,7,24
6137,1702,2022-10-22 13:37:00,3d555abc1d4feb41f58d2210aadb6885,0,24,0,3,8,35
6138,1702,2022-10-22 13:43:00,2794b1a839b895a136ff44f05d6cda92,0,20,0,3,6,29
6139,1702,2022-10-22 13:47:00,a4dca726413c926eab9476f08b9745a9,0,22,0,1,2,25
6140,1702,2022-10-22 13:53:00,3faca5a0d71411e62b04651799a468c8,1,20,0,0,6,27
6141,1702,2022-10-22 13:56:00,775f8e9a76f3b11e34d07082b9b587c0,0,22,0,4,2,28
6142,1702,2022-10-22 14:02:00,1261764e4473ad0d871d69c2ea566f0e,0,27,0,1,4,32
6143,1702,2022-10-22 14:07:00,c290fa655a96fba72185f8103cd7b50d,0,19,0,2,6,27
6144,1702,2022-10-22 14:12:00,84f574aa4e0d5677d8c3176add9fe83f,0,22,0,0,11,33
6145,1702,2022-10-22 14:17:00,1f6474ea86f2e9e25eac1e70b4944dc8,0,35,0,4,7,46
6146,1702,2022-10-22 14:23:00,fb644090a798819d6f2b5d3eaca180be,0,17,0,3,10,30
6147,1702,2022-10-22 14:26:00,46d55ae8acfe13d4a7845f2b5e844f62,0,27,1,3,3,34
6148,1702,2022-10-22 14:32:00,0a44bf958542fb2b113a2bf54c237095,0,23,0,4,9,36
6149,1702,2022-10-22 14:37:00,8d9b0c39cf51a796e8fd364c2f5ca2d1,0,24,0,5,1,30
6150,1702,2022-10-22 14:42:00,dd960254098a0e96ff88f9910cc2528d,0,15,1,1,12,29
6151,1702,2022-10-22 14:47:00,62aa23944c1b7ed901255b39b1f90a55,0,16,2,3,10,31
6152,1702,2022-10-22 14:52:00,452a566ec2917263213a7ddaa5a8b5cd,1,23,0,3,7,34
6153,1702,2022-10-22 14:57:00,415f2b907113c0be8c50672095aa17ee,0,20,0,2,10,32
6154,1702,2022-10-22 15:02:00,c3e7da19c4f36f9ef05c82a56536b3f4,0,22,0,2,10,34
6155,1702,2022-10-22 15:06:00,6680c32776d8157528974e65d048846b,0,19,0,1,10,30
6156,1702,2022-10-22 15:12:00,ac1be51121cfdd5b29dca8726ba4dd1e,0,15,0,2,14,31
6157,1702,2022-10-22 15:17:00,b5e7b99629d4dd9b3dd0a897d8ea9568,1,16,0,0,9,26
6158,1702,2022-10-22 15:22:00,34d76ea18d34536338fdff83d33e291a,0,15,0,0,9,24
6159,1702,2022-10-22 15:27:00,ed35e94d98885234da25847aab204d3c,1,13,1,3,10,28
6160,1702,2022-10-22 15:32:00,fe62d8d45368e25168addebba2d09abf,0,15,0,2,5,22
6161,1702,2022-10-22 15:37:00,928cab5384d37c85b2f2a60f30422366,0,23,1,4,5,33
6162,1702,2022-10-22 15:42:00,7f52a2f90f21d6f04589d0acd5adbdb1,0,17,1,0,9,27
6163,1702,2022-10-22 15:47:00,cc68fd55757b66319cd9550af04abdcc,1,17,1,2,10,31
6164,1702,2022-10-22 15:52:00,b37033bc9f62acff3fdf202283319c17,0,12,0,0,16,28
6165,1702,2022-10-22 15:57:00,634d22e4093fb5246b5e5cfb451e51cf,0,15,0,1,10,26
6166,1702,2022-10-22 16:03:00,ed21a361f34e20e9f0aa6ff9d58cb2a2,0,12,0,1,16,29
6167,1702,2022-10-22 16:08:00,a2b3dbb0e95ca4172671aeccad01fda1,0,18,0,3,10,31
6168,1702,2022-10-22 16:12:00,cf0986e079ac43f68387e55b03d001cf,0,24,0,3,4,31
6169,1702,2022-10-22 16:17:00,d7160951fbdbb79533cc3654287c4320,0,22,1,0,7,30
6170,1702,2022-10-22 16:21:00,d59ee860867724d96b0077b3d7a8e402,0,18,2,4,9,33
6171,1702,2022-10-22 16:27:00,214637313c672606cb40883ecae5ddd5,1,19,0,1,8,29
6172,1702,2022-10-22 16:32:00,189300c8d063cd7fd7956de493a298bd,0,17,1,3,7,28
6173,1702,2022-10-22 16:37:00,13e4ad4102664a9c03502fba3e204c49,0,18,0,3,9,30
6174,1702,2022-10-22 16:42:00,70ec11124f2ccf9c0ea6d7fd8c83ef62,0,16,0,1,7,24
6175,1702,2022-10-22 16:47:00,49a0a58e88910dc36cf86f29394c45e4,0,13,0,2,8,23
6176,1702,2022-10-22 16:53:00,2aa0a6531c9e94db0c740850aa9f4e15,0,15,0,4,7,26
6177,1702,2022-10-22 16:57:00,2070de7afb99f5093e62b8ba0fde683c,0,17,1,4,6,28
6178,1702,2022-10-22 17:02:00,4abfeb237999d0b0775605a06abee4c9,0,16,1,1,9,27
6179,1702,2022-10-22 17:07:00,3354e82a6a4f9bf87b66ce4c1b001a24,0,15,1,4,9,29
6180,1702,2022-10-22 17:12:00,b5c6b4c5a1bde7f0d8ebfbe05e8caad6,0,19,0,1,7,27
6181,1702,2022-10-22 17:18:00,a547f31c174e1b6ebcd62899c60e7ad3,0,18,1,6,10,35
6182,1702,2022-10-22 17:21:00,3641f0cc8b0e81b284f617e0222cdca3,0,20,0,4,6,30
6183,1702,2022-10-22 17:27:00,061dfc8390a3ff0d4662a1b8bd53765e,0,21,0,1,9,31
6184,1702,2022-10-22 17:32:00,0e9427fed9cdc18ccd777c20fd14fa58,0,17,0,0,13,30
6185,1702,2022-10-22 17:36:00,99e8e62469af0f19332acb997ae264fc,0,14,0,2,8,24
6186,1702,2022-10-22 17:41:00,e6215df75d7fcd4497723902efdf1984,0,15,0,3,8,26
6187,1702,2022-10-22 17:47:00,08ce093a9be6b11959b94abecbac4d20,0,18,0,1,11,30
6188,1702,2022-10-22 17:51:00,b6c85730aec523a45ac750452a9e1d8e,0,25,0,5,8,38
6189,1702,2022-10-22 17:57:00,1c9b550dcaea4ef8472345e02f218c54,1,18,0,0,11,30
6190,1702,2022-10-22 18:02:00,f53e6be7f4152ef13d7791614862429c,0,20,0,3,2,25
6191,1702,2022-10-22 18:07:00,bd6951fb02bb396016e6da1375928623,0,14,0,5,9,28
6192,1702,2022-10-22 18:12:00,30119b56bae847d6981cfae2bd5fb6f6,0,18,0,2,11,31
6193,1702,2022-10-22 18:17:00,aeffc3ba917f7f345c473422aee05a08,0,21,0,2,5,28
6194,1702,2022-10-22 18:23:00,c29cf6cf38362393ab3949a38407c86f,0,23,0,3,4,30
6195,1702,2022-10-22 18:28:00,dca6378ef853cf01b90ca25d580e735c,0,20,0,1,5,26
6196,1702,2022-10-22 18:33:00,96128b7138660c49687ef68fea1f4431,0,20,0,2,2,24
6197,1702,2022-10-22 18:38:00,f8524d21abc0c2b7f907cc435868875f,0,27,1,2,6,36
6198,1702,2022-10-22 18:41:00,cbb56fa7782300c1542c4ab4f7cd1d23,0,29,0,1,2,32
6199,1702,2022-10-22 18:47:00,d7784c54029ef2da36b40e3fa440e665,0,19,0,3,7,29
6200,1702,2022-10-22 18:57:00,1e6600a2bbd74675be64a842e9a4a5d9,0,17,2,3,3,25
6201,1702,2022-10-22 19:01:00,4a0755b25e6371522271b617afc83bf1,0,15,3,0,3,21
6202,1702,2022-10-22 19:07:00,9b36b7e8e6e91d0d3c339c1ed230cc23,0,10,0,1,1,12
6203,1702,2022-10-22 19:11:00,1217f3acb0dbf3639d03aeee307693a5,0,20,0,2,0,22
6204,1702,2022-10-22 19:17:00,89aa7fc93e7a94596e8c0bd5bf0c88c4,0,25,1,0,0,26
6205,1702,2022-10-22 19:22:00,fbda4353fa0b0f20cc316acc1944beb9,0,32,1,1,2,36
6206,1702,2022-10-22 19:27:00,0e81982602f8156a59876b790781046c,0,20,1,0,0,21
6207,1702,2022-10-22 19:31:00,fa8e3534aa1105ee4f37f9c0ee819a31,0,15,1,1,0,17
6208,1702,2022-10-22 19:37:00,f8d8d2fdcc15f44ba89fe543926466c1,0,23,0,0,0,23
6209,1702,2022-10-22 19:41:00,c2d1c9fe10d000d3fc501f6c912ab039,0,21,0,1,0,22
6210,1702,2022-10-22 19:46:00,2fa60856a75e754e1f5b49ba52f1e304,0,13,0,0,0,13
6211,1702,2022-10-22 19:52:00,a53558579d793490d429f9d82630bade,0,16,0,0,0,16
6212,1702,2022-10-22 19:56:00,05878aa6c761922444c5921902b5dcdb,0,15,0,0,0,15
6213,1702,2022-10-22 20:02:00,80cd2a5f83526928b86eb19424f52551,0,17,0,0,0,17
6214,1702,2022-10-22 20:07:00,06a918fb5266e2142be01c1a35d82be7,0,11,0,0,0,11
6215,1702,2022-10-22 20:11:00,3d491514e7543b93cbcadb05da9f6e21,0,10,0,0,0,10
6216,1702,2022-10-22 20:17:00,dc2610a7db8c75a9c301d7f4ce26f62a,0,15,0,0,0,15
6217,1702,2022-10-22 20:22:00,feff95fa743f96d3f9f05edc0f48a53d,0,13,1,1,0,15
6218,1702,2022-10-22 20:26:00,b623129215ff413a33b0bd85d2771579,0,16,0,0,0,16
6219,1702,2022-10-22 20:32:00,b79b11bd920a3f3859d49a10719b1d26,0,15,0,0,0,15
6220,1702,2022-10-22 20:36:00,d129edecedda6cb63fe2d376bc42c7bf,0,19,0,0,0,19
6221,1702,2022-10-22 20:41:00,ad28b1d9d4c9fc7935decda2e254718d,0,7,2,0,1,10
6222,1702,2022-10-22 20:47:00,9378309cfe11547e2959c6162d8bf670,0,19,0,0,1,20
6223,1702,2022-10-22 20:51:00,314265d6759eabd8fd6e9a3568a42e72,0,18,0,0,1,19
6224,1702,2022-10-22 20:56:00,e22de1a5bebbfe9fb0bddd2623e9edb2,0,19,0,2,0,21
6225,1702,2022-10-22 21:02:00,ec059330d41de67796880cacdead9b32,0,10,0,0,1,11
6226,1702,2022-10-22 21:06:00,b7297a3d8cb84aa3def0ba02e8a34737,0,10,1,0,0,11
6227,1702,2022-10-22 21:11:00,40e687c859530571b35a21d97bbb6834,0,9,0,0,0,9
6228,1702,2022-10-22 21:17:00,c52170c3fc49f5dedf712192129372e8,0,11,0,0,0,11
6229,1702,2022-10-22 21:22:00,ec034cd2ac20e0367aee113b6cceb505,0,6,0,1,0,7
6230,1702,2022-10-22 21:27:00,ccab96f9d97b847d78004ce4439e8693,0,8,0,0,0,8
6231,1702,2022-10-22 21:32:00,fce294149c4d2758e060049204cd2627,0,16,0,0,0,16
6232,1702,2022-10-22 21:37:00,95f8310304a98898e3f3079f07f77b2e,0,5,0,0,0,5
6233,1702,2022-10-22 21:42:00,47fbe65b2b193438e577da87d1e68536,0,9,0,0,0,9
6234,1702,2022-10-22 21:47:00,61056fa2461946c78666078aa3433111,0,15,0,0,0,15
6235,1702,2022-10-22 21:52:00,d37701d8abb1afc47c324b2d079f7acc,0,15,0,0,0,15
6236,1702,2022-10-22 21:57:00,18139812820438b01d869e5d39458244,0,19,0,0,1,20
6237,1702,2022-10-22 22:02:00,368f88c1908092f92011c20d2fe4df55,0,9,0,0,0,9
6238,1702,2022-10-22 22:07:00,aaf71f052103e8849afcc514b12a0de6,0,21,0,0,0,21
6239,1702,2022-10-22 22:12:00,15f89d0724751a10157a6a1b1026c05c,0,19,0,1,0,20
6240,1702,2022-10-22 22:17:00,266c2fea090d0a970e011aeabfe338c4,0,20,1,1,0,22
6241,1702,2022-10-22 22:21:00,45b37b9dfc329a190ecebb4cb5886178,0,17,0,0,1,18
6242,1702,2022-10-22 22:26:00,ea4916876dfc12c184370a7657b3f15c,0,10,0,0,0,10
6243,1702,2022-10-22 22:32:00,51295cccc20d8c364e03152e55bdca26,0,19,0,0,1,20
6244,1702,2022-10-22 22:38:00,bb3add9f2eb9d15211f5314ad845af05,0,24,0,0,0,24
6245,1702,2022-10-22 22:41:00,7560fce0a98e0133fab67563befd94c7,0,16,0,1,1,18
6246,1702,2022-10-22 22:47:00,c950d405e96df3a7d5b7a03f9c05448c,0,17,0,1,0,18
6247,1702,2022-10-22 22:52:00,eaf61c19f522d44684d52c2e6bba0fad,0,12,0,0,0,12
6248,1702,2022-10-22 22:56:00,b30ae3f500a9680753562b6f550d12fc,0,15,0,0,0,15
6249,1702,2022-10-22 23:02:00,274249190ace7e20cdba6abe557515d4,0,14,0,1,0,15
6250,1702,2022-10-22 23:07:00,6b5f89e41931f3237438705b74cdb698,0,13,0,1,0,14
6251,1702,2022-10-22 23:11:00,8b1e049ff2acf652dc7d31e345736c7e,0,11,0,0,1,12
6252,1702,2022-10-22 23:17:00,6557b212931bc3bc1148a689b6eac45c,0,15,1,0,0,16
6253,1702,2022-10-22 23:22:00,1fe5255cc9e8ecc621a39f9348917e7e,0,12,2,0,0,14
6254,1702,2022-10-22 23:26:00,68b3e6e25a2966593bf955726df42bbc,0,5,0,0,0,5
6255,1702,2022-10-22 23:32:00,526c55d714da0d471bee127512b0f71e,0,15,0,0,0,15
6256,1702,2022-10-22 23:37:00,e4dbcc36bef22c69eed85ede6f40d095,0,13,0,0,0,13
6257,1702,2022-10-22 23:41:00,c20373acd2bd5c050910b0f7509dc188,0,8,0,0,0,8
6258,1702,2022-10-22 23:47:00,018932b4e5e110fe825366b7e69fca2f,0,14,0,0,1,15
6259,1702,2022-10-22 23:51:00,0060582cfb5a28c252115dad9bfc73d8,0,7,0,0,1,8
6260,1702,2022-10-22 23:57:00,8588899a2c8fdb1811a1639887deca02,0,7,0,0,1,8
6261,1702,2022-10-23 00:02:00,f34f3179eed0ecd6d435ca170e4dedbc,0,12,0,0,1,13
6262,1702,2022-10-23 00:07:00,f4063287eda5d830198fa252bee23770,1,11,0,0,1,13
6263,1702,2022-10-23 00:11:00,ae21f6bfa2a792054d71d0d2e104bfb6,0,9,0,0,0,9
6264,1702,2022-10-23 00:17:00,384c4248efb78077af4345085c3d2a7a,0,9,0,1,0,10
6265,1702,2022-10-23 00:21:00,73427e2cd241adfffc48daef4a5863d9,0,16,0,0,0,16
6266,1702,2022-10-23 00:27:00,3245a741dac80dbe9c1618a7bc576105,0,4,0,0,0,4
6267,1702,2022-10-23 00:32:00,030af288c876347db4933b551e0e7e43,0,11,0,0,1,12
6268,1702,2022-10-23 00:37:00,90d498b7683b7e3c89e030d214b9816a,0,6,0,0,0,6
6269,1702,2022-10-23 00:42:00,dffdf0d4b866354acad4382b30a5cca3,0,6,0,1,0,7
6270,1702,2022-10-23 00:46:00,4b9236494a975ba4f1782557d9d22bc0,0,3,0,0,0,3
6271,1702,2022-10-23 00:52:00,b4c1189f4065b0c07a0649e0c59b8c81,0,4,0,0,1,5
6272,1702,2022-10-23 00:56:00,12847fed5f1bafc26baf8aeee19f1589,0,7,0,0,0,7
6273,1702,2022-10-23 01:02:00,d28d734140e4bdd9234087bd3479459c,0,9,0,0,0,9
6274,1702,2022-10-23 01:17:00,0d5423269b6e3708af81ca98a8e3987e,0,4,2,0,0,6
6275,1702,2022-10-23 01:22:00,6d8b93629da13c7d7f0ca89b21a3213a,0,4,0,0,1,5
6276,1702,2022-10-23 01:26:00,b703fcd10c519967b5a95cd2f4b871d1,0,3,1,0,0,4
6277,1702,2022-10-23 01:32:00,e8f73f829b4f1cc6d51880f54c5e42b8,0,5,0,0,0,5
6278,1702,2022-10-23 01:37:00,83ba2500c2d5dbdf61195c410a28f4ee,0,5,0,1,0,6
6279,1702,2022-10-23 01:41:00,ec66bd79cb27c9f4a5c2481e8fefd7ba,0,3,0,0,0,3
6280,1702,2022-10-23 01:47:00,4f91555ffd837a9e1db23490654fde83,0,8,1,0,0,9
6281,1702,2022-10-23 01:51:00,53217e4bb2f16ee01337e0b56198fd24,0,2,1,0,0,3
6282,1702,2022-10-23 01:57:00,fd0c20ec8ec16305f836b1e257c3b085,0,6,0,0,1,7
6283,1702,2022-10-23 02:02:00,17d8839aed20189bc1df92a6fb920748,0,3,0,0,1,4
6284,1702,2022-10-23 02:06:00,89678a4d5122699751b7c8c858b16b58,0,9,1,0,0,10
6285,1702,2022-10-23 02:11:00,97f968ea0bdbaa904cae70d8ae10e742,0,9,0,0,0,9
6286,1702,2022-10-23 02:17:00,c9eb3767b07ef955c2e523cdbd926cf4,0,9,1,0,0,10
6287,1702,2022-10-23 02:22:00,f0e274b9e3c07d1cd465549ca294d4ef,0,7,1,0,1,9
6288,1702,2022-10-23 02:27:00,801c48683425d34df92c66aaa534d072,0,2,0,0,0,2
6289,1702,2022-10-23 02:31:00,24c52379ec2d4f8ef815c10d7caa7a52,0,6,0,0,0,6
6290,1702,2022-10-23 02:38:00,73db94c1a55ab515650f48cdaa9aa4f5,0,5,0,0,0,5
6291,1702,2022-10-23 02:41:00,d832b02d2379d629ede9cb899f2e8703,0,2,0,0,0,2
6292,1702,2022-10-23 02:47:00,a03ec48388d836413363d20f83c482fa,0,10,0,0,0,10
6293,1702,2022-10-23 02:51:00,b3ed40ea3ab69b16e355f5bfa16894a2,0,0,0,0,0,0
6294,1702,2022-10-23 02:57:00,6d3d3412c1788c688d00d788c622757b,0,7,0,0,2,9
6295,1702,2022-10-23 03:02:00,f1936f38d562e447f76f80363119a3dc,0,10,0,0,1,11
6296,1702,2022-10-23 03:07:00,af66e1d351e77336b7fbff1c09b18994,0,1,0,0,0,1
6297,1702,2022-10-23 03:11:00,c8c7baa2211bd39644b012b51ec2fcd2,0,8,1,0,1,10
6298,1702,2022-10-23 03:16:00,8b14eb758c3af0932031fe658ae29ac9,0,4,0,0,1,5
6299,1702,2022-10-23 03:22:00,f198483c24fbe30d4025ed9be34fa0c7,0,6,0,0,0,6
6300,1702,2022-10-23 03:27:00,9c6339241e2011607b293956fef8a310,0,1,0,0,0,1
6301,1702,2022-10-23 03:32:00,04ec3d3fdf70353e1e785134c12ca6ba,0,3,0,0,1,4
6302,1702,2022-10-23 03:36:00,0b1c193df08c56a04bddbe5fe265d015,0,7,1,0,0,8
6303,1702,2022-10-23 03:41:00,09fe881baa117400baa4eb6218dd30b1,0,13,0,0,0,13
6304,1702,2022-10-23 03:48:00,1261e4296ad45d1a3b1acc2923c16c10,0,5,0,0,0,5
6305,1702,2022-10-23 03:52:00,e9a111e9e371a19ba7e5ca5b94d3ead5,0,3,1,0,0,4
6306,1702,2022-10-23 03:56:00,7ed3faaf92870e6672e982c0ed0152e8,0,3,0,1,2,6
6307,1702,2022-10-23 04:02:00,d78ce3c198aa436ea125ab66e9a62625,0,3,0,0,0,3
6308,1702,2022-10-23 04:06:00,97726dc5eba7891d8ede8999d8b037c1,0,2,1,0,2,5
6309,1702,2022-10-23 04:12:00,0add6db04a023f987d88fd29ab456310,0,1,0,0,0,1
6310,1702,2022-10-23 04:17:00,fc2a84fa3dc81f442fb95783469bfc04,0,2,0,0,2,4
6311,1702,2022-10-23 04:22:00,c9b63db9b66e072baf26ada7c96b3bb2,0,6,1,0,0,7
6312,1702,2022-10-23 04:26:00,5bc1b771e6dde0b27f3753aacc1f0b3e,0,6,0,0,0,6
6313,1702,2022-10-23 04:31:00,3f0fc51441f42286d5c7889a475ad363,0,4,0,0,0,4
6314,1702,2022-10-23 04:37:00,7ad364db2251a385f43caace0e2912d9,0,1,0,0,2,3
6315,1702,2022-10-23 04:42:00,ae76b2daac5e32e1fc65b284f50a3a6a,0,4,0,0,0,4
6316,1702,2022-10-23 04:46:00,d587520f34d8d6c65a38e08191ad3c4f,0,5,2,0,0,7
6317,1702,2022-10-23 04:52:00,3ce5bf91a69d142ddc2ae1fdd009de2f,0,1,0,0,0,1
6318,1702,2022-10-23 04:56:00,2721882adeef40543f1f4247bcd01965,0,3,1,0,0,4
6319,1702,2022-10-23 05:02:00,94099b3b2c4e9f69cbb15b9d7930cf08,0,2,0,0,0,2
6320,1702,2022-10-23 05:07:00,d6073f38e93527eea6199dfa618101a5,0,3,0,0,0,3
6321,1702,2022-10-23 05:12:00,7c53748173b2bcc767289b2a97957ef0,0,5,1,0,0,6
6322,1702,2022-10-23 05:18:00,13bd142b0a692b02b4db45952149b030,0,1,0,0,0,1
6323,1702,2022-10-23 05:22:00,7e1712ae6defaf7d23dee3164d8c1c6e,0,2,0,0,0,2
6324,1702,2022-10-23 05:26:00,ab251b9713f8da8566a7d28d94a5c827,0,1,0,0,0,1
6325,1702,2022-10-23 05:32:00,4e8487b95b5d902fd9cd5e45f60da946,0,1,0,0,2,3
6326,1702,2022-10-23 05:36:00,7c0d8ed796632a6ad87cbe374ce07720,0,10,0,0,0,10
6327,1702,2022-10-23 05:41:00,dabae48950933637c9dbabe66597ef29,0,5,0,0,0,5
6328,1702,2022-10-23 05:47:00,e14dfdfeb9007635d300788f9cc7cb43,0,4,0,0,0,4
6329,1702,2022-10-23 05:53:00,ca151cf98c5987c6c762f1eaaa962fb4,0,9,0,0,0,9
6330,1702,2022-10-23 05:57:00,b02d58b06e5be2d791ee7a1ce9a95b64,0,6,0,0,0,6
6331,1702,2022-10-23 06:03:00,50d1d1564ab7c415a2df12b44a67890a,0,4,0,0,0,4
6332,1702,2022-10-23 06:07:00,1c32eb64215d6fc876bb743b2a7f2635,0,4,2,0,1,7
6333,1702,2022-10-23 06:12:00,651557f89598ebeb8390b1b6d6a3e0ac,0,0,0,0,0,0
6334,1702,2022-10-23 06:16:00,0f7d747462859e57394f5ef5f14b6973,0,8,0,0,0,8
6335,1702,2022-10-23 06:22:00,64bc9fa8d20d4396cced10492174e60a,0,9,0,0,0,9
6336,1702,2022-10-23 06:26:00,2c35f65dedbcbe7a496601d2571ddf3f,0,3,0,0,0,3
6337,1702,2022-10-23 06:32:00,e28e02451803810f56ecd311a54b36ac,0,5,0,0,2,7
6338,1702,2022-10-23 06:36:00,a5f9eadc2e662203e9cb9c07e0fedeff,0,2,0,3,1,6
6339,1702,2022-10-23 06:42:00,b2d628dd2f3890b0faec4e295418654f,0,7,0,1,1,9
6340,1702,2022-10-23 06:47:00,d7a6d9fa708cf8592f32e2d6a08106ec,0,14,0,0,4,18
6341,1702,2022-10-23 06:52:00,a69bc489d8ada35e6d8f6dfd4ac7ed60,0,12,0,1,0,13
6342,1702,2022-10-23 06:57:00,89fa0be52ccd9278c715eba20e089fef,0,5,1,0,4,10
6343,1702,2022-10-23 07:02:00,33a2b44df1b5bf5edc4fd5881152047c,0,13,0,0,1,14
6344,1702,2022-10-23 07:07:00,414478baf4c39a83c9e82c728d7309a2,0,14,1,0,2,17
6345,1702,2022-10-23 07:12:00,69d66244c79e4f5ffe802135faacfc1e,0,6,0,0,4,10
6346,1702,2022-10-23 07:18:00,8b9faafae0d01372e4077e4affaf1232,0,17,0,0,1,18
6347,1702,2022-10-23 07:22:00,7668fae2943aa1a19e06e656823f4769,1,6,1,0,2,10
6348,1702,2022-10-23 07:27:00,167a98fa83ac2806694e97ee8a6a26bd,0,16,0,0,3,19
6349,1702,2022-10-23 07:32:00,d32e1233936c40897674df2cea1d5a8d,0,11,0,1,7,19
6350,1702,2022-10-23 07:38:00,264583d4bec3fcda1e09836e278d73c4,0,8,0,2,4,14
6351,1702,2022-10-23 07:42:00,d3001c5f68a117edfd3a14f06b8dd9d5,0,9,0,0,5,14
6352,1702,2022-10-23 07:47:00,b9a5fc74f535a9aa6e4fe4b32c5de4ab,0,15,0,0,6,21
6353,1702,2022-10-23 07:52:00,9df2e34cf40f2c6eedacde12adc59955,0,14,0,0,7,21
6354,1702,2022-10-23 07:56:00,8d11ff6ca38dcc102abcf84810cbfb5f,0,12,0,1,5,18
6355,1702,2022-10-23 08:02:00,e4050d7afc370a554e9e62008d49fbd8,0,9,0,3,5,17
6356,1702,2022-10-23 08:07:00,c5e24e91e03aececa94aec08a016702c,0,9,0,1,7,17
6357,1702,2022-10-23 08:11:00,3f22a3815626bd0299e1242fdc9e3206,0,14,0,1,3,18
6358,1702,2022-10-23 08:17:00,550b4c6402a593a380c1ed7fc23d52f1,0,10,0,0,9,19
6359,1702,2022-10-23 08:22:00,551a75c966a44fce097f87e91754099d,1,15,0,1,10,27
6360,1702,2022-10-23 08:27:00,3ace881bb2b660dafc516dda7b6e97be,0,9,0,2,9,20
6361,1702,2022-10-23 08:33:00,01b96cfb4fb68cea06c8f469d6507f41,0,11,0,3,10,24
6362,1702,2022-10-23 08:37:00,656481883305b1a186a9a2e0e3f5b296,0,15,0,4,2,21
6363,1702,2022-10-23 08:43:00,f4fc445dd43b1921e3f50e3c97c557d0,0,13,1,1,7,22
6364,1702,2022-10-23 08:47:00,993718db98a553cc83a90feeeee0cf85,1,11,0,0,7,19
6365,1702,2022-10-23 08:53:00,1d3edec4d18547452d47c3a7ca631469,0,13,0,3,8,24
6366,1702,2022-10-23 08:58:00,caad6a257b04897b934c1dfb6fd9b64a,0,8,0,2,11,21
6367,1702,2022-10-23 09:02:00,2f158982ea4e8b3c657add78d1831147,0,15,0,2,3,20
6368,1702,2022-10-23 09:07:00,49bf933b2513e34697da24d5a3ec996f,0,15,0,0,4,19
6369,1702,2022-10-23 09:13:00,8253d7b37cb98ceedf563683652aa2dc,0,8,0,3,9,20
6370,1702,2022-10-23 09:17:00,adbe2d19883735dc679752709b66dd1c,0,9,0,5,8,22
6371,1702,2022-10-23 09:23:00,da590292f04a2b00f3b03e4f5c880f29,0,15,0,2,4,21
6372,1702,2022-10-23 09:27:00,a9a37f6129d2ba416d0aea14fde43a3a,1,13,0,1,5,20
6373,1702,2022-10-23 09:33:00,ed91896359721409d400625dcb65ca51,0,12,0,0,11,23
6374,1702,2022-10-23 09:37:00,f85f983da15340635d7fd14a35830736,0,16,0,2,6,24
6375,1702,2022-10-23 09:43:00,07738a3197c4cb892430a9f3a0f72107,0,16,0,1,8,25
6376,1702,2022-10-23 09:48:00,a0ec85f200b4b552da59c3e9f7cc078e,0,15,0,0,8,23
6377,1702,2022-10-23 09:52:00,293a06c8c32d79b096620c6edf4f4604,0,14,0,2,6,22
6378,1702,2022-10-23 09:57:00,501e477cb07541a240c68e42a80807a5,0,10,0,1,8,19
6379,1702,2022-10-23 10:02:00,4cb4825ab8e0de85d6859f7f70041d2a,0,9,0,3,9,21
6380,1702,2022-10-23 10:08:00,b24cbbd48f4cf0e93b3b9eb86c449cd9,0,10,0,2,6,18
6381,1702,2022-10-23 10:12:00,af3effc4fca081e447c3beab8cfc1216,0,14,0,3,4,21
6382,1702,2022-10-23 10:17:00,c567e4bdd2704bac9f998c09bc06587c,0,10,0,1,5,16
6383,1702,2022-10-23 10:27:00,538d6605167f2d01d108102b1e26a7e3,0,17,0,1,6,24
6384,1702,2022-10-23 10:33:00,4e6b268aec41d37715b4afef2222a678,0,9,0,0,6,15
6385,1702,2022-10-23 10:37:00,13a3fc49cef78b8eee0646336041c487,0,12,0,1,6,19
6386,1702,2022-10-23 10:42:00,96f89083eb117cd33e2fef58397c109d,2,14,1,2,3,22
6387,1702,2022-10-23 10:47:00,838febe0751dfaee1963c1626bde1b7e,1,19,0,1,6,27
6388,1702,2022-10-23 10:52:00,5ed843b116ca67f63f9cacfaa83f11ad,0,12,1,1,11,25
6389,1702,2022-10-23 10:57:00,b26b413c6c040baecd62e2935d8abe7f,0,12,0,3,9,24
6390,1702,2022-10-23 11:01:00,07d2ec0d8b5b7c6fd3c16990f02c52d8,0,13,0,2,8,23
6391,1702,2022-10-23 11:07:00,c8fcee05b99ca54bffce93c019e537a1,0,13,0,2,8,23
6392,1702,2022-10-23 11:12:00,ea908debce95927536293acab7057c82,0,9,0,0,11,20
6393,1702,2022-10-23 11:17:00,0cb4fff1d1395c9e7bacbbe7d4e62f88,0,13,0,3,13,29
6394,1702,2022-10-23 11:23:00,2296877916136007c973a29b46962382,0,8,0,1,11,20
6395,1702,2022-10-23 11:26:00,34c9445ff5418b4a18a19451323fba98,0,14,0,2,6,22
6396,1702,2022-10-23 11:33:00,a3022646c2d0e545ccbce0552f13f5b9,0,11,0,1,8,20
6397,1702,2022-10-23 11:37:00,1f975f11f286adb62604d4f127652f60,0,14,0,3,9,26
6398,1702,2022-10-23 11:41:00,2255839b3bfb00788f5a5947225e1953,0,16,0,2,13,31
6399,1702,2022-10-23 11:47:00,588707c1e6eba67aa4523aa4859430ef,0,11,0,2,15,28
6400,1702,2022-10-23 11:52:00,e9c332d615d07af111779a4175a9aac6,0,11,0,3,12,26
6401,1702,2022-10-23 11:57:00,74d978667affd41a6f968642f5331e5c,0,7,0,4,14,25
6402,1702,2022-10-23 12:03:00,8ebb173ed580edc0c33833cc7a2eab58,0,14,1,1,7,23
6403,1702,2022-10-23 12:08:00,7b35bc25b1c11c192332c828b7448bbb,0,12,0,0,12,24
6404,1702,2022-10-23 12:12:00,ecb98773c7ec776a78b2f3c28bdcb64d,6,14,0,0,9,29
6405,1702,2022-10-23 12:17:00,0a8caeff205afae96c7ca9d534d26cb2,0,10,0,1,7,18
6406,1702,2022-10-23 12:22:00,465a8ee0b76737475a931e5bc2b5ff8e,0,13,1,7,2,23
6407,1702,2022-10-23 12:26:00,2b8bfdc75958448de4e0825dc4c7f579,0,7,0,0,10,17
6408,1702,2022-10-23 12:32:00,3c44c5b83bdabab46ae8ed16dbc09b93,0,15,0,0,10,25
6409,1702,2022-10-23 12:37:00,f622116f905e9cc1f1c4f92408e07e20,0,11,0,2,8,21
6410,1702,2022-10-23 12:41:00,5bb1a19e136171cf2c3fbef60b14de5a,0,15,0,3,7,25
6411,1702,2022-10-23 12:46:00,1c386fbd51aeea2ebf2c57246b49cdca,0,25,0,2,7,34
6412,1702,2022-10-23 12:52:00,ffb2074faed2d236c3068507dda38d2b,0,16,0,2,5,23
6413,1702,2022-10-23 12:56:00,3098f4ccfb836693791dfd84fcd53edb,0,20,0,0,9,29
6414,1702,2022-10-23 13:03:00,c3138726df2c026586d31219957a77bb,0,10,0,0,6,16
6415,1702,2022-10-23 13:07:00,bb8823928dd8d2371517f160af52203a,0,10,0,0,11,21
6416,1702,2022-10-23 13:13:00,7a890be84b83f6c6a3e95e80df7e921d,0,19,0,1,5,25
6417,1702,2022-10-23 13:17:00,02fb57dcddf089ab2db9bb2cff05bf3d,0,10,0,2,11,23
6418,1702,2022-10-23 13:23:00,df82222395a9eca06bf5958104863269,0,13,0,4,7,24
6419,1702,2022-10-23 13:26:00,fc5b5b5e637d04619721dcbe0882e995,0,19,0,2,4,25
6420,1702,2022-10-23 13:33:00,c3f577168b8a66d08a08b6f75fb26f77,2,12,0,3,10,27
6421,1702,2022-10-23 13:37:00,e222edd581d52a1197bc5a97079afe34,0,12,0,1,8,21
6422,1702,2022-10-23 13:42:00,50de5fcdf32d796363c9426e011e4524,0,19,0,1,5,25
6423,1702,2022-10-23 13:47:00,81ddd4673ff2814c5ac58eab8d898539,1,12,0,3,11,27
6424,1702,2022-10-23 13:52:00,1a8f410c1719b10cb80aa39d575fd367,0,20,0,0,6,26
6425,1702,2022-10-23 13:58:00,d92828522f505a25fba141f4209bdfc9,0,16,0,1,10,27
6426,1702,2022-10-23 14:02:00,91b24ba787ee8451fc610dfa379f25e4,0,15,1,3,8,27
6427,1702,2022-10-23 14:07:00,69dbae971c103f2a830d0b8f90500aa4,0,19,0,1,6,26
6428,1702,2022-10-23 14:11:00,1a47009a4d0bf92675898097dd940d22,0,18,0,3,3,24
6429,1702,2022-10-23 14:17:00,6721869a789d6c23ad24f66a400d4ce4,0,20,0,3,5,28
6430,1702,2022-10-23 14:23:00,c4326cd18d8b75d1f0cd46975848a9b1,1,18,0,2,10,31
6431,1702,2022-10-23 14:26:00,87a9adf9909805c00d248ba2fe753d13,0,20,0,2,7,29
6432,1702,2022-10-23 14:34:00,b2c63e6b3a28320ff4b03e33e23e2f35,0,11,0,1,12,24
6433,1702,2022-10-23 14:37:00,a028feded00fbb036dbf039e3d9f445c,1,11,1,4,7,24
6434,1702,2022-10-23 14:41:00,bb947e26bffade255394f5c31fc83095,0,14,0,2,6,22
6435,1702,2022-10-23 14:47:00,9ebbd5338e68161a0148dc2e4cb0d2e8,0,14,0,1,8,23
6436,1702,2022-10-23 14:52:00,f755d3eae3cb4eb2624d5da41b735acf,0,16,0,0,10,26
6437,1702,2022-10-23 14:57:00,95c48b12f2f5c011c71c1e0ad56a3cae,0,19,0,1,6,26
6438,1702,2022-10-23 15:02:00,bc4b7c5ecb4ef23a9dd2c3852877cde8,0,16,0,3,4,23
6439,1702,2022-10-23 15:08:00,e37be7b5163237a84ca6b91d51bddadd,1,11,2,2,6,22
6440,1702,2022-10-23 15:12:00,25ce884fbc98d155a5d3a5d3a60572c0,0,18,0,3,4,25
6441,1702,2022-10-23 15:17:00,54a30d2015d725f709abcb697f086eb2,1,10,0,2,5,18
6442,1702,2022-10-23 15:22:00,13b3385620e4f9f1ea6f1b80e759ba4a,0,17,0,2,8,27
6443,1702,2022-10-23 15:27:00,607ee67964fd494b733009f77e3af6a0,3,11,0,3,10,27
6444,1702,2022-10-23 15:32:00,8dd75a46ff17ee25c16941504f6d40a1,0,15,0,2,7,24
6445,1702,2022-10-23 15:37:00,0f2fa595c7ce61d9e875757da5513336,0,14,0,0,9,23
6446,1702,2022-10-23 15:42:00,dfbe21374bdc7a25c286c9258f9c434d,1,13,1,1,7,23
6447,1702,2022-10-23 15:47:00,136ece6cae56065509266303aa639f7c,0,8,0,1,11,20
6448,1702,2022-10-23 15:52:00,0deab23585d4bac3bbafb11195fe830f,0,15,0,1,9,25
6449,1702,2022-10-23 15:57:00,b1793b37ef4d05acb8b6203031871b47,0,13,0,0,5,18
6450,1702,2022-10-23 16:02:00,e95db09438e010237cc00958995b4460,0,7,0,0,11,18
6451,1702,2022-10-23 16:07:00,9c5171ec4b76d019ff32029432934c7c,0,9,0,2,11,22
6452,1702,2022-10-23 16:12:00,0405feabdea7ffe873acc0c1db8cb89b,0,13,0,0,10,23
6453,1702,2022-10-23 16:17:00,90c493d7dc7409e33868272da0bdf74d,0,14,0,1,9,24
6454,1702,2022-10-23 16:22:00,cd35d0c15309a8121678bf3e67dc9c8c,0,9,0,2,7,18
6455,1702,2022-10-23 16:27:00,3814d76d134eb71a4f09e7071e865c1c,1,15,0,0,7,23
6456,1702,2022-10-23 16:32:00,39ec7cdc0139f1af4c077c79de3fc3d0,0,13,0,2,6,21
6457,1702,2022-10-23 16:37:00,cd76817c55c8dbdaa7e2fba93d1cf813,0,14,1,4,6,25
6458,1702,2022-10-23 16:42:00,dfcbea8fa0036138c6f8354a6fcbafdd,0,21,0,1,3,25
6459,1702,2022-10-23 16:46:00,97d536098450fc907ff2ce6c8044f0e7,0,18,0,0,7,25
6460,1702,2022-10-23 16:52:00,49a497e18a6505e1f0669423a43fc0e5,0,17,0,1,9,27
6461,1702,2022-10-23 16:57:00,8d41b6452b252f0893d89e9763f575f0,0,11,0,3,10,24
6462,1702,2022-10-23 17:01:00,c3a2e6fba7ce937ab72259a39d2bf6c1,3,13,0,0,7,23
6463,1702,2022-10-23 17:07:00,c926e71156d6389400dc4b5d24be8e35,0,14,0,2,9,25
6464,1702,2022-10-23 17:12:00,52c901c3cb31413df8e077b6dfd60aa8,0,9,0,2,14,25
6465,1702,2022-10-23 17:17:00,33c62189ef1ebc8c8aea9e1f6b7d50ef,0,17,0,1,8,26
6466,1702,2022-10-23 17:22:00,349e7dac8ba0726bfe91c8789c43e942,0,14,0,2,4,20
6467,1702,2022-10-23 17:26:00,91560270f6a03a3a7d15133eb3053ab4,0,13,0,0,9,22
6468,1702,2022-10-23 17:32:00,51ee779175f0de86067aeb5ad4163946,0,18,0,1,2,21
6469,1702,2022-10-23 17:36:00,ca62a969172085f5a8745dd5934d89db,1,16,0,2,10,29
6470,1702,2022-10-23 17:42:00,04124d4c7117cedcc1a3354ff4d846b9,0,17,0,5,9,31
6471,1702,2022-10-23 17:47:00,01cab111c81c1bb70f5e5b1d51d29600,0,10,0,1,9,20
6472,1702,2022-10-23 17:52:00,0b56e1ea1d1c88af02792d869c7f7979,0,20,0,2,4,26
6473,1702,2022-10-23 17:57:00,abfee821dbf8e8ca0dde47f786524c57,0,12,0,0,13,25
6474,1702,2022-10-23 18:02:00,d970d746a52f5cfe856bb39149f189a0,0,12,0,4,11,27
6475,1702,2022-10-23 18:07:00,6cee4cbf2a547f12c0f07a8d3fccf456,1,20,0,0,8,29
6476,1702,2022-10-23 18:12:00,2ea104728f8debf2dd7053ed37307f39,1,11,0,2,10,24
6477,1702,2022-10-23 18:18:00,b37f62afd3b26714182105ecd8e873cd,0,11,0,2,11,24
6478,1702,2022-10-23 18:22:00,6bf3466967439f8b1acd3070154b012b,1,11,0,4,13,29
6479,1702,2022-10-23 18:28:00,5a8365debf2b0119fcb7828578d89f68,0,23,0,4,6,33
6480,1702,2022-10-23 18:32:00,61967cd66751631b5f5ebfa446eae633,0,20,0,1,8,29
6481,1702,2022-10-23 18:37:00,819f67acba0bf294e5ce93f07ce8bcbe,0,18,0,1,7,26
6482,1702,2022-10-23 18:42:00,69384132c7e63445f445ab4407d5fd5b,0,15,1,3,6,25
6483,1702,2022-10-23 18:47:00,5bdf6a6458624d7cb8c23635f0db6cd4,0,24,1,0,8,33
6484,1702,2022-10-23 18:52:00,7ad6983d1d50cf1c0a7b605882dbe9eb,0,23,0,0,1,24
6485,1702,2022-10-23 18:57:00,f9aea68bd4c221a6274d99853151188a,0,19,2,0,6,27
6486,1702,2022-10-23 19:02:00,77ae3aeb049703f58b731eafcd48530f,0,18,0,1,2,21
6487,1702,2022-10-23 19:06:00,b0d84a1d45964f374798272b1584af1f,0,24,0,0,2,26
6488,1702,2022-10-23 19:12:00,a3d6068771a43852decbdd73f730465a,0,17,1,0,1,19
6489,1702,2022-10-23 19:17:00,8d2cf63861b7e1b1f68e660a02543b07,0,25,2,0,0,27
6490,1702,2022-10-23 19:21:00,2a9755a87d3720b8e0b98306741880b6,0,13,0,0,2,15
6491,1702,2022-10-23 19:26:00,fe6f08a0fe6e8509d9fe3f3e56e66e23,0,16,0,2,1,19
6492,1702,2022-10-23 19:32:00,f5ce4d5c29449c94dce4ebce1baffca2,0,15,0,1,0,16
6493,1702,2022-10-23 19:37:00,e8e4104b21687da0a35e825585420ca8,0,18,0,1,1,20
6494,1702,2022-10-23 19:41:00,a459793c5baf5dd9ce75a86fee2e9908,0,15,0,0,1,16
6495,1702,2022-10-23 19:46:00,45afde8cd7ec4b218e4db6ba80816196,0,14,1,0,1,16
6496,1702,2022-10-23 19:52:00,0ec56e6d65509556c15b42be312cfe2c,0,21,0,0,2,23
6497,1702,2022-10-23 19:56:00,64dd6689b87bf19a6c591eaeab275877,0,11,1,2,0,14
6498,1702,2022-10-23 20:02:00,1dc37d2d8b49977d8923b869a621e231,0,10,0,0,0,10
6499,1702,2022-10-23 20:07:00,842a58bac8d094dd753096180df145c2,0,22,0,1,2,25
6500,1702,2022-10-23 20:11:00,b7c690108979fa0904a01b07d1b15a95,0,16,2,0,0,18
6501,1702,2022-10-23 20:17:00,93d4330e25bb505aec78abc6ad2209b1,0,20,0,1,1,22
6502,1702,2022-10-23 20:21:00,4b3ae89ff52a30e7e434046b0f8462d9,0,10,0,0,1,11
6503,1702,2022-10-23 20:26:00,d3f213495a4d5459489ea5322548e1e0,0,12,0,1,2,15
6504,1702,2022-10-23 20:31:00,60fcd109ea6b9c4d28a049ec696b7bab,0,15,0,2,1,18
6505,1702,2022-10-23 20:37:00,31e9fd98adaa5006aa9a8f44e81c0513,1,21,0,2,1,25
6506,1702,2022-10-23 20:41:00,ac074eef799c91f8c9337a6a48515055,0,13,0,1,2,16
6507,1702,2022-10-23 20:46:00,f96205841b5130d72c246b0719ece41f,0,11,0,0,2,13
6508,1702,2022-10-23 20:51:00,f9af4ed8b40a7f2c5fd09611de9dca97,0,27,0,0,0,27
6509,1702,2022-10-23 20:57:00,a7c9b3b4c79a6d3bbe4c848cc3c13dbe,0,19,1,0,0,20
6510,1702,2022-10-23 21:02:00,1405c2f236d3eb87ec2c5a31cad1f1e3,0,18,0,0,2,20
6511,1702,2022-10-23 21:07:00,12ecfc7ab721bc1122c2ba50af38a1fa,0,11,0,1,2,14
6512,1702,2022-10-23 21:12:00,a099564e7c9aa473b9d67c808090edf1,0,15,0,0,2,17
6513,1702,2022-10-23 21:16:00,9348c8615cbddf370f4c7223bd7f5b88,0,13,0,1,0,14
6514,1702,2022-10-23 21:21:00,43306261eaeacd82384744cbbf9dd7a9,0,25,0,1,0,26
6515,1702,2022-10-23 21:27:00,9cf75c3404c6880d0788f0b70a2ae367,0,19,1,0,2,22
6516,1702,2022-10-23 21:32:00,2a6d0942af8be6efc282687a6f049e01,0,17,0,0,1,18
6517,1702,2022-10-23 21:37:00,f549b74595fe3046691b431a667de532,0,19,0,0,0,19
6518,1702,2022-10-23 21:41:00,af511d24e66b31a00418a9dcdd785af7,0,24,0,1,0,25
6519,1702,2022-10-23 21:47:00,e46b6ca4ee2d305f3c1eae27319d1b08,0,21,0,0,2,23
6520,1702,2022-10-23 21:53:00,c4b8010177f1b838188fe5540d49b93f,0,12,0,1,0,13
6521,1702,2022-10-23 21:56:00,947056b2b6b1d32e56600f6db4e74cc9,0,15,0,0,0,15
6522,1702,2022-10-23 22:01:00,da8588466ce00d1d4a28e276bd419a69,0,15,0,0,6,21
6523,1702,2022-10-23 22:06:00,46f7336de84e07f9a82039915e57ddc7,0,13,0,1,1,15
6524,1702,2022-10-23 22:11:00,e2982481f6ed699b6443162510fa06ad,0,19,1,2,2,24
6525,1702,2022-10-23 22:17:00,8cd9207946494571ea93fc8b07b3a9ca,0,22,1,0,1,24
6526,1702,2022-10-23 22:21:00,eb665ab5b311144d3be05d0af9dffa48,0,13,0,1,0,14
6527,1702,2022-10-23 22:26:00,cc9d887c5326b7598ecfed39725860a2,0,8,1,0,0,9
6528,1702,2022-10-23 22:32:00,5769fe42aed9e56d202b4892560a502f,0,12,1,0,0,13
6529,1702,2022-10-23 22:36:00,6105431877fd52ebc24b2211c5b78a55,0,11,0,0,0,11
6530,1702,2022-10-23 22:41:00,a60fe2b6057384c874334535fbd6532d,0,14,1,0,1,16
6531,1702,2022-10-23 22:47:00,d518a8f4655f3632ae539f08c8db99e9,0,14,0,0,0,14
6532,1702,2022-10-23 22:51:00,0376e719d8d8732d8745a3a2b978abcf,0,15,0,2,0,17
6533,1702,2022-10-23 22:57:00,d3ce3d310eb1b3d0487074ef748fd3fa,0,15,0,1,1,17
6534,1702,2022-10-23 23:02:00,204b1e3b40cc757e90a23324e4c2c83c,0,8,0,0,0,8
6535,1702,2022-10-23 23:06:00,b91f8ed018478b3ccd339a373931e9da,0,16,0,0,1,17
6536,1702,2022-10-23 23:12:00,d3e61d8b0370b43c515cf864096f11c0,0,14,0,0,1,15
6537,1702,2022-10-23 23:16:00,fc07510ef593da25888e394edc6e5acb,0,9,0,0,0,9
6538,1702,2022-10-23 23:22:00,f3381e72e1ac5aeea9e314d9b630ff6b,0,14,0,1,0,15
6539,1702,2022-10-23 23:26:00,43b11a70027e00651fdfdfabcb7491ae,0,11,0,0,2,13
6540,1702,2022-10-23 23:32:00,a0f418dbb2373214f4b2ef673444181e,0,5,0,1,0,6
6541,1702,2022-10-23 23:36:00,c7656f04d50126071062a5ef5422e36a,0,15,0,0,0,15
6542,1702,2022-10-23 23:42:00,937ab418a8a796af1fe6ffb78bd29c63,0,15,0,1,2,18
6543,1702,2022-10-23 23:47:00,14e02b561bb3846e50e57c1935eb8bd6,0,10,1,0,0,11
6544,1702,2022-10-23 23:51:00,99fb22f38d86e04bfb34b142ec66f6a5,0,15,0,0,3,18
6545,1702,2022-10-23 23:56:00,a7b5c81fabe70cc6811c7fe7b4a0b7d6,0,15,0,1,0,16
6546,1702,2022-10-24 00:02:00,49194e104d971bd15d3b6a0b84331f00,0,4,0,0,1,5
6547,1702,2022-10-24 00:06:00,8760ec2ff64f20296166b51835b6cbb7,0,14,0,0,0,14
6548,1702,2022-10-24 00:11:00,0f7e2b2ee9c0b88f2f5469bc7b185577,0,12,0,1,0,13
6549,1702,2022-10-24 00:16:00,65b2224a8f0ea249ab221a7a6e7f61f1,0,11,0,0,1,12
6550,1702,2022-10-24 00:21:00,0f746f5dca0b46d9ebdf8aa49e37067c,0,14,0,0,0,14
6551,1702,2022-10-24 00:26:00,7c2f47dc79b3b78378fa9dde015a37f5,0,10,0,0,1,11
6552,1702,2022-10-24 00:32:00,a2481336746cc1dd69ecc305b2b4a9af,0,19,0,0,0,19
6553,1702,2022-10-24 00:37:00,6cb97d3f2ee7672335a5a2fad581b718,0,12,0,0,1,13
6554,1702,2022-10-24 00:42:00,42bb5caf1fa6fe6ab0c5fb12991a3702,0,11,0,0,1,12
6555,1702,2022-10-24 00:47:00,6590c31898cb253419fe674971d45bdd,0,11,0,0,0,11
6556,1702,2022-10-24 00:52:00,a098aedde8015750672bec1cdcc2bfca,0,8,0,0,0,8
6557,1702,2022-10-24 00:57:00,8922bbd7403443664631404543abaef0,0,7,0,0,1,8
6558,1702,2022-10-24 01:02:00,fceec794eda170c5bac81e2a1d174413,0,13,0,0,1,14
6559,1702,2022-10-24 01:11:00,9af437f802f8400689fa216fa576b5ce,0,4,0,0,0,4
6560,1702,2022-10-24 01:17:00,94103025e30fb64eaad8304fc32389c0,0,8,0,0,0,8
6561,1702,2022-10-24 01:22:00,615f8bc1f7de2598bfb52f860719d125,0,10,0,1,2,13
6562,1702,2022-10-24 01:26:00,e8d7dce118f98f3345eeadfba46ae821,0,12,0,0,0,12
6563,1702,2022-10-24 01:32:00,feada48f53db49788e01cce0b2f0a77b,0,11,0,0,0,11
6564,1702,2022-10-24 01:36:00,960847f0977043f444d067592e0f1e27,0,9,0,0,0,9
6565,1702,2022-10-24 01:42:00,46273100ca10f45a131e73b218c7e2ab,0,10,0,1,0,11
6566,1702,2022-10-24 01:47:00,6705bc6269f01e1eea8ce67c1be7dc56,0,10,0,0,2,12
6567,1702,2022-10-24 01:52:00,b966027dc66fe611cffa3ed0804350a4,0,12,0,0,0,12
6568,1702,2022-10-24 01:57:00,5eca275c2774af7c120f67aecdbdbb33,0,4,3,0,0,7
6569,1702,2022-10-24 02:01:00,988d5ad377ec7b0b96e053e0a42d91e2,0,6,0,1,1,8
6570,1702,2022-10-24 02:07:00,5d3b48b276e6a58895478d7f06409e54,0,7,0,0,0,7
6571,1702,2022-10-24 02:12:00,c9c8b49fa314a1e834df500917d94dca,0,11,0,0,0,11
6572,1702,2022-10-24 02:18:00,9f63c51c4cf1fdfbeb638f39862c84ef,0,9,0,0,0,9
6573,1702,2022-10-24 02:22:00,79bfbf81913ed00c7d90128ed2cfc5f0,0,13,0,0,0,13
6574,1702,2022-10-24 02:26:00,f773f7c0b9c819753fdc50657423d0ea,0,2,0,0,0,2
6575,1702,2022-10-24 02:32:00,f95625a33699e124a821ecf0858bf2b3,0,17,0,1,0,18
6576,1702,2022-10-24 02:38:00,f5345e03b10769d835471c01fc824911,0,2,0,0,4,6
6577,1702,2022-10-24 02:42:00,e86e1f166435fd0e97ad727bc58bfff7,0,6,0,0,0,6
6578,1702,2022-10-24 02:48:00,b70ca54f99a55b0adb762b36c34e769c,0,10,0,1,2,13
6579,1702,2022-10-24 02:52:00,0ff261bed055cbb7a25739b370e28a35,0,4,0,0,1,5
6580,1702,2022-10-24 02:57:00,cedd22d91f8c8b8da547affc6a375b24,0,4,0,0,1,5
6581,1702,2022-10-24 03:02:00,85481ff9c8619fdd357fff9fc613a9d4,0,6,0,0,1,7
6582,1702,2022-10-24 03:06:00,a7be71ab70583d336458ffc47775a7a9,0,8,1,0,0,9
6583,1702,2022-10-24 03:11:00,665fa855d337a4df80b4c66f430e47ff,0,8,0,0,1,9
6584,1702,2022-10-24 03:16:00,685cf8628aa7174cd0f15eb2777f86cf,0,4,0,0,0,4
6585,1702,2022-10-24 03:21:00,bfa254c7baa1fb926088d48c6630553d,0,9,0,0,0,9
6586,1702,2022-10-24 03:27:00,a25a3fb3883127ae2effcc333265675c,0,10,0,0,0,10
6587,1702,2022-10-24 03:32:00,49b058390ea3e1805be1065e40808b53,0,12,1,0,1,14
6588,1702,2022-10-24 03:36:00,68dc6aafd61ec189006124762ef43b7d,0,8,0,0,0,8
6589,1702,2022-10-24 03:41:00,bc7fb7e7de1655a116b4a78a6358ff95,0,3,0,0,0,3
6590,1702,2022-10-24 03:47:00,2b3c8b5c4adce60964742723e60c570e,0,1,0,0,0,1
6591,1702,2022-10-24 03:52:00,190f9eb3a17f879910d891d0093b8ce8,0,6,0,0,0,6
6592,1702,2022-10-24 03:56:00,1c1e0b81c969e742ec74070dec7d493f,0,8,0,0,0,8
6593,1702,2022-10-24 04:01:00,91339ca26eb3e69b92f503bf2c1fc6e7,0,1,0,0,0,1
6594,1702,2022-10-24 04:06:00,0aabf3b1e9517d47f8b887c7b864541f,0,3,0,0,0,3
6595,1702,2022-10-24 04:12:00,d2ca30355a699be1be4baaf0781413af,0,13,0,0,0,13
6596,1702,2022-10-24 04:17:00,2d3e348d66fdf29d37801e72cd26c34e,0,5,0,0,0,5
6597,1702,2022-10-24 04:22:00,507104db74aad38b1290ea763a45f234,0,12,0,0,2,14
6598,1702,2022-10-24 04:27:00,f20973243c259f69069fd4879a204a3a,0,5,2,0,0,7
6599,1702,2022-10-24 04:32:00,1dd11a8badd00032c025f0daf896b742,0,6,0,0,0,6
6600,1702,2022-10-24 04:37:00,52548533560105bbfaf0c430aa723010,0,1,0,0,0,1
6601,1702,2022-10-24 04:41:00,4cc124f3741c5b50f6c427caacb47f17,0,9,0,0,1,10
6602,1702,2022-10-24 04:46:00,591b5edc1eb8499e1a2983dfff703b02,0,8,0,0,0,8
6603,1702,2022-10-24 04:52:00,d1ba5d0be4daababea8a2a7bb1f73d34,0,7,0,1,0,8
6604,1702,2022-10-24 04:57:00,0ae4e5f2c25f1c406294f702fc7652d3,0,1,0,0,2,3
6605,1702,2022-10-24 05:02:00,e5bae2f5d2e8c5e4531eeb54b950d0d2,0,1,0,0,0,1
6606,1702,2022-10-24 05:06:00,e4da0ed866de601ece03295a6960a5d3,0,6,0,0,1,7
6607,1702,2022-10-24 05:11:00,67a9ab29ae4e91b2455ac08fe01ea7ce,0,5,0,0,0,5
6608,1702,2022-10-24 05:16:00,ce098714c169f56e5a0d99b46b41ff1f,0,9,0,0,0,9
6609,1702,2022-10-24 05:22:00,340196ffd50f25de59422fb46dd5799e,0,1,0,0,0,1
6610,1702,2022-10-24 05:26:00,d7481330459de52526f3058658bdba10,0,10,0,0,0,10
6611,1702,2022-10-24 05:31:00,2d1520b8c4caae1cf0e965b9ff21f6f6,0,5,0,0,1,6
6612,1702,2022-10-24 05:37:00,15dba02b0e604c7c2c4688d915fbc440,0,6,0,1,1,8
6613,1702,2022-10-24 05:41:00,9bd0e0d56c78ab0605969ada332ce43e,0,8,0,1,2,11
6614,1702,2022-10-24 05:47:00,8cc7b29717570fefd4f0c6d4c2f977ec,0,2,0,2,1,5
6615,1702,2022-10-24 05:51:00,4ab24ed75c8015a814958b24ef45cce7,0,7,0,2,0,9
6616,1702,2022-10-24 05:56:00,5f04c54088014a3a4f71654734b38167,0,6,0,0,0,6
6617,1702,2022-10-24 06:02:00,2c9dbf91f7c8c5cc0c29e25646fd533a,0,4,0,0,0,4
6618,1702,2022-10-24 06:07:00,79a7c659cc15f203635808def7979119,0,3,1,0,1,5
6619,1702,2022-10-24 06:12:00,9c021b746ab87183ed400c904a0203ad,0,12,0,0,1,13
6620,1702,2022-10-24 06:17:00,e7c4ad92db9b5a6f40f6c62a4da3175c,0,9,0,0,1,10
6621,1702,2022-10-24 06:22:00,ed9b73dafab12b986ff18228b872ac73,0,2,1,0,0,3
6622,1702,2022-10-24 06:26:00,1fc5b152826b866dfa14ac47e0234065,0,2,0,0,0,2
6623,1702,2022-10-24 06:32:00,6f306bc8724a71dc4d9ae1832e215f26,0,13,1,0,0,14
6624,1702,2022-10-24 06:36:00,a5220177512bad251657936d70cbb992,0,4,1,0,1,6
6625,1702,2022-10-24 06:42:00,5216740b7a7896182311f15a1bf3897a,0,3,0,0,1,4
6626,1702,2022-10-24 06:46:00,2eeb3a27563380ebd0338dc0f3270edc,0,8,0,0,2,10
6627,1702,2022-10-24 06:51:00,f8e834361f7aad8994f12ce5705bb57d,0,9,0,1,0,10
6628,1702,2022-10-24 06:57:00,09106c682f5521448b46d45c833ac2bf,0,13,0,1,3,17
6629,1702,2022-10-24 07:01:00,205800cee095e04ac81fb30d34eb17ca,0,14,0,0,0,14
6630,1702,2022-10-24 07:06:00,7d02c14f3d25476f64d0c2a25ff0e23e,0,12,0,0,3,15
6631,1702,2022-10-24 07:12:00,0e5ef9495fc99be97c71c63048c222f6,0,14,0,0,1,15
6632,1702,2022-10-24 07:17:00,1df70be980a7a0d9ba3b6377257251d5,0,10,1,0,1,12
6633,1702,2022-10-24 07:22:00,efe4ffcd11dea8575743ab75e008a3e2,0,10,0,0,4,14
6634,1702,2022-10-24 07:27:00,3ac522b6f2a77b8d5b45a74377ebb99d,0,12,1,0,4,17
6635,1702,2022-10-24 07:32:00,a6509e4de37069a473a087569b002f70,0,14,0,1,1,16
6636,1702,2022-10-24 07:37:00,d56953caff5db426d96991ee2c33936e,0,20,0,0,2,22
6637,1702,2022-10-24 07:41:00,551b5ead2d957749d54a5de618c0ec10,0,13,0,1,3,17
6638,1702,2022-10-24 07:47:00,be6b0b195b6e134ef4159b6a6da56944,0,12,0,1,3,16
6639,1702,2022-10-24 07:52:00,d069f69c291f79f8e2e416c6ed713777,0,11,0,1,2,14
6640,1702,2022-10-24 07:56:00,2aa8c09b19e625844a7110afb611b1ff,0,6,0,0,1,7
6641,1702,2022-10-24 08:02:00,5a73042d8726eacf79ae03fd6094a85d,0,11,0,0,2,13
6642,1702,2022-10-24 08:07:00,e10391fb81a65f865bc7340cc3d478f6,0,8,0,0,0,8
6643,1702,2022-10-24 08:12:00,164d314ad29ff7b1911b3f7c1ccb3509,0,10,0,1,4,15
6644,1702,2022-10-24 08:17:00,789c8fefbfb1319965f9b4ef2b459e2e,0,5,0,3,7,15
6645,1702,2022-10-24 08:22:00,88495b10e7d2eab9a786fff82bf97f76,0,11,0,0,3,14
6646,1702,2022-10-24 08:26:00,6b098737bdf23f30e6b7d0d2f1121996,0,8,0,0,3,11
6647,1702,2022-10-24 08:32:00,3a79f34c97c7dc6483559ab9dcb3db07,0,8,0,0,3,11
6648,1702,2022-10-24 08:37:00,102afd2eb65d363b2c8596297aec98a8,0,9,0,1,2,12
6649,1702,2022-10-24 08:42:00,f7c778c4b916cf80925e6c68d7cbec65,1,9,0,1,2,13
6650,1702,2022-10-24 08:46:00,1cd56d90af32b93e7c18db766b899cc0,0,5,0,0,4,9
6651,1702,2022-10-24 08:53:00,be1e6b4d657eed4364a57437ed0c4a55,0,20,0,1,5,26
6652,1702,2022-10-24 08:57:00,6b07fd01d80b0cdb711badc7527ebe92,0,15,0,1,8,24
6653,1702,2022-10-24 09:01:00,6b46b4d682dc754a4c617c5677b24cfe,0,10,0,0,2,12
6654,1702,2022-10-24 09:07:00,252fb6bada05562a228f7b6928f71f69,0,10,0,0,5,15
6655,1702,2022-10-24 09:12:00,e718723de7bfff4b9f7d06b3d4c545b7,0,8,0,0,3,11
6656,1702,2022-10-24 09:17:00,56dd20f6896f7dbc1e5c9858159590ae,2,11,1,0,4,18
6657,1702,2022-10-24 09:22:00,62902651c1092008eb185c8fc4194a1b,0,13,0,2,2,17
6658,1702,2022-10-24 09:27:00,3725f709782113607789886c39d95900,0,11,0,0,6,17
6659,1702,2022-10-24 09:32:00,5d36107e06b0c2c873928ae622fb5582,0,15,1,1,4,21
6660,1702,2022-10-24 09:37:00,172befec6f51ce90940c47dacd45c424,0,16,0,0,3,19
6661,1702,2022-10-24 09:41:00,9a95651485c87671f5ea9ab7770bf2f0,0,12,0,0,9,21
6662,1702,2022-10-24 09:47:00,14d03f603442e078934929c88833fb88,0,8,0,1,9,18
6663,1702,2022-10-24 09:52:00,d16c71ac15b42fa00fb73bfcb4873d35,0,19,0,0,6,25
6664,1702,2022-10-24 09:58:00,b6a056dcf6c48341443b84ae5af0f26a,0,7,0,0,8,15
6665,1702,2022-10-24 10:02:00,39d94ce7f853e008b2982b8c6d4f8dc7,1,13,0,0,5,19
6666,1702,2022-10-24 10:06:00,7b155fe1cb4059d190df2c1775612b47,0,10,0,2,9,21
6667,1702,2022-10-24 10:12:00,1e286fe548dd71c69f48319d56297c55,1,16,0,0,5,22
6668,1702,2022-10-24 10:17:00,5afeb592f273d4a72662d226afdf9ef0,2,12,1,1,9,25
6669,1702,2022-10-24 10:23:00,4c1540bcc50cf1f589eecf8663709fc5,0,17,0,0,5,22
6670,1702,2022-10-24 10:27:00,576a20c266391bcf842db22f5e67e8d5,0,10,0,0,12,22
6671,1702,2022-10-24 10:33:00,1053dd82bad5906ba2fcdc490021e996,0,11,0,1,6,18
6672,1702,2022-10-24 10:37:00,07e0b41fdcebc3327a20f161e3ca1cd7,0,13,0,2,8,23
6673,1702,2022-10-24 10:42:00,a61f95a4ac1869a2853489e5edef2f1c,0,10,0,1,11,22
6674,1702,2022-10-24 10:47:00,80ca0510c38742b11de74b8f0060cdff,0,20,0,1,8,29
6675,1702,2022-10-24 10:52:00,04eeb8104185bd5e59d606567c335566,0,13,0,4,12,29
6676,1702,2022-10-24 10:57:00,73d0d2810a0da869b4380548af275eeb,0,14,0,3,8,25
6677,1702,2022-10-24 11:02:00,ce3337b3d3a2304b2e1a7deba0c68071,0,19,0,0,7,26
6678,1702,2022-10-24 11:07:00,fd232a343f8d6c182d5d11037737ecc3,0,15,0,2,7,24
6679,1702,2022-10-24 11:12:00,08bcc98a8fd0ab654774c6ef09a56c58,0,18,0,2,8,28
6680,1702,2022-10-24 11:18:00,9fd53dbc9d10e3a2fdad6c3979fcab50,0,20,0,1,5,26
6681,1702,2022-10-24 11:22:00,3ba9757c0d512d35073ac3a330a9d35d,0,19,0,1,4,24
6682,1702,2022-10-24 11:27:00,c61768c120434fe2d1e6bdf1547a61ee,0,8,0,1,15,24
6683,1702,2022-10-24 11:32:00,1eb35720d83426ff5e4555ab9b8df2f3,0,11,0,0,11,22
6684,1702,2022-10-24 11:37:00,363a40e14b6a1be2b65b6707765474d0,1,12,0,2,9,24
6685,1702,2022-10-24 11:41:00,74933c7fa25b5d839f3a3aad7f1fe13a,0,20,0,3,7,30
6686,1702,2022-10-24 11:47:00,9851220843a33992efbacbcabd032c13,0,11,0,2,13,26
6687,1702,2022-10-24 11:52:00,256a7146ca6ebee29061caa6596283d6,0,16,0,1,7,24
6688,1702,2022-10-24 11:56:00,1d150439fe41de506fe20f389b8e2d99,0,14,0,1,11,26
6689,1702,2022-10-24 12:02:00,17fc4fa1a994e76355064da2b16cfa1a,0,19,0,1,9,29
6690,1702,2022-10-24 12:07:00,1056f2f03b55eef607ad83ddebfe378a,0,12,0,0,15,27
6691,1702,2022-10-24 12:12:00,6586c90b10af8a5713bbb67fa89d5d0b,1,12,1,3,7,24
6692,1702,2022-10-24 12:17:00,dec9e5880bbc07720b288515a1cdfd46,0,14,0,4,9,27
6693,1702,2022-10-24 12:22:00,bb69bca38654531f14ec78d5ca54c3dc,0,13,0,2,8,23
6694,1702,2022-10-24 12:27:00,a61ffa166a946b2d266a6493a8c170c4,0,16,0,2,8,26
6695,1702,2022-10-24 12:32:00,e5a3cbcc5f55d704b530ce1a4a4c7a90,0,14,0,1,9,24
6696,1702,2022-10-24 12:37:00,5499b14e079c6f0995e9cf9e4672e075,0,8,0,0,11,19
6697,1702,2022-10-24 12:42:00,98d241b5d36a9527e4c2a058651ba801,0,13,0,2,8,23
6698,1702,2022-10-24 12:48:00,c8aad9d1e2fd44a7a5a2756d8ede7140,0,15,1,0,5,21
6699,1702,2022-10-24 12:52:00,ecc447a1f20239a5707e9834e3c15a81,0,15,0,1,10,26
6700,1702,2022-10-24 12:56:00,37a5d4c35d43a3b8b79704a785088cb8,0,10,0,0,9,19
6701,1702,2022-10-24 13:02:00,9871f73e37072369013acf34c02a1bda,0,11,0,4,4,19
6702,1702,2022-10-24 13:07:00,e048b185eac0f14505fcb304e53e58fd,0,12,0,3,8,23
6703,1702,2022-10-24 13:12:00,5d5f99a31e09fd18f199b9c4d88df3c5,0,17,0,0,6,23
6704,1702,2022-10-24 13:18:00,a7eaebdfc4eb8a483793ab052065bf7e,1,8,0,1,12,22
6705,1702,2022-10-24 13:22:00,1fa9ecff34338058d94c0b3427aa6733,0,18,0,0,4,22
6706,1702,2022-10-24 13:27:00,9e020586ac6f25722c2ac5bafd310532,0,17,0,0,10,27
6707,1702,2022-10-24 13:32:00,98bc9188d7152c525bcdc14887e9a4d8,0,14,0,0,9,23
6708,1702,2022-10-24 13:37:00,b2ff877e83bd42507503c9944ac3eccf,0,10,0,0,12,22
6709,1702,2022-10-24 13:41:00,0fb40c641abe702eb9ab492518f45d19,1,17,1,1,10,30
6710,1702,2022-10-24 13:47:00,105b8df975f2ee040f414f99d575f68f,0,19,1,0,4,24
6711,1702,2022-10-24 13:53:00,009b228f500cd438d2403154570a30fe,0,13,0,0,10,23
6712,1702,2022-10-24 13:57:00,162f4c2216fa93fd8a6bd45fefd90024,0,12,0,4,9,25
6713,1702,2022-10-24 14:02:00,23bed4180c7a09e0553e3cefad29bfed,0,11,0,1,9,21
6714,1702,2022-10-24 14:07:00,9d87c61b9c810c77b6a058e43b39ee5d,0,11,1,0,8,20
6715,1702,2022-10-24 14:11:00,38ed465257fd9913537856d0bbaf6c6e,0,14,0,0,10,24
6716,1702,2022-10-24 14:17:00,82eb9981cac3a965c6970d1fc252b7e5,0,10,0,1,6,17
6717,1702,2022-10-24 14:22:00,9bf68f4fc30244cefd39b29947a65dd9,0,16,0,0,4,20
6718,1702,2022-10-24 14:26:00,d20d70caf2d40d11ff0095c74d359815,0,13,0,1,10,24
6719,1702,2022-10-24 14:32:00,312c19cd535795e2d0d8124ad5fc256d,0,15,0,2,6,23
6720,1702,2022-10-24 14:37:00,849b66cb712a4856c57bae6fefb386e5,0,16,0,4,7,27
6721,1702,2022-10-24 14:41:00,efd7b6a52d48f61119bd29e0aa8235b8,0,20,0,4,5,29
6722,1702,2022-10-24 14:47:00,0f3b3feefe11b87caec08197987ebf81,0,16,0,2,7,25
6723,1702,2022-10-24 14:52:00,e42a86e339ebefabf3d83b41393eef4b,0,19,0,3,2,24
6724,1702,2022-10-24 14:57:00,5d57d83b367e59dfa1b539de76a48b77,0,9,0,2,10,21
6725,1702,2022-10-24 15:01:00,49a757057051525c47d4b9c3d2178853,0,21,0,0,7,28
6726,1702,2022-10-24 15:06:00,23cc387b480580f32f7e38d743266887,0,17,0,2,7,26
6727,1702,2022-10-24 15:12:00,90dc1f442b559551fe6f556e2f87cf11,0,12,1,0,3,16
6728,1702,2022-10-24 15:16:00,3ffb43a83430a83e7c79739ef552b08c,1,18,0,2,9,30
6729,1702,2022-10-24 15:23:00,96aef0621b3c8c296e048b79b6857bf4,0,13,0,2,8,23
6730,1702,2022-10-24 15:27:00,0d3692707851861a7e3d43105ab1b984,0,18,1,2,12,33
6731,1702,2022-10-24 15:32:00,ae3463f03a2d23009581af62ecb1214e,1,16,0,0,9,26
6732,1702,2022-10-24 15:36:00,99095476637afd8e01e5437c36c404ad,0,19,1,2,8,30
6733,1702,2022-10-24 15:47:00,8d60e1df0a095a1c3f709d8ac49f6da0,0,10,2,1,12,25
6734,1702,2022-10-24 15:51:00,60a2d41fd43bf9879832c01329af5300,0,15,1,0,8,24
6735,1702,2022-10-24 15:57:00,33cec02227049ba4a2de4a85c2f5d331,0,8,1,0,8,17
6736,1702,2022-10-24 16:02:00,24841824c3268f81605661fc36cb0712,0,14,0,3,9,26
6737,1702,2022-10-24 16:07:00,54ab0f34ac37e7d2d6e96e7904e418c4,0,13,0,3,8,24
6738,1702,2022-10-24 16:12:00,1131ed4e4ed7962e907fdf1c72ce5f20,1,17,0,2,7,27
6739,1702,2022-10-24 16:17:00,c656e98f9c839a4396f6d565736e2c89,0,18,0,2,5,25
6740,1702,2022-10-24 16:22:00,5054ab877562090a9f71059b277e0462,0,9,0,1,10,20
6741,1702,2022-10-24 16:27:00,c8504bc3dadcba5be9ec6dc5ca5425dd,0,14,0,0,10,24
6742,1702,2022-10-24 16:32:00,cf08b1ed31fb1491f8979b731e5cc430,0,11,1,1,9,22
6743,1702,2022-10-24 16:36:00,d9f9f414af6281dcf84aaae794bc9914,0,14,0,0,4,18
6744,1702,2022-10-24 16:42:00,5707293e6e49823ac2bb6940d1dcee42,0,16,0,0,8,24
6745,1702,2022-10-24 16:46:00,3b052f22a670e1ed99b7292fb01172ac,0,11,0,2,11,24
6746,1702,2022-10-24 16:52:00,ab3eace58ed47076e801efe5564a6b51,1,6,0,0,17,24
6747,1702,2022-10-24 16:57:00,4e9f9077b0853897797cc153058ce422,2,17,0,2,6,27
6748,1702,2022-10-24 17:03:00,a38555aae86b4b9188cffee2329c18c7,0,20,0,1,4,25
6749,1702,2022-10-24 17:07:00,4ba13516e21c9ddf3b0b5870e3e4d2df,1,14,1,1,8,25
6750,1702,2022-10-24 17:13:00,c9f544ff370578e4642cce8da0cb5f27,2,10,0,1,7,20
6751,1702,2022-10-24 17:17:00,af08103be53224ec5672748bd175da76,1,11,0,1,15,28
6752,1702,2022-10-24 17:22:00,360fdddae235274004b7792f2a9f579e,0,12,0,2,8,22
6753,1702,2022-10-24 17:27:00,5e8e461803f29d3df6ff159bd2e6b71f,0,15,0,0,6,21
6754,1702,2022-10-24 17:32:00,c0b2d4a888546aca8887b38236f79371,0,19,0,5,6,30
6755,1702,2022-10-24 17:37:00,601ae92890277af69db9278207d4720f,0,15,0,2,3,20
6756,1702,2022-10-24 17:42:00,98523b0803258b2526c150f04d419a59,0,9,0,1,9,19
6757,1702,2022-10-24 17:47:00,c05e9b9ca033e993db0f362a88ac746b,0,16,0,0,5,21
6758,1702,2022-10-24 17:52:00,e026a256300d54212656d9c242f9f7b7,0,12,0,0,11,23
6759,1702,2022-10-24 17:57:00,9cf7e685fd4f2c2368a9c6a42b9199b4,0,8,1,1,7,17
6760,1702,2022-10-24 18:02:00,1240145cd01b7df46bff6cf00068716c,0,17,1,1,5,24
6761,1702,2022-10-24 18:07:00,7d93fb6e889bf14beb13fc9fcb414f1e,0,11,0,3,8,22
6762,1702,2022-10-24 18:12:00,321b6a13a68e880755f39d5a2c405272,1,15,0,0,5,21
6763,1702,2022-10-24 18:17:00,db469bae265716a894e8ea748d72abda,1,18,0,0,8,27
6764,1702,2022-10-24 18:21:00,50787a2f56af3d4f1558f5165fa28c69,0,9,0,1,9,19
6765,1702,2022-10-24 18:27:00,aa39f1e0f8e3756036978137b24cc09c,0,9,0,0,8,17
6766,1702,2022-10-24 18:31:00,5338df3e6ebfe968b85f79d736b28c46,0,15,1,0,6,22
6767,1702,2022-10-24 18:37:00,64140fbb7d13572e82f6850d7ac7346d,1,15,2,1,3,22
6768,1702,2022-10-24 18:41:00,504f3494d26a872a296601b56a0ea6a9,0,15,0,2,9,26
6769,1702,2022-10-24 18:47:00,3e16c43a80119f2d2a56eccdce486f23,0,14,0,0,9,23
6770,1702,2022-10-24 18:52:00,c96d6a2c8a00b58db9c5594cdfcb8a43,0,20,0,0,3,23
6771,1702,2022-10-24 18:56:00,1ab89372e07183b91bdd1c709d882d6c,0,17,1,1,2,21
6772,1702,2022-10-24 19:02:00,e987d356215a5ec3a1a7f3c9e82d90da,0,21,1,1,1,24
6773,1702,2022-10-24 19:07:00,e88f018f2a0b4d3eaf253b96ab152943,0,15,0,0,1,16
6774,1702,2022-10-24 19:12:00,fd1b4628a9be895f98f8896c56e1a1be,0,22,0,0,0,22
6775,1702,2022-10-24 19:17:00,fe63201788aa29df616fc15fa5ac9ba1,0,10,2,1,1,14
6776,1702,2022-10-24 19:21:00,6e6a07db1166727cb0137efbec423193,0,21,3,0,0,24
6777,1702,2022-10-24 19:26:00,cd35a5c1fc5fb98f5ffa57dedba8fedb,0,15,0,0,0,15
6778,1702,2022-10-24 19:32:00,04d67d08d1aaeceb97698a15194916a4,0,23,2,1,0,26
6779,1702,2022-10-24 19:37:00,5c7b6298bdfd30bcf9e9524bc563ea48,0,15,0,0,0,15
6780,1702,2022-10-24 19:41:00,e3cc4fdffb820964af11e6c0207d6288,0,12,2,0,0,14
6781,1702,2022-10-24 19:47:00,143e3b60c90c67ed7a4333ee71ae54e6,1,14,0,1,1,17
6782,1702,2022-10-24 19:51:00,54ca6e955d1724dadb22b4acb8bb5ae2,0,11,1,1,2,15
6783,1702,2022-10-24 19:57:00,c2947f896c4929ca9a95e2f726fa7f1d,0,21,0,0,0,21
6784,1702,2022-10-24 20:02:00,a5329e477d79e94c3bcf6a10ed9b96c2,0,14,0,0,0,14
6785,1702,2022-10-24 20:07:00,272d7e76e5013977a45af10f80243dfc,0,15,0,0,1,16
6786,1702,2022-10-24 20:12:00,53b1bbbfe71d3452b2d582680dac88ce,0,16,0,0,1,17
6787,1702,2022-10-24 20:17:00,9778354d79aec8097356b6fa76b595c4,0,11,0,1,0,12
6788,1702,2022-10-24 20:22:00,26ec07f376e36e3b60500755e5db201b,0,18,0,0,0,18
6789,1702,2022-10-24 20:27:00,a02630d991ddacfedb77b548913fc675,0,24,0,0,0,24
6790,1702,2022-10-24 20:31:00,6ad591c5f6486cb4922b01bfa09f9f98,0,13,0,0,2,15
6791,1702,2022-10-24 20:37:00,51fd03f5a99dbe19bade8c431f8be3db,0,14,1,0,0,15
6792,1702,2022-10-24 20:42:00,44a4fa8a8767c618f9de503605e38648,0,14,0,0,0,14
6793,1702,2022-10-24 20:47:00,19286ca998d40603f4b90684523c3e07,0,14,0,0,0,14
6794,1702,2022-10-24 20:52:00,bdb89373706d0a2dd852c0e41eac0bd3,0,14,0,2,3,19
6795,1702,2022-10-24 20:56:00,99b4c058eb650d7c0b9040b7fc7336dc,0,20,0,1,0,21
6796,1702,2022-10-24 21:02:00,3f840120a9c794caec8d99cf3640a9ed,0,15,1,2,0,18
6797,1702,2022-10-24 21:06:00,b4c7ef9b4e6d65048693d6c14617a5eb,1,17,0,0,0,18
6798,1702,2022-10-24 21:12:00,55c8c70bec0c8e42ec48473a70e5635d,0,10,0,0,0,10
6799,1702,2022-10-24 21:17:00,fa6509db6ec6019c4dc6aa74652842b8,0,19,1,0,0,20
6800,1702,2022-10-24 21:21:00,4e4c56544df22cb7541f8d86d8650d4a,0,14,0,2,1,17
6801,1702,2022-10-24 21:27:00,cb4bca8142ff747f3731357f8a38d898,0,16,0,1,0,17
6802,1702,2022-10-24 21:31:00,3078a847dd38ce5767f6c511a555ad27,0,12,0,0,1,13
6803,1702,2022-10-24 21:37:00,a2f87fdd147272b4ccbae5b3f95b3c80,0,24,0,0,2,26
6804,1702,2022-10-24 21:42:00,8e5a1d69a2b97ab016f2791b9ef8d6ff,0,19,0,0,0,19
6805,1702,2022-10-24 21:47:00,dd6adbac8695bfa42f0605120e14478f,0,16,0,0,1,17
6806,1702,2022-10-24 21:52:00,b65903094567d97612c505007537b60e,0,13,0,1,0,14
6807,1702,2022-10-24 21:56:00,d1b5d9f3601ffc9115fde415320b6dff,0,17,1,0,0,18
6808,1702,2022-10-24 22:02:00,7c7f9bd4de9cdf023458ca7f8a3895b3,0,12,1,0,2,15
6809,1702,2022-10-24 22:07:00,7d6d3f03c1f6e41b987502624561566c,0,8,0,0,2,10
6810,1702,2022-10-24 22:11:00,8af7b48f155f3fa75148dd8b9e289feb,0,10,0,1,2,13
6811,1702,2022-10-24 22:16:00,f12fdf6ea390dd796ed9feaaf08b9e07,0,13,0,0,1,14
6812,1702,2022-10-24 22:22:00,a26634339abccde8e56c58511df907a3,0,11,0,0,1,12
6813,1702,2022-10-24 22:26:00,b6a15eb8e4f373ed2bd58707b4ba6015,0,5,1,1,0,7
6814,1702,2022-10-24 22:32:00,1ddc7007daffe0dc34c319202df35eb1,0,7,0,0,1,8
6815,1702,2022-10-24 22:37:00,c1969805fd5d3efd511235f0cdd4cfee,0,12,0,0,0,12
6816,1702,2022-10-24 22:41:00,f73a172de8f23c2262d98911d36ef74d,0,12,0,1,0,13
6817,1702,2022-10-24 22:47:00,ee707d462d2a212ec3574505dcc906d9,0,12,0,1,1,14
6818,1702,2022-10-24 22:51:00,8488378ea1753ea18a782cd5930a6528,0,8,0,0,0,8
6819,1702,2022-10-24 22:57:00,5548abcae6ce3120438a929cf1e56124,0,12,0,0,0,12
6820,1702,2022-10-24 23:02:00,3e76b9e8bfedee293c3ffcbf96602880,0,11,0,0,2,13
6821,1702,2022-10-24 23:07:00,4bb6886e484510c72bf0367dcb1e821e,0,15,0,0,0,15
6822,1702,2022-10-24 23:12:00,07ba713cfd0e1e3990a2031742e1b3c4,0,9,0,0,0,9
6823,1702,2022-10-24 23:17:00,951cb0fbd0113042e41196972ecfe453,0,11,0,1,0,12
6824,1702,2022-10-24 23:22:00,bea9ae8a4e1f1ece3cafe3865ee2cf68,0,9,0,0,0,9
6825,1702,2022-10-24 23:27:00,5acdf3dae987483ffa46741c8a564a85,0,15,0,0,0,15
6826,1702,2022-10-24 23:31:00,97a884c031aac1551007c522d7be8ae5,0,12,0,0,0,12
6827,1702,2022-10-24 23:36:00,b9c7e1f7002007ca0b9578d491f02bae,0,9,1,0,1,11
6828,1702,2022-10-24 23:41:00,e81398abb1b3d82f8ec33c6aea284e49,0,5,0,0,2,7
6829,1702,2022-10-24 23:47:00,ad562f46e8055b997c53c8148f6d5917,1,3,1,0,0,5
6830,1702,2022-10-24 23:51:00,510b0d84c14db43f312788fe24c9c563,0,11,0,0,0,11
6831,1702,2022-10-24 23:57:00,5fb032e65ba8bfa9d4e41469d2b4aff4,0,10,0,0,0,10
6832,1702,2022-10-25 00:02:00,9dd59cdac457e318ee8bc660797ec191,0,9,0,0,4,13
6833,1702,2022-10-25 00:07:00,34061aa0b920e8354ea5dd8d2ab19392,0,15,0,1,0,16
6834,1702,2022-10-25 00:11:00,e2ec7102dbe4ebc73a85d225c8d46296,0,6,0,0,1,7
6835,1702,2022-10-25 00:17:00,9ea1d2137e99f2499066498f96f647d4,0,11,0,0,0,11
6836,1702,2022-10-25 00:21:00,fe932823b5d835ead7c47126bf65dce3,0,8,0,1,0,9
6837,1702,2022-10-25 00:26:00,cda5fd065d8800d0be2f5cbc40aa5759,0,13,0,0,1,14
6838,1702,2022-10-25 00:31:00,b1f67e314cb2e18832929b1acd11d448,0,12,0,0,0,12
6839,1702,2022-10-25 00:36:00,0d354be2966d4505fa576c9c6989599e,0,2,0,0,0,2
6840,1702,2022-10-25 00:41:00,3cbc94c3178fecf10478d409e22bbc80,0,10,0,0,1,11
6841,1702,2022-10-25 00:47:00,27ffb0c2c317179e248c02b05cbd38cd,0,2,0,2,2,6
6842,1702,2022-10-25 00:51:00,c0f9dce0ace7a73fb0ceaf9f2e0988f6,0,2,0,0,0,2
6843,1702,2022-10-25 00:56:00,8819e11fedb31984d5af18479a1e4267,0,2,0,0,1,3
6844,1702,2022-10-25 01:01:00,ab56737919e37842ad718d402f0aefa4,0,5,0,0,0,5
6845,1702,2022-10-25 01:16:00,91a3eb187edf3a131a37c9696d3c001e,0,7,0,0,0,7
6846,1702,2022-10-25 01:22:00,8984b5da5f8b57164032d8687d0baaf9,0,0,0,0,1,1
6847,1702,2022-10-25 01:27:00,c83e40b59981b3edee6c284a169fd801,0,7,0,0,0,7
6848,1702,2022-10-25 01:31:00,4d436b0c5653c2299ef4540fe464933f,0,4,0,0,0,4
6849,1702,2022-10-25 01:37:00,375fbb20ea37d448c52fc4c0534a1121,0,3,0,0,0,3
6850,1702,2022-10-25 01:41:00,11debc3a7759c16a37a99cc272636a73,0,0,0,0,0,0
6851,1702,2022-10-25 01:46:00,259dc5c747709349aaf0ed40acc65df5,0,7,0,0,0,7
6852,1702,2022-10-25 01:51:00,cef4024b9d919fa4634fe7c506e56f0b,0,4,0,0,1,5
6853,1702,2022-10-25 01:56:00,f29142891c47326ab436b5fc00be1d6e,0,3,0,0,1,4
6854,1702,2022-10-25 02:01:00,496bf4a1afe928ddb7a3fac4a77d1d3f,0,12,0,0,0,12
6855,1702,2022-10-25 02:07:00,1d42ab16b01689ef38e2a2d7b00521a5,0,7,0,0,1,8
6856,1702,2022-10-25 02:11:00,f1e6b3bb805a3591ffa35a2e0bde7284,0,2,1,0,0,3
6857,1702,2022-10-25 02:17:00,9af8b6cb44761b0cfe1e135a0df4c768,0,13,0,0,0,13
6858,1702,2022-10-25 02:22:00,8596bc85f85bd6100be1cd3e12fa5ef5,0,2,0,0,0,2
6859,1702,2022-10-25 02:26:00,0f46856484db8021bf563d0b4069d948,0,9,1,0,0,10
6860,1702,2022-10-25 02:31:00,0b9a638c55706c5b37db942b41ca91b0,0,0,1,0,0,1
6861,1702,2022-10-25 02:37:00,85aebb46fc7e66eadcb8c400e09484df,0,11,0,0,3,14
6862,1702,2022-10-25 02:41:00,aaf75025c6f1351ba5ba4c7f5d680387,0,6,0,0,0,6
6863,1702,2022-10-25 02:46:00,ac2a8a5e5f93074248a5cd9d230a1f88,0,12,0,0,0,12
6864,1702,2022-10-25 02:52:00,3f57d0874967805a1470950f0432e969,0,4,0,0,0,4
6865,1702,2022-10-25 02:56:00,951bdc7c3fa870746d7c83f57ff87028,0,7,0,0,0,7
6866,1702,2022-10-25 03:01:00,781c689323941b310a0304420bcde903,0,5,0,0,0,5
6867,1702,2022-10-25 03:06:00,43da0e7a25e30a6ef056ce77a8974e5f,0,8,1,0,0,9
6868,1702,2022-10-25 03:11:00,5c562f51edc59c9ba830e66af475a47e,0,2,0,0,0,2
6869,1702,2022-10-25 03:17:00,22d72c349cab6f388c3450d613d5c89d,0,7,0,0,2,9
6870,1702,2022-10-25 03:22:00,9fc7b9cec9caacc6f16dba157e88665a,0,8,0,0,0,8
6871,1702,2022-10-25 03:26:00,fb5baa2b7469a502e18f6a60e565369d,0,6,0,0,0,6
6872,1702,2022-10-25 03:32:00,0ff75dac155e4473d109ad709bdaceec,0,5,0,0,0,5
6873,1702,2022-10-25 03:37:00,a4d7c26707a6dee0af563946a0ea57a8,0,5,0,0,0,5
6874,1702,2022-10-25 03:42:00,2f21517763613013173e63f10ee42a34,0,2,1,0,0,3
6875,1702,2022-10-25 03:47:00,047d1ac243e0bd130f5076c675178a95,0,7,0,0,0,7
6876,1702,2022-10-25 03:52:00,3f1973714ad83f89c7d68113c99287f7,0,2,0,0,0,2
6877,1702,2022-10-25 03:56:00,66122d5684f028fc54128fc76030a9b2,0,5,0,1,1,7
6878,1702,2022-10-25 04:02:00,666821b5ba2cae2c93caacf256ff8928,0,4,0,0,0,4
6879,1702,2022-10-25 04:06:00,31a0546f6a0463f20cd01b14a134cada,0,6,0,0,0,6
6880,1702,2022-10-25 04:12:00,063512ef792dd998e475aa8204f45dd4,0,4,0,0,1,5
6881,1702,2022-10-25 04:16:00,718062caa1dfe48b460a1d4a98badd70,0,4,0,0,0,4
6882,1702,2022-10-25 04:21:00,5b55f266bf659051e472a5c36d4f5225,0,5,0,1,1,7
6883,1702,2022-10-25 04:27:00,a33236c8f245fc698c9d51b3ee1bc7b0,0,11,0,0,0,11
6884,1702,2022-10-25 04:33:00,b8bb3315dd2df8106b177adaca4e0f37,0,7,0,0,1,8
6885,1702,2022-10-25 04:37:00,e0e885cc45b9989a9f7e9b3844e6989d,0,1,0,1,0,2
6886,1702,2022-10-25 04:41:00,47e3538fbc37e9bb80066feb4b054d7b,0,7,0,0,1,8
6887,1702,2022-10-25 04:47:00,94f5f1243677321e3e2ba6182f4acc67,0,3,0,0,1,4
6888,1702,2022-10-25 04:52:00,beb305623c5462b86a683355eb74bf68,0,1,0,0,0,1
6889,1702,2022-10-25 04:57:00,0ca1b031fb7b15b5f2d5711297a64f5f,0,9,0,1,0,10
6890,1702,2022-10-25 05:01:00,04fb032b71e7a0c10406356f6d9d5a28,0,4,0,0,0,4
6891,1702,2022-10-25 05:06:00,3565b6accda34324db121c963a9481bf,0,7,0,0,0,7
6892,1702,2022-10-25 05:12:00,d92cb00ff55303f0311b2e3e763a3529,0,3,0,1,1,5
6893,1702,2022-10-25 05:17:00,8a3bedc89e0a3e6568fa39e54fa3e02d,0,4,0,0,0,4
6894,1702,2022-10-25 05:22:00,fd559c9ae8adaa2fb63c6c259da22dae,0,8,0,0,0,8
6895,1702,2022-10-25 05:27:00,dcb05fba6b1b155b70169ced4751455b,0,6,0,0,1,7
6896,1702,2022-10-25 05:32:00,9e7e2f3940e245e1eb741d9fdc70c0fe,0,3,0,0,0,3
6897,1702,2022-10-25 05:37:00,daca4053e05a77f0764eceab7c291390,0,5,0,0,0,5
6898,1702,2022-10-25 05:41:00,a94ac8730a06027b21fc13f3db579d22,0,5,1,0,0,6
6899,1702,2022-10-25 05:47:00,2cac4b456114b1171439b8e130eeb3dc,0,0,0,0,0,0
6900,1702,2022-10-25 05:53:00,bdec8f2ceca8b7963c3e7be5d57e3ebf,0,0,0,0,0,0
6901,1702,2022-10-25 05:57:00,7152b72eeb4d5cb8165ee37c87949970,0,10,0,0,1,11
6902,1702,2022-10-25 06:01:00,42dcf6dc42a2aaf5c88a69813b43153a,0,13,0,0,1,14
6903,1702,2022-10-25 06:07:00,6c02f8d5bb8afb85f507d727f8526bff,0,6,0,1,1,8
6904,1702,2022-10-25 06:12:00,03a6e6aebe09efde3fcbb3f2172e9944,0,6,1,0,1,8
6905,1702,2022-10-25 06:17:00,2e091bd952465ce573dc92b28a6b9797,0,6,0,1,0,7
6906,1702,2022-10-25 06:23:00,620bf4f0e1238e09d17939f8c4896d18,0,14,0,0,0,14
6907,1702,2022-10-25 06:26:00,49107d4a6c7974ba5fb86706fc91821e,0,12,0,1,0,13
6908,1702,2022-10-25 06:32:00,9b920139f64007b5bf86e39da6030d3f,0,14,1,1,0,16
6909,1702,2022-10-25 06:38:00,1b3952e08950ad338ce38347533c2963,0,9,0,1,2,12
6910,1702,2022-10-25 06:41:00,d24691acb704542c5684404167dde99c,0,18,2,1,1,22
6911,1702,2022-10-25 06:47:00,84b7f824b1c140ab31b8636b104d4e59,0,17,0,0,3,20
6912,1702,2022-10-25 06:52:00,f36446e64a84d41cad074bb61a3a94e2,0,15,0,2,7,24
6913,1702,2022-10-25 06:56:00,9f6369374e8a584ffc999abbf9540044,0,11,0,4,8,23
6914,1702,2022-10-25 07:02:00,4cd1de41fdcdaa5491e545d56e167c25,1,13,0,1,13,28
6915,1702,2022-10-25 07:07:00,80354e21afa0e945b7d57a2ec2af3b3c,0,18,0,3,4,25
6916,1702,2022-10-25 07:11:00,2599bd59fb2ffa952a897b2366fc973d,0,11,0,2,11,24
6917,1702,2022-10-25 07:17:00,e3c85f64c23a8865e3195a779a661a26,2,9,0,1,8,20
6918,1702,2022-10-25 07:22:00,4e553bbeaf8e8eb518736fe0294fa868,0,7,1,2,14,24
6919,1702,2022-10-25 07:27:00,f17454152ed22dd3f28dfbb5196fa6a1,1,27,0,1,4,33
6920,1702,2022-10-25 07:32:00,cd8be697eb207f49d7d2808b927d7069,0,14,0,0,10,24
6921,1702,2022-10-25 07:37:00,ffb00f758388c66d11c15e44481941a2,0,18,0,1,7,26
6922,1702,2022-10-25 07:42:00,46425d6f6948ec4dde8b968edd2159ea,0,12,0,3,11,26
6923,1702,2022-10-25 07:47:00,c5dbf7d042be6e8e3309adf81f740e85,0,17,0,2,11,30
6924,1702,2022-10-25 07:52:00,5d005f6a6ab129f9b593c8900171da33,0,16,0,4,8,28
6925,1702,2022-10-25 07:58:00,48619dd26576dac4597844f000001dc5,0,14,0,3,10,27
6926,1702,2022-10-25 08:02:00,7b01f37e3ff878853a3d08444a081c51,1,18,0,0,11,30
6927,1702,2022-10-25 08:07:00,f2b6fc0c5585f7991c620a3be9362487,0,14,1,8,5,28
6928,1702,2022-10-25 08:12:00,56b8d5ff11a1fd3d8d6603d14c1bcb85,0,13,0,1,9,23
6929,1702,2022-10-25 08:16:00,12bce8f6377ffbfdbd03e334c2baba66,1,11,0,4,13,29
6930,1702,2022-10-25 08:22:00,384b1d587f799d4508e0c86c2154c552,0,17,0,2,11,30
6931,1702,2022-10-25 08:26:00,83b65744b42ad99c685f82fd318d1b72,0,7,0,2,11,20
6932,1702,2022-10-25 08:32:00,79660ba411d8a257847fec064feaba3e,0,14,1,1,6,22
6933,1702,2022-10-25 08:38:00,15c3142ba56ce9911debe4ba9c86045b,0,13,0,1,8,22
6934,1702,2022-10-25 08:41:00,ef89884ddb5ff3a81d3ae07beee03a19,0,19,0,0,6,25
6935,1702,2022-10-25 08:47:00,78466d4fb092bc1bbc2fbdc5ef1c3a4f,0,16,0,4,3,23
6936,1702,2022-10-25 08:52:00,253e9c720903c8ded1b4a3c50c9cdb7d,0,16,1,3,3,23
6937,1702,2022-10-25 08:57:00,df445726c5f3ecdb1709c233c7e22772,0,11,0,2,11,24
6938,1702,2022-10-25 09:03:00,d51eb3be75484dc010e60bf26e5457ae,0,11,0,4,7,22
6939,1702,2022-10-25 09:08:00,036af6fec48da6dc03eff9e1b3bf4e06,1,14,0,3,5,23
6940,1702,2022-10-25 09:12:00,de4535d45ab2ce7826a20c8928be02b4,0,10,0,0,7,17
6941,1702,2022-10-25 09:18:00,411a1fc2f6c25bcc0b75e03601088c2a,0,23,0,0,2,25
6942,1702,2022-10-25 09:22:00,8f7ba107cbb3e889565fb0952756509d,0,14,0,1,5,20
6943,1702,2022-10-25 09:27:00,e7cf3481aff2ec1efff9555dc9cfb779,0,15,0,2,8,25
6944,1702,2022-10-25 09:32:00,bc33d1ada114bcbb77e9df6b31872c8d,0,11,0,1,11,23
6945,1702,2022-10-25 09:37:00,a4ca0d1ea790bf99422bce691b835bc9,0,13,1,1,6,21
6946,1702,2022-10-25 09:42:00,c3341a67846f76bdbe8df54fd8d81fdd,0,20,0,2,5,27
6947,1702,2022-10-25 09:47:00,67c35bcf7843217e92da367c926aedbc,0,21,0,0,7,28
6948,1702,2022-10-25 09:52:00,9dcba524eccd680cec29d8e3e8c97437,0,17,0,0,10,27
6949,1702,2022-10-25 09:58:00,5071d87e7bc1093d92a604caf0993ce4,0,14,0,0,7,21
6950,1702,2022-10-25 10:03:00,d90667f46ef3c3cfd23f81294254c93d,0,11,0,3,6,20
6951,1702,2022-10-25 10:07:00,dc849580ca42a1427c3e9aeefc14ee9d,0,13,0,1,14,28
6952,1702,2022-10-25 10:12:00,4567f63b585b9ddb26b129b4f2d87858,0,7,1,2,9,19
6953,1702,2022-10-25 10:18:00,94532d3c100bc752efb4e8352c9fdbc0,0,9,0,3,14,26
6954,1702,2022-10-25 10:22:00,650c7e9f1279a596f3572c9d9395c56d,0,14,0,3,8,25
6955,1702,2022-10-25 10:28:00,d001e8a5e0ff1e326e8635cc82b79552,1,13,1,5,11,31
6956,1702,2022-10-25 10:33:00,a480a1aa900729671ed62105c7329d20,0,17,2,1,9,29
6957,1702,2022-10-25 10:38:00,5e28a262e915efa340eb3a0f9fc895a1,0,12,0,2,11,25
6958,1702,2022-10-25 10:43:00,e791766e5171982f8854d6ad51bbc600,0,9,0,3,7,19
6959,1702,2022-10-25 10:47:00,40f228ceef76a9ec58e0f4e7c1bff41b,0,18,0,0,8,26
6960,1702,2022-10-25 10:53:00,c24cc7f671a8698409bc38793f7feaa1,0,14,0,3,7,24
6961,1702,2022-10-25 10:57:00,a82ee8cd88ba674b8e0803a69c407ac3,1,20,0,1,7,29
6962,1702,2022-10-25 11:03:00,68a3630e6efbd5f7f3edd3dad8144bb9,0,15,0,3,9,27
6963,1702,2022-10-25 11:07:00,b2e43d8686fdb6835c98fd1cf7660c4b,0,13,0,5,11,29
6964,1702,2022-10-25 11:12:00,c6a9f9c8d2da5856e2bea6e5b476fa83,0,11,0,3,13,27
6965,1702,2022-10-25 11:18:00,6e26838f47e6d2ed9e05c5daadc8c0e7,0,11,0,2,5,18
6966,1702,2022-10-25 11:21:00,78e2f2d38893b886055b265e9c9b626a,0,11,1,4,9,25
6967,1702,2022-10-25 11:27:00,e6c7273b26748c67b73947439c13e0d8,0,15,0,1,15,31
6968,1702,2022-10-25 11:32:00,a4a6dbbd3872822982856ef962d4b9c7,0,11,0,2,9,22
6969,1702,2022-10-25 11:37:00,c3bf3dcd73d1f4996b928c91c88f24ff,0,13,0,2,9,24
6970,1702,2022-10-25 11:41:00,da4baf61d06b358676f5c23d99b1dd73,0,17,0,0,8,25
6971,1702,2022-10-25 11:47:00,f952f426710d58992ab6c7eecff75890,0,9,0,2,11,22
6972,1702,2022-10-25 11:52:00,afdce3fc75a21f2bfc9e1f753e80696d,1,4,0,0,16,21
6973,1702,2022-10-25 11:56:00,bb9842fd7e231dec190f947cad47620e,0,9,1,0,8,18
6974,1702,2022-10-25 12:02:00,6f6e418f506ea6a46d38de02c51bc2ae,0,13,0,1,6,20
6975,1702,2022-10-25 12:07:00,90bbfc21b4dc604de506a3dac6103caf,0,12,1,3,8,24
6976,1702,2022-10-25 12:12:00,48743e1fd8d0f7a8ae14217739756fd5,0,16,0,1,8,25
6977,1702,2022-10-25 12:17:00,3787a0ba54f2dac6ae96285b9b5bfdd1,0,13,0,2,7,22
6978,1702,2022-10-25 12:22:00,baa7760a4b5751154022e0479c048f91,2,8,0,1,10,21
6979,1702,2022-10-25 12:27:00,3e13f5e2da707e1aa1b616519eda5607,0,8,0,1,15,24
6980,1702,2022-10-25 12:32:00,928792bca6492e80763eaf7ba0524a34,2,13,0,1,9,25
6981,1702,2022-10-25 12:37:00,e5a197a1fa432f84a2f59376787c3b06,0,8,0,2,10,20
6982,1702,2022-10-25 12:42:00,3069ea86ed155ed882e75c2d24cdf7d6,0,9,1,0,12,22
6983,1702,2022-10-25 12:48:00,e35d77745cfc3819d39c2b6e5c2b42d4,0,13,0,2,7,22
6984,1702,2022-10-25 12:53:00,7141190b71d71064573517a7e5227934,4,11,0,3,6,24
6985,1702,2022-10-25 12:57:00,1688b7df818761ac5a7c9c9553974449,0,11,1,1,14,27
6986,1702,2022-10-25 13:02:00,7db33b1688a1d2fdc6db67396070e5fd,0,13,0,2,8,23
6987,1702,2022-10-25 13:07:00,26644b121a17599bb091055e2a655a5b,2,11,1,4,8,26
6988,1702,2022-10-25 13:12:00,c6b8af17f153bd3f566adf167eb939aa,0,11,1,1,8,21
6989,1702,2022-10-25 13:17:00,bc8fc452bc6a9b19c96d21164869c571,2,10,0,2,7,21
6990,1702,2022-10-25 13:22:00,aea20a83454b2605b8d959656a65ca3f,0,12,0,1,10,23
6991,1702,2022-10-25 13:27:00,f49bfaa1ccd85250dd12d2f9898729e7,0,13,0,3,12,28
6992,1702,2022-10-25 13:32:00,793faba99e4009d8f2f8b81326ef1d4f,0,12,1,4,9,26
6993,1702,2022-10-25 13:37:00,e73b93d743fb45ddd9f67731cdcb0131,0,13,0,0,18,31
6994,1702,2022-10-25 13:42:00,d2434e228cfa53a6af48df86077a2f33,0,9,0,2,12,23
6995,1702,2022-10-25 13:47:00,0199fcbb76b8f8423e7801cb6cc44de1,0,12,0,1,12,25
6996,1702,2022-10-25 13:52:00,4d16773c394503ec3884e1332b0d52c8,1,17,0,6,14,38
6997,1702,2022-10-25 13:57:00,fdcfb45ab87d2a37c4dd82a828ce6ca6,0,14,0,4,11,29
6998,1702,2022-10-25 14:02:00,002a2f18468a859c20621916590c5c84,0,9,0,2,12,23
6999,1702,2022-10-25 14:08:00,91d23ec1dcb9290400f0aa3f225fade5,0,17,0,2,9,28
7000,1702,2022-10-25 14:12:00,10835cdbc50bcf14aa7fa15017300bed,1,16,2,2,8,29
7001,1702,2022-10-25 14:18:00,6fc83218fe3e416fa7e80434912d03b3,0,13,0,1,12,26
7002,1702,2022-10-25 14:22:00,548c06a427f0bffac45c267559e9a349,1,16,1,2,8,28
7003,1702,2022-10-25 14:27:00,8047f78dd2295227b79d6aa054943dc4,0,16,1,2,11,30
7004,1702,2022-10-25 14:32:00,6a4e0571e02d7ca20e4f2148501b32ea,0,13,0,3,8,24
7005,1702,2022-10-25 14:38:00,4a24897dacaee37eee1639f726b57fc9,1,17,0,4,9,31
7006,1702,2022-10-25 14:42:00,4b2cde1a3bea16cc8706cfe71df4184e,0,14,0,2,12,28
7007,1702,2022-10-25 14:46:00,8f7f1680b3433a53bb3b81978208de49,0,13,0,3,11,27
7008,1702,2022-10-25 14:53:00,67419ebac1b213d1decc4c26bc3b3dd1,0,16,0,1,13,30
7009,1702,2022-10-25 14:57:00,27fd164496a11a8c8006ba4472e8fa70,0,16,0,2,7,25
7010,1702,2022-10-25 15:02:00,2c8019919f5d66d5650ca65c8807f39b,0,17,1,0,4,22
7011,1702,2022-10-25 15:07:00,3a353b372af7fd7fd84f06ff3a019a86,1,17,0,3,5,26
7012,1702,2022-10-25 15:13:00,98929034d0d1e877258c5c22df01508f,0,17,0,2,5,24
7013,1702,2022-10-25 15:17:00,528efff9f8332d80a6ee667b568c5506,2,10,0,0,10,22
7014,1702,2022-10-25 15:22:00,168fc2ffa214f8ca4a7f6111a98219e1,1,17,1,4,9,32
7015,1702,2022-10-25 15:28:00,7a551e6fa772cfd2ca8570bfc9988951,0,14,0,2,10,26
7016,1702,2022-10-25 15:33:00,ecb325dacef8161ef06222464a605f76,0,10,0,1,9,20
7017,1702,2022-10-25 15:37:00,ebe736c0e032722f397cebf252d37f74,0,9,1,1,12,23
7018,1702,2022-10-25 15:43:00,c60d7d7442eeebb655b121192e785fe7,0,14,0,1,9,24
7019,1702,2022-10-25 15:47:00,443f97d135177e6dea43deca9d382634,0,14,0,3,9,26
7020,1702,2022-10-25 15:52:00,39c12da64570083e283618dd16a10aa0,0,12,1,3,13,29
7021,1702,2022-10-25 15:56:00,b7be6e0caa9e92558d68ca54a2711f46,1,16,1,5,4,27
7022,1702,2022-10-25 16:03:00,db89b8dc620f9b2af0d4ca24cf0e21a1,0,20,0,5,6,31
7023,1702,2022-10-25 16:07:00,743fc49408be97f61abf0bf5695ac62a,0,15,0,6,2,23
7024,1702,2022-10-25 16:12:00,b60b392be9ab67e67a80cfc60756f5ce,0,17,0,3,6,26
7025,1702,2022-10-25 16:17:00,b1e0325c4b630d6247564395500defc6,0,15,0,2,3,20
7026,1702,2022-10-25 16:21:00,38fef433ff1f76b17d75b7701ea53be4,0,15,0,1,9,25
7027,1702,2022-10-25 16:26:00,23718deb21da4dae13f530c4151112c1,0,14,1,0,8,23
7028,1702,2022-10-25 16:32:00,de5bdb2f15cd21350cc1a2efc42c7546,1,16,0,2,3,22
7029,1702,2022-10-25 16:37:00,fcdbcd3de460afa114a89574e0e39918,0,26,0,0,3,29
7030,1702,2022-10-25 16:41:00,db60e0e340c2c5438dab8f8fcd68c03e,0,21,0,0,4,25
7031,1702,2022-10-25 16:46:00,a4faec72d237a321741f95425dd951ec,0,19,0,1,2,22
7032,1702,2022-10-25 16:51:00,c5ae532be90497845b36ba0ee6839ad5,0,22,0,5,4,31
7033,1702,2022-10-25 16:57:00,0f347acfd6d0d3b025b93e09819dfe0d,0,24,0,2,3,29
7034,1702,2022-10-25 17:02:00,303cc57d2d2723df694370108ec0f28f,0,21,1,0,8,30
7035,1702,2022-10-25 17:06:00,bcfba0f75ce636816f7d490b4d09cae0,1,25,0,3,2,31
7036,1702,2022-10-25 17:13:00,2c603270f5bfaa0edd8e43fc6b324a43,4,20,1,1,6,32
7037,1702,2022-10-25 17:17:00,4976b49462c5187731fd4fef45746ff0,0,19,0,2,4,25
7038,1702,2022-10-25 17:23:00,ee86f9fe1d4112cc7ad3218ba9e5eda3,0,21,0,4,6,31
7039,1702,2022-10-25 17:26:00,891a8077ff7297f46fdf36cf4cd08705,0,20,1,3,5,29
7040,1702,2022-10-25 17:32:00,0bd2f5eb0b245428f54046b1983bdcd6,0,14,0,1,6,21
7041,1702,2022-10-25 17:38:00,a6d550354e11a35281fe3950a255b6bb,0,24,1,1,6,32
7042,1702,2022-10-25 17:41:00,ff7c4dad4bd4c67543f27a9e8528815b,0,21,0,3,0,24
7043,1702,2022-10-25 17:47:00,3280a2db3186e60eeafbe2759c7f881f,0,22,0,3,1,26
7044,1702,2022-10-25 17:52:00,daabfaba2520233d41c28cb1033ea725,1,23,0,0,7,31
7045,1702,2022-10-25 17:56:00,0096049d8f63f59e48068f8e822e077d,0,23,0,4,2,29
7046,1702,2022-10-25 18:01:00,3fef75a5e8efbb683990f0a04c817c5e,0,26,0,2,3,31
7047,1702,2022-10-25 18:07:00,c06b9e01e5e05d4349c948706a2ec383,0,21,0,3,3,27
7048,1702,2022-10-25 18:12:00,4518fdbbb9ec33c2f975f1309837ff94,0,22,0,2,4,28
7049,1702,2022-10-25 18:17:00,f1e9f73ee68be1f1036b4d6637b32de5,0,22,0,4,3,29
7050,1702,2022-10-25 18:21:00,2c7e1ab14911325bd28fd7cf9da8ad2d,0,20,0,3,2,25
7051,1702,2022-10-25 18:27:00,7e2c8ea38463c5e59d760f0d5a3b7752,0,34,0,0,3,37
7052,1702,2022-10-25 18:31:00,c685534009f98fe86fb27813b0b7b3bc,0,20,1,2,0,23
7053,1702,2022-10-25 18:36:00,f789e3cd447b8ad0cc1d868733c569d4,0,18,0,1,0,19
7054,1702,2022-10-25 18:42:00,d10a113abc4efae081969eff0bfbe9d5,0,15,0,1,2,18
7055,1702,2022-10-25 18:47:00,82bc9e9c2e869b6079db01e428c74dee,0,24,0,0,0,24
7056,1702,2022-10-25 18:51:00,9ed2a17d317db54832ba855b0f1f24ff,0,20,3,1,0,24
7057,1702,2022-10-25 18:57:00,43b62a77bee9a74dc18ed2f96049d8ef,0,25,0,0,1,26
7058,1702,2022-10-25 19:01:00,3b35c068fe5567251490bdecc2965474,0,17,0,2,1,20
7059,1702,2022-10-25 19:07:00,6dc701f5077ff708960a836967c69838,0,16,1,1,1,19
7060,1702,2022-10-25 19:11:00,af47b36583e70237b34e6b3059f14efe,0,21,0,1,0,22
7061,1702,2022-10-25 19:16:00,85680136c0d36517eccefcc3e6b672a2,1,14,0,0,0,15
7062,1702,2022-10-25 19:22:00,b409b398a9a68cc6a4db9290bbedc39d,0,16,0,0,1,17
7063,1702,2022-10-25 19:26:00,e66d5a4154b98e0a6319c2781e928c99,0,18,0,0,0,18
7064,1702,2022-10-25 19:32:00,42bb980bc37552e0abfdd3ad98689563,0,16,0,1,0,17
7065,1702,2022-10-25 19:37:00,5b677a1e8c5766c9114472cb3a291edb,0,13,0,0,0,13
7066,1702,2022-10-25 19:41:00,a313437d7f731df08aaf49a17cbe6951,0,14,0,1,0,15
7067,1702,2022-10-25 19:46:00,83933fe2a4492d15c036ca7bd44590b9,0,20,0,0,0,20
7068,1702,2022-10-25 19:52:00,9f9027377f258c2abf7139f0f40aa7df,0,14,1,0,0,15
7069,1702,2022-10-25 19:57:00,613a0e504703b88036d062ddac2c597e,0,22,1,0,0,23
7070,1702,2022-10-25 20:01:00,3912202187b6c82f18add61af7b6d1ff,0,14,0,0,0,14
7071,1702,2022-10-25 20:08:00,9503cc2c57de567becfea8cfdc09cee8,2,18,0,1,0,21
7072,1702,2022-10-25 20:12:00,31b10ff9585b71b21ce11ff7704c09a1,0,20,0,0,0,20
7073,1702,2022-10-25 20:16:00,7ba7dcf0541017bd4dc917f32d40da8e,0,14,1,0,0,15
7074,1702,2022-10-25 20:22:00,183af6835a29d7442628c1dbfdeb84d6,0,23,0,0,0,23
7075,1702,2022-10-25 20:27:00,a7b108b646b2f90ac339c6bacd59277d,0,19,1,0,1,21
7076,1702,2022-10-25 20:32:00,52baa513cd9d0b823afb167b22b0c710,0,19,0,0,0,19
7077,1702,2022-10-25 20:36:00,c56b57f9f05972939dea88661044848a,0,12,0,1,0,13
7078,1702,2022-10-25 20:42:00,7397b6be7e549b9db0a7e95cbdb76945,0,5,0,0,0,5
7079,1702,2022-10-25 20:47:00,b592a0356feb67cb6031abaaf45c4017,0,12,0,0,0,12
7080,1702,2022-10-25 20:52:00,14203a364f87681ee592632212e4d91e,0,11,2,2,0,15
7081,1702,2022-10-25 20:57:00,7fb35b3531d162eb09dd90a3c169a3e7,0,20,0,0,0,20
7082,1702,2022-10-25 21:02:00,123f363dff4789b7a8a0516d0ff4048e,0,13,0,0,0,13
7083,1702,2022-10-25 21:07:00,dfb3142643299291f1cb29a6beb554d5,0,20,1,1,1,23
7084,1702,2022-10-25 21:11:00,70432c4889b938262821b99856c81b45,0,13,0,0,0,13
7085,1702,2022-10-25 21:17:00,5a3355d3af779027673104f52af27e42,0,15,1,0,0,16
7086,1702,2022-10-25 21:21:00,d660fcd1ea93bbc3dcf90c98c996820a,0,10,0,0,0,10
7087,1702,2022-10-25 21:27:00,d3714db14aea2ba88c55325ff3fc0e8e,0,21,0,0,0,21
7088,1702,2022-10-25 21:32:00,377182d762ddb6a210a38bf6affd7895,0,15,0,1,1,17
7089,1702,2022-10-25 21:36:00,7b6c445f0536ff023b0f83f4e3e5e0f6,0,8,0,0,0,8
7090,1702,2022-10-25 21:41:00,893097b2004f95885d4ddfe07a576e5c,0,17,1,0,0,18
7091,1702,2022-10-25 21:47:00,722b3add02c116dfdf82acd8beb1058c,0,16,1,0,1,18
7092,1702,2022-10-25 21:52:00,148aaf5183fff19dc495d82a71254e2f,0,11,0,0,1,12
7093,1702,2022-10-25 21:57:00,b0f558b51a32bb183d18cb032952188d,0,12,0,1,0,13
7094,1702,2022-10-25 22:02:00,39c902cb4199890e5b8e8d84956daae9,0,18,2,0,1,21
7095,1702,2022-10-25 22:07:00,b269be005bc06b2f70239a655054189e,0,10,0,0,1,11
7096,1702,2022-10-25 22:12:00,915bacbfd0327f03698d25b3210063fd,0,10,0,0,3,13
7097,1702,2022-10-25 22:17:00,932326ea54c783ff6c8bcec0b9253cc1,0,16,0,0,0,16
7098,1702,2022-10-25 22:22:00,0fef8f5b33c0c650d1e682eb3eb65927,0,12,2,0,2,16
7099,1702,2022-10-25 22:28:00,dfffe027a296f8f75c580b4513ed291d,0,14,1,0,0,15
7100,1702,2022-10-25 22:32:00,61c1dd98a7baccbf04680d7256232ffe,0,12,1,0,4,17
7101,1702,2022-10-25 22:39:00,9308ed2aa5f4ac4eb9f1653a59dd3ad7,0,11,0,0,0,11
7102,1702,2022-10-25 22:42:00,e6c41edae672d529a4ed96aa7b74a77b,0,10,0,1,0,11
7103,1702,2022-10-25 22:47:00,b40d6adc1390c6536f682a3004691263,0,16,0,0,0,16
7104,1702,2022-10-25 22:52:00,4599398d07c9b34b5d48f4aee1879dd4,0,11,0,0,0,11
7105,1702,2022-10-25 22:57:00,db06e32bd651dcfa0c00fcf6a5752abc,0,9,0,0,2,11
7106,1702,2022-10-25 23:02:00,cfd2a005bfeb7c4f2e2a10ab4099d330,0,7,0,2,1,10
7107,1702,2022-10-25 23:08:00,908e5d64321862459d79a0f200a12462,0,13,1,0,0,14
7108,1702,2022-10-25 23:12:00,654e90b24e8cb6eb898a372ebc4f2e6f,0,13,0,0,1,14
7109,1702,2022-10-25 23:17:00,3b5069ace3a077787c392e5b8e212197,0,10,0,2,0,12
7110,1702,2022-10-25 23:22:00,6c8d05c43dadc793e0a269f87df8c41f,0,11,0,0,0,11
7111,1702,2022-10-25 23:27:00,7ee272875b8372e72641afde6adaf61f,0,7,0,0,2,9
7112,1702,2022-10-25 23:32:00,5fd15cd332230a07ef535b80e171590e,0,14,4,0,0,18
7113,1702,2022-10-25 23:36:00,1dab98a1713b8163c6c7f4cd41ddd1e8,0,8,0,0,2,10
7114,1702,2022-10-25 23:42:00,12c8ab88258b71dc963f503ddfdbd2c1,0,8,0,0,0,8
7115,1702,2022-10-25 23:46:00,af44801e4952e873943b7b334535e779,0,15,0,0,1,16
7116,1702,2022-10-25 23:52:00,87c6e70159c6d05ecf55056bd57c3151,0,7,1,0,3,11
7117,1702,2022-10-25 23:57:00,e90de83739b435dfb69604f5b4e9dbf2,0,11,1,1,1,14
7118,1702,2022-10-26 00:02:00,2455229079663a63957ff084c6cc5645,0,5,0,0,1,6
7119,1702,2022-10-26 00:07:00,eb5f680ca9d39274e9edda416a9e0dcc,0,8,0,0,0,8
7120,1702,2022-10-26 00:11:00,d9142beea5ec69ab033cbcb7a9bbf7fc,0,11,0,0,2,13
7121,1702,2022-10-26 00:16:00,6384055af189943ce561156e1e337a96,0,9,0,1,0,10
7122,1702,2022-10-26 00:21:00,d1fa6c44dd15fce136e06cd905a3a8db,0,6,0,0,2,8
7123,1702,2022-10-26 00:26:00,0c6e5ac912ff0e9aaabbc545d77a2369,0,1,0,0,1,2
7124,1702,2022-10-26 00:32:00,9d44f1c5cfd4d07c4b15be03c659ec8f,0,9,0,0,2,11
7125,1702,2022-10-26 00:37:00,5d1e958b82f3320f79639d9b933f2f70,0,11,0,0,2,13
7126,1702,2022-10-26 00:42:00,da14c12d5d7f502adab36b1d9ff4d24e,0,5,0,0,0,5
7127,1702,2022-10-26 00:46:00,927c6a9862e553457165e58e52a32df9,0,8,0,0,0,8
7128,1702,2022-10-26 00:51:00,3ecc9a80961d8b2808fb6cc1bf136d97,0,8,1,0,0,9
7129,1702,2022-10-26 00:56:00,bf8828f60ca20f7fe12e8d4531204236,0,6,0,0,0,6
7130,1702,2022-10-26 01:02:00,b677f7daff692357d340d1db366a1efc,0,3,0,0,0,3
7131,1702,2022-10-26 01:17:00,f7192cee4eee4fca6105aa6c951867ad,0,0,0,0,0,0
7132,1702,2022-10-26 01:22:00,61ddc629358860559557a069bde2deb4,0,12,0,0,1,13
7133,1702,2022-10-26 01:27:00,8e7255b89600450e75aa94abf8a335eb,0,6,0,0,1,7
7134,1702,2022-10-26 01:32:00,c641cf17cca248bc53b822ceb39c7bb3,0,7,1,1,0,9
7135,1702,2022-10-26 01:37:00,973a5b5b0276bc9bd60e81cc7967ba6b,0,3,0,0,0,3
7136,1702,2022-10-26 01:42:00,17edbdb4c806344b9a6762b41cdc1873,0,1,0,0,0,1
7137,1702,2022-10-26 01:48:00,db3af563370b16b6884fd22ea3b564f3,0,8,0,0,2,10
7138,1702,2022-10-26 01:51:00,0469c4e47b3ea90be335a2e34dee2109,0,7,0,0,0,7
7139,1702,2022-10-26 01:56:00,c112af659a2dcbd45b2a21a923a4cf23,0,6,0,0,1,7
7140,1702,2022-10-26 02:01:00,e5742f211ee1bb43e74174359986f1ac,0,8,0,0,0,8
7141,1702,2022-10-26 02:07:00,8ab24a128e75a3f921506112fb5cf184,0,4,0,0,0,4
7142,1702,2022-10-26 02:11:00,5d37ad22f3c69bdfff902e9e511c1d38,0,1,0,0,0,1
7143,1702,2022-10-26 02:17:00,dca0da6be8b70b6443cdcc81bc538cd4,0,0,0,0,0,0
7144,1702,2022-10-26 02:22:00,d4b06897d85ab316a8db1ca5c70a753b,0,7,1,0,1,9
7145,1702,2022-10-26 02:26:00,6a6426720b61bc11eb95a595bd6b144b,0,9,0,0,1,10
7146,1702,2022-10-26 02:31:00,df508754316d92ecdc099727a165ae2a,0,5,0,0,0,5
7147,1702,2022-10-26 02:37:00,420d69952f38ea5aca359353f9cf5581,0,5,0,0,0,5
7148,1702,2022-10-26 02:41:00,e7d58d2bcc3ce1a44004adbc405c6d2b,0,4,0,0,0,4
7149,1702,2022-10-26 02:47:00,c92b35a63610151b92664a9d66ee5627,0,10,1,0,1,12
7150,1702,2022-10-26 02:51:00,4727333baf7ea695225c3a36ef4ee82d,0,2,0,0,0,2
7151,1702,2022-10-26 02:57:00,83f533da070df8a173160e2cca1fdc25,0,9,0,0,0,9
7152,1702,2022-10-26 03:02:00,9b2caffd321d78bda7526d196d2a673e,0,7,0,0,1,8
7153,1702,2022-10-26 03:07:00,216410324de1d2e06d1dd330ffce02c9,0,1,0,0,0,1
7154,1702,2022-10-26 03:11:00,be9bf05adc54d1d61c3e454cc12cfbe6,0,2,0,0,1,3
7155,1702,2022-10-26 03:17:00,5917c65a1fdc89c010ff29f2cbcafee3,0,7,0,0,0,7
7156,1702,2022-10-26 03:21:00,644e63ba1c118f5daf3b05408a23d2b1,0,8,0,0,0,8
7157,1702,2022-10-26 03:26:00,037831c62faf3992becc6d7b51692b0c,0,4,0,1,1,6
7158,1702,2022-10-26 03:31:00,584c332c49ce9480079635b615d833ad,0,1,0,0,1,2
7159,1702,2022-10-26 03:37:00,d4a5ad5eb93712a0143c113034e3e4a3,0,2,0,0,1,3
7160,1702,2022-10-26 03:41:00,612a2b6988246d8c568ebeed509a762c,0,8,0,0,1,9
7161,1702,2022-10-26 03:46:00,3ddba0060f5d8e91277b7d5cc7a37f9b,0,6,0,0,0,6
7162,1702,2022-10-26 03:51:00,a4e11f8d74cbe096e00354117fc41c30,0,2,0,0,0,2
7163,1702,2022-10-26 03:57:00,9039df852a04b3bbd096269259a79f38,0,0,0,0,0,0
7164,1702,2022-10-26 04:03:00,810cf7e2695534f56ac0f4ca014dc085,0,3,0,0,0,3
7165,1702,2022-10-26 04:07:00,fe0d380f5251b38ea50ee4297020ec4a,0,2,0,0,0,2
7166,1702,2022-10-26 04:12:00,c7b349e25de764c8e2805e72685b7866,0,2,0,0,0,2
7167,1702,2022-10-26 04:16:00,f86e1703cd5fdf2009bf463a794dbd1c,0,1,0,0,0,1
7168,1702,2022-10-26 04:22:00,3e14245fcddb1e7f34b905f532e480af,0,10,0,0,0,10
7169,1702,2022-10-26 04:27:00,ecd41ae19212dec7ea4bfddb253f0ea5,0,7,0,0,1,8
7170,1702,2022-10-26 04:31:00,930a358264707b661774c90a026ac6c3,0,5,0,0,0,5
7171,1702,2022-10-26 04:37:00,6e3e78e0045c53a38a61f14a84167e92,0,3,1,0,0,4
7172,1702,2022-10-26 04:41:00,64664edaef01353b4c6229608f24ade7,0,8,0,0,1,9
7173,1702,2022-10-26 04:46:00,855f00bccf2e9c2d67cf6f655d12c5da,0,9,0,0,1,10
7174,1702,2022-10-26 04:52:00,128944008286994faf6837b552d33268,0,4,0,0,0,4
7175,1702,2022-10-26 04:56:00,0142778b89ab714747e99a8cd8b3cc77,0,4,0,0,1,5
7176,1702,2022-10-26 05:02:00,223e930f036acd00ea792e32a3fbf141,0,7,0,0,0,7
7177,1702,2022-10-26 05:07:00,1f017c6271709cc5a5aef6ae1ecef921,0,2,0,3,0,5
7178,1702,2022-10-26 05:11:00,12f4e8fcb4ea7979c5ac5086bf7c77f2,0,3,0,1,0,4
7179,1702,2022-10-26 05:17:00,04d59df6ae482c2c7398b822d90c37a9,0,8,0,1,0,9
7180,1702,2022-10-26 05:21:00,520b7613fcb70f21d8293f899b049d87,0,4,0,0,1,5
7181,1702,2022-10-26 05:26:00,2f3af6d32a09e82de053db19c09abb1e,0,1,0,0,0,1
7182,1702,2022-10-26 05:32:00,7c705334b6c5024264c4cdf0fcc65886,0,3,0,0,1,4
7183,1702,2022-10-26 05:36:00,0bc736d15cc1932901dbd7e744617c59,0,2,0,0,0,2
7184,1702,2022-10-26 05:41:00,f65b9578599e894c92a0bc1d60af3bff,0,6,0,1,1,8
7185,1702,2022-10-26 05:47:00,7a08bbfbc0c0e630baf8fec9ad93a100,0,3,0,0,0,3
7186,1702,2022-10-26 05:52:00,238280dd53d2ed2186c86fb03b632916,0,10,0,0,0,10
7187,1702,2022-10-26 05:57:00,9c3f54131ece287ec655b594fedf8c8f,0,4,0,0,1,5
7188,1702,2022-10-26 06:01:00,865cb853511c34800e7537a7d4c0b83e,0,4,0,0,0,4
7189,1702,2022-10-26 06:07:00,4f21e3295a9a937492358abeb0708e05,0,10,0,2,0,12
7190,1702,2022-10-26 06:11:00,8b27203c87e13bb98784565472f4c6e3,0,9,0,0,0,9
7191,1702,2022-10-26 06:18:00,e4d52595b4bb2c181eb4ce48f9176333,0,3,0,4,0,7
7192,1702,2022-10-26 06:22:00,89931d6a369487d239b81238e2851eab,0,8,0,1,0,9
7193,1702,2022-10-26 06:27:00,d2145c176887d0eec17b70691f5d343b,0,9,0,0,1,10
7194,1702,2022-10-26 06:31:00,51867b596acaa46057d2207869cd50cc,0,9,3,0,2,14
7195,1702,2022-10-26 06:37:00,f8f31f2f809d25a45e3f1fd522f4758b,0,7,0,0,6,13
7196,1702,2022-10-26 06:41:00,2795070338a029c152929a59f5ba622c,0,17,0,4,0,21
7197,1702,2022-10-26 06:47:00,0fadae0c715902c6eba1d98f90f972d7,0,16,2,2,3,23
7198,1702,2022-10-26 06:52:00,f81e1427baf13d1611df3ffdc01e6c73,0,7,0,2,7,16
7199,1702,2022-10-26 06:57:00,9950923ed6dc68b1f997ae6b06b6194c,0,22,0,1,3,26
7200,1702,2022-10-26 07:02:00,5f0df3f253ce6618aca7f32c1e6b7855,0,21,0,1,6,28
7201,1702,2022-10-26 07:07:00,90c89d5e8604f9391b6fbcca781ba11c,0,13,0,0,6,19
7202,1702,2022-10-26 07:11:00,082ba96b0d5bc9ce9aae9fcb17658bbd,1,14,0,2,2,19
7203,1702,2022-10-26 07:17:00,e3d7ce894ffee4db5bdea2126bd8c265,1,17,1,2,6,27
7204,1702,2022-10-26 07:21:00,25724934cdd5302be64510938c0fccf1,0,19,1,2,10,32
7205,1702,2022-10-26 07:26:00,73b8d188c1c84558c7008ff98a380942,0,18,0,0,5,23
7206,1702,2022-10-26 07:32:00,0b775ecb4ed22287488f012d9894aaa9,0,17,1,4,4,26
7207,1702,2022-10-26 07:36:00,ee621c15bb8143d9bdc95b1e9009c370,0,13,1,0,6,20
7208,1702,2022-10-26 07:41:00,7f30bbdf30b54e13f52f8ab08f5c61b1,0,12,0,2,1,15
7209,1702,2022-10-26 07:47:00,1a627295a01101ebe8233ccaf45e2185,0,14,0,1,3,18
7210,1702,2022-10-26 07:52:00,24cf71604a4e9216dbc1ca56fbdab8bc,0,21,0,0,1,22
7211,1702,2022-10-26 07:56:00,553c3df5414d46344e03ca6a720763e0,0,20,0,1,3,24
7212,1702,2022-10-26 08:02:00,9ef44ddee2982260d49d557705264d43,0,22,0,1,2,25
7213,1702,2022-10-26 08:07:00,56cf72ce9c7b3f8346a23e99823bbbfa,0,19,0,1,4,24
7214,1702,2022-10-26 08:12:00,2ca9febecd7e5ef4dc8c997c41d68829,1,25,0,1,2,29
7215,1702,2022-10-26 08:17:00,5d44d240092a8b864dfeaca759057226,0,20,0,3,4,27
7216,1702,2022-10-26 08:22:00,18158ac2999cf9f7dfef24ec204c5974,1,19,0,0,8,28
7217,1702,2022-10-26 08:26:00,5c70de9208d5a1a06758bdcf32c9b085,0,23,0,4,6,33
7218,1702,2022-10-26 08:33:00,4616065a4aa6d01c2a63092aeb9a503b,0,27,0,1,7,35
7219,1702,2022-10-26 08:37:00,52373eb06635d3c8d7bc258ea698bf35,0,24,0,0,13,37
7220,1702,2022-10-26 08:43:00,aea0837f95e41fe3c88fb7bd5431e289,0,21,0,1,11,33
7221,1702,2022-10-26 08:47:00,e0073a9441f50a2357c8efc13eec908d,0,21,1,3,6,31
7222,1702,2022-10-26 08:52:00,affe67f3dc169cba200539d71ea4921a,0,23,0,0,11,34
7223,1702,2022-10-26 08:57:00,1c98bff5cb865fc722cfbc209de6efcd,0,23,0,4,7,34
7224,1702,2022-10-26 09:03:00,8072a88265908c492aee93ad1272dfb4,2,19,0,1,14,36
7225,1702,2022-10-26 09:08:00,d6e7e80b7b5bb62e051ab887dc3fc5ca,0,23,0,6,9,38
7226,1702,2022-10-26 09:12:00,a29a2cc2c5c692d925bd3f3e68f68ad0,0,24,0,3,11,38
7227,1702,2022-10-26 09:17:00,159c549247c82b661c03230269c84f36,0,9,1,5,16,31
7228,1702,2022-10-26 09:22:00,a9f1e4133be6b5b341b7af79f65f48b8,1,14,0,6,12,33
7229,1702,2022-10-26 09:27:00,a86724eda60f73b1eb8839dba5bf767d,0,15,0,2,12,29
7230,1702,2022-10-26 09:32:00,8320affb712088b19d1f14ee6ea8b7b4,0,18,0,3,13,34
7231,1702,2022-10-26 09:36:00,bd2bb381da6b909442fce1257bc04b47,0,16,1,0,15,32
7232,1702,2022-10-26 09:41:00,dcb25dae78610be2c9e0f7e602ca956f,0,25,0,4,7,36
7233,1702,2022-10-26 09:47:00,5df9e783cb6121d524e9905821314ddd,0,11,0,8,6,25
7234,1702,2022-10-26 09:52:00,153dee4ed50b1c6a6a12c080d797fd91,0,14,0,3,11,28
7235,1702,2022-10-26 09:57:00,dd8a9020df2acc9c9dbb05755e936c65,1,14,0,1,4,20
7236,1702,2022-10-26 10:02:00,6690b066774d3b914812f90710f335f0,0,11,0,1,10,22
7237,1702,2022-10-26 10:07:00,55418640ee6e711e6ab27c8473d981be,0,16,0,2,11,29
7238,1702,2022-10-26 10:12:00,040832fa30607340b781e7c3c25f328b,0,12,1,1,13,27
7239,1702,2022-10-26 10:17:00,64fdc9d5f129996583c19d3ae51fc506,0,11,0,4,11,26
7240,1702,2022-10-26 10:22:00,0f40731b3e8e44b13847ec9ca2ba205c,1,13,0,5,13,32
7241,1702,2022-10-26 10:27:00,29c17d251a23e00e54d377255acce980,1,16,0,6,4,27
7242,1702,2022-10-26 10:31:00,2e00420cba0244c23b724bb95fbbd7df,0,22,0,2,7,31
7243,1702,2022-10-26 10:37:00,902da0e82db9d744c403b716aa7a4f52,0,9,0,3,13,25
7244,1702,2022-10-26 10:42:00,1755d28d96675f897353f29d32029553,2,12,0,2,9,25
7245,1702,2022-10-26 10:47:00,5528d6be1da9f42da9c049a77a0621b1,2,14,0,9,8,33
7246,1702,2022-10-26 10:52:00,c9958bb4d0ff422811d4cbcca704acfe,0,14,0,0,13,27
7247,1702,2022-10-26 10:56:00,ab70cf943788694df1274b36f0a9adbb,0,15,0,2,11,28
7248,1702,2022-10-26 11:02:00,6e59a6acde560c248ec6cac07a9031ca,1,11,0,10,5,27
7249,1702,2022-10-26 11:07:00,86726381a5e3f6003a1f573125f5f306,0,12,0,4,10,26
7250,1702,2022-10-26 11:13:00,f36a6e124804ad77c951f945ac272272,0,17,0,4,8,29
7251,1702,2022-10-26 11:17:00,62c7ea942b756698935e000654646c26,0,14,0,3,12,29
7252,1702,2022-10-26 11:22:00,a237189a32424636f9443f94f68f3467,1,11,0,0,10,22
7253,1702,2022-10-26 11:27:00,13de2258e487b9db4df82d8013f81d44,0,15,0,2,10,27
7254,1702,2022-10-26 11:31:00,68be5e6b6cf3a0e38d7146f8f74a1cc6,0,8,0,2,9,19
7255,1702,2022-10-26 11:37:00,9f413bb75c528b85095cbcd2327c2de4,0,13,0,1,9,23
7256,1702,2022-10-26 11:42:00,289d511ac928aac0ad365b61ed149757,0,13,0,1,14,28
7257,1702,2022-10-26 11:46:00,5bb11f25b8f54396ba121bc02492877d,0,10,0,3,8,21
7258,1702,2022-10-26 11:52:00,8ddbb42c1d0c45b3120bfc2e29b30428,1,11,0,6,12,30
7259,1702,2022-10-26 11:56:00,fdc1cd20a7295d5df2295e40d7bd7ce3,0,15,0,3,16,34
7260,1702,2022-10-26 12:03:00,102be09dffa7e0bd2357ad6eb2e636ff,0,9,0,4,10,23
7261,1702,2022-10-26 12:07:00,50664a0c49a253f95653139f270c9fff,0,9,0,2,11,22
7262,1702,2022-10-26 12:11:00,f4cb3a37257cacf939d24aff73871dbb,0,12,0,4,11,27
7263,1702,2022-10-26 12:17:00,8c48dde25ab9bae802f44dc35d56d734,0,13,1,1,11,26
7264,1702,2022-10-26 12:22:00,1d5b9add579fd19a8600a60f7804b47d,0,18,0,0,7,25
7265,1702,2022-10-26 12:26:00,ab379e9a807e81685cc60d457128e5aa,0,17,2,4,9,32
7266,1702,2022-10-26 12:32:00,c84e703c0e0b1bc45003bc2076bdf8cb,0,16,0,4,7,27
7267,1702,2022-10-26 12:38:00,fbac35bf2e4e76e9c3008761632a18f9,0,13,1,3,9,26
7268,1702,2022-10-26 12:42:00,d9f24e6150e1e3fb22b63308d4f63264,0,11,0,1,13,25
7269,1702,2022-10-26 12:47:00,519ad9fc2c4a8bcd0845e7a65da6b57c,0,10,0,3,12,25
7270,1702,2022-10-26 12:53:00,1ea92b1b4974c25f3491430e761a106a,0,13,0,3,8,24
7271,1702,2022-10-26 12:56:00,fc0e62326a018a0ce55d5473a9a61434,0,7,0,4,7,18
7272,1702,2022-10-26 13:03:00,775830eacbdf57de061def88701dc8fa,0,12,0,4,13,29
7273,1702,2022-10-26 13:07:00,a2790f0ca6218532a057d1b5b3e7849b,0,16,1,1,6,24
7274,1702,2022-10-26 13:13:00,1b9aa780c47d104b4ad9a8a5c246f8ca,0,15,0,2,8,25
7275,1702,2022-10-26 13:17:00,c7d6c7daaa98f0bb794859fe0e11cc90,0,10,0,4,8,22
7276,1702,2022-10-26 13:23:00,aba7048feacb09f3895af6fa7cadfce2,0,12,1,1,9,23
7277,1702,2022-10-26 13:26:00,31615b8f6340285fc7d073031063b594,0,8,0,5,8,21
7278,1702,2022-10-26 13:32:00,826e117d6444fd7226360b392f3f38e7,0,10,0,5,6,21
7279,1702,2022-10-26 13:38:00,cb8e5b7f8a2b9e116a8fac527aa60e55,0,3,1,5,13,22
7280,1702,2022-10-26 13:42:00,806a0ec7d861b6119986226a5748a7a5,0,14,0,3,13,30
7281,1702,2022-10-26 13:47:00,621b931ade35aeaa3f74bb6de44f0004,0,12,0,2,11,25
7282,1702,2022-10-26 13:53:00,f5af36df27ae569b4c452e87a97d7712,0,10,0,3,16,29
7283,1702,2022-10-26 13:56:00,e4aeff8478619dbec8d0f17ad9b807e6,0,10,1,2,18,31
7284,1702,2022-10-26 14:02:00,3302de98ee0fb4c0043c7ffc976109dd,0,7,0,4,17,28
7285,1702,2022-10-26 14:07:00,c68678abf8a6e771002d427a19e77395,0,18,0,1,13,32
7286,1702,2022-10-26 14:12:00,da389026d93c80616a146d429cc5ce35,0,12,0,2,14,28
7287,1702,2022-10-26 14:17:00,d10986c3c17339ddcb81a5e0369032c3,0,10,0,5,10,25
7288,1702,2022-10-26 14:23:00,40779b8ce2d6226951d0a64ecdc21ca5,0,17,0,5,9,31
7289,1702,2022-10-26 14:27:00,df9010ddb225a9a70e11ad479fc63d4c,0,15,0,2,16,33
7290,1702,2022-10-26 14:32:00,f6e799cf2aa5fe14fe63319f62120860,0,4,0,3,17,24
7291,1702,2022-10-26 14:37:00,b4b256d89496f2d679352a2cb1a52db5,0,18,0,1,11,30
7292,1702,2022-10-26 14:41:00,0f4564118d1db1db5169fc5a1014fdf5,0,11,0,4,6,21
7293,1702,2022-10-26 14:48:00,5fed89707dace56d900fe4be9ce8247b,0,13,0,2,11,26
7294,1702,2022-10-26 14:52:00,ab35e8933c10ed39cfebaa53da28d31d,0,12,0,8,7,27
7295,1702,2022-10-26 14:56:00,5e7a041ec44e52f9ad936c5d8481d13a,1,11,0,0,12,24
7296,1702,2022-10-26 15:03:00,4fd4f1a85cfe55e311af9b28643ab8ff,0,14,0,2,7,23
7297,1702,2022-10-26 15:06:00,08b4553d346d5d36db07f9c1ad304ad6,0,9,0,1,14,24
7298,1702,2022-10-26 15:11:00,020c1df404f49555007389a5c1ff2ba5,0,9,0,3,11,23
7299,1702,2022-10-26 15:17:00,7ccdd0e40be69d2c889cbb9f4d405bfd,0,14,0,1,8,23
7300,1702,2022-10-26 15:22:00,d752e88412728901d7cbf1cfa2f9530f,0,10,0,1,4,15
7301,1702,2022-10-26 15:26:00,2e9ab02eac42d351bcdbee29710ca229,1,16,0,4,8,29
7302,1702,2022-10-26 15:32:00,d1f14ef9fcde3443326a6953701f0bfa,0,14,0,1,6,21
7303,1702,2022-10-26 15:37:00,0501528bc2b850c0756dc6bebbe3c58a,0,9,0,2,11,22
7304,1702,2022-10-26 15:41:00,d533dc37cec93ac8ebae04be4a1534cf,0,10,0,0,10,20
7305,1702,2022-10-26 15:47:00,b1aa8fa6870722f00f6d49306e633907,0,10,0,2,8,20
7306,1702,2022-10-26 15:52:00,b5fe98518636d2c14ee2f7901d160e40,0,12,0,1,11,24
7307,1702,2022-10-26 15:56:00,32c7a15c47f4d848c999cca45381d04b,1,16,1,0,13,31
7308,1702,2022-10-26 16:02:00,314f1b462c17afb73c9a5a76d051fae8,1,12,0,4,9,26
7309,1702,2022-10-26 16:08:00,bd83d6c3dbfc387e9b2b1efd09fe0c4a,1,13,0,1,7,22
7310,1702,2022-10-26 16:12:00,287548105b46c42a84f0ce9a16f894d8,0,16,0,1,9,26
7311,1702,2022-10-26 16:17:00,0c686d06d8f231cd35463029fc36489a,0,22,0,3,5,30
7312,1702,2022-10-26 16:22:00,0d9f8408202d0ad00b9f7178c65e16f1,0,23,0,1,13,37
7313,1702,2022-10-26 16:27:00,ad1cb2e85bdccfeda41f50a33fe623f8,1,12,0,3,10,26
7314,1702,2022-10-26 16:32:00,0dccfdd0dffc210ecf32dc2747af462e,0,19,0,1,12,32
7315,1702,2022-10-26 16:37:00,5eb0524809e2961b4850888f87c0eed7,2,10,1,0,18,31
7316,1702,2022-10-26 16:42:00,51553170f849c8e4fb8f9b2f0c52c665,1,11,0,1,10,23
7317,1702,2022-10-26 16:47:00,974cd87389bddc7c1204168edcf7bfb8,1,19,0,2,13,35
7318,1702,2022-10-26 16:52:00,8de3418040c95b7de3b0f428cfe2b7e7,0,17,0,8,5,30
7319,1702,2022-10-26 16:57:00,79d2fddc4422481eeeda3be0ccd490ff,0,17,1,3,16,37
7320,1702,2022-10-26 17:02:00,d05a170f98561cd721f424a0ef30e92e,0,14,0,4,6,24
7321,1702,2022-10-26 17:07:00,291dd649bdb596b6c2e5e9862f96c6ee,0,13,0,1,14,28
7322,1702,2022-10-26 17:12:00,02dd81e93eb788a9f85e251b458af6d4,0,14,0,1,9,24
7323,1702,2022-10-26 17:17:00,6c1ee198e42b2fbbb5747cdc81346c25,0,16,0,0,9,25
7324,1702,2022-10-26 17:21:00,8d4c8770248a597104b9b434b5d32f81,0,16,1,2,13,32
7325,1702,2022-10-26 17:26:00,c9315e24c13b4e6767b0db6c59eab876,0,16,0,2,7,25
7326,1702,2022-10-26 17:32:00,2131c945e86dc28f46c52d758dd7276c,0,21,0,5,4,30
7327,1702,2022-10-26 17:38:00,084b8458f22a027f5430ef4023d25546,0,20,0,5,12,37
7328,1702,2022-10-26 17:42:00,c8c70865bd19f40d96fc46f651fcf61d,0,18,0,2,9,29
7329,1702,2022-10-26 17:47:00,41bcf073a937620218ddb1aed06f5b40,0,18,1,1,12,32
7330,1702,2022-10-26 17:52:00,8da77b660c3fa6cc301c03510edd1400,0,15,1,7,8,31
7331,1702,2022-10-26 17:57:00,aaa101dd50d20449dbc5a7fcd179fab1,0,13,1,4,12,30
7332,1702,2022-10-26 18:02:00,930c84e7eaccbc23bfee67de1cc94235,0,13,0,7,11,31
7333,1702,2022-10-26 18:08:00,378a3bdffc0d1d45964d0e273ed58b9a,0,15,0,4,13,32
7334,1702,2022-10-26 18:12:00,cd1123b36daac68761e90b617d0ef07a,0,17,0,2,6,25
7335,1702,2022-10-26 18:17:00,fe1cf26b9f009f3ce06c7e89e6f28ec7,0,16,0,3,13,32
7336,1702,2022-10-26 18:22:00,145f3b99b5fe08a68aedf347620b74ca,0,33,0,4,10,47
7337,1702,2022-10-26 18:27:00,f1dfbd35b7ff6901ec418e2a59e271d5,1,12,0,1,13,27
7338,1702,2022-10-26 18:32:00,3bcf362da37fe23190aa2e142f978581,0,18,1,2,12,33
7339,1702,2022-10-26 18:37:00,5603af9bfcd3230e97c7620b30e2a3ac,1,20,0,3,14,38
7340,1702,2022-10-26 18:42:00,0a5700a85eb7961b967e7ab49e6b74a7,0,18,0,2,10,30
7341,1702,2022-10-26 18:47:00,12002b01ce60b7b1b63da35d6f036766,0,11,1,3,17,32
7342,1702,2022-10-26 18:53:00,a35eced5f22c5053915f3c06fa58bbe1,0,14,0,1,6,21
7343,1702,2022-10-26 18:57:00,408803d71283b99179c23f0768e423eb,2,23,2,1,6,34
7344,1702,2022-10-26 19:03:00,99cbce7f4c429552712db71f53eb8cdb,0,22,0,3,2,27
7345,1702,2022-10-26 19:07:00,fe3639f934d25d3603bf0f77911143db,0,24,4,0,1,29
7346,1702,2022-10-26 19:12:00,fd0483b573649a5ae22a0900dd63137c,0,16,0,3,0,19
7347,1702,2022-10-26 19:16:00,2bf659c0fe864ec404f3424e148ec669,0,14,0,2,1,17
7348,1702,2022-10-26 19:22:00,d408c26c5d216f50ccc014381b2c7db9,0,20,2,0,2,24
7349,1702,2022-10-26 19:26:00,aa8841ea5521e1148fa379830dbdc86f,0,20,1,0,1,22
7350,1702,2022-10-26 19:32:00,2d06cacead5a01abcf1290b4157d4cfd,0,17,0,0,2,19
7351,1702,2022-10-26 19:37:00,3cd390a0f3776b87d744d2bfbfd69870,0,16,4,1,0,21
7352,1702,2022-10-26 19:41:00,cca26070c7507dfa8aa04101c5650c08,0,23,2,0,1,26
7353,1702,2022-10-26 19:46:00,24e90cae1fb78cb634622d6772e07689,0,21,1,0,0,22
7354,1702,2022-10-26 19:52:00,1806ceaae18fd340b3206c72aefd4709,0,19,0,1,1,21
7355,1702,2022-10-26 19:56:00,7568cb96e047ee1f9f3308f0edab1cc5,0,16,0,0,1,17
7356,1702,2022-10-26 20:02:00,2341432c14428a8d62a0864994cce96e,0,15,0,0,1,16
7357,1702,2022-10-26 20:07:00,18ea9ff4abc678e869877e610edcdf59,0,16,0,1,2,19
7358,1702,2022-10-26 20:11:00,9f9be7f2add7a8a8c2be10e0534ebb5f,0,16,1,2,1,20
7359,1702,2022-10-26 20:16:00,66097da30b6dde76af94dee32cb8d4c0,0,12,0,1,0,13
7360,1702,2022-10-26 20:22:00,02541fc11398a911219cdfefbf5707a4,0,14,0,1,2,17
7361,1702,2022-10-26 20:26:00,741a2d9507c0bfeb7f4f1e33cfc04ee8,0,9,1,0,0,10
7362,1702,2022-10-26 20:31:00,f7f2358cc291a4a7cb13c7d5a91cd12c,0,21,1,1,1,24
7363,1702,2022-10-26 20:37:00,da384c7c585697fa60b900782954248e,0,15,2,0,1,18
7364,1702,2022-10-26 20:42:00,e52e76cb9d7009e2ee7735e2a4cf9cc4,0,17,2,0,1,20
7365,1702,2022-10-26 20:47:00,5bdbdc6b5e3db246b5e9580b8a0d733f,0,12,1,1,1,15
7366,1702,2022-10-26 20:53:00,759ed3ecb5e471a10911e5965ef076ed,0,17,0,1,0,18
7367,1702,2022-10-26 20:57:00,f60610c9c442a3dff5a4500f5a4cc2ca,0,13,0,1,1,15
7368,1702,2022-10-26 21:03:00,97c04ecf2810da1491fb055dc27fc621,0,11,0,1,0,12
7369,1702,2022-10-26 21:07:00,1e980b385d12dec4da0a7eda677d5bb7,0,6,3,0,2,11
7370,1702,2022-10-26 21:11:00,7022ae92fdc428501f07eec463231686,0,12,1,0,2,15
7371,1702,2022-10-26 21:16:00,0292ff15d20d5ce511d49d381a389efa,0,21,0,0,0,21
7372,1702,2022-10-26 21:22:00,14e33a9c7534667b038c71b9c5914e58,0,17,0,1,3,21
7373,1702,2022-10-26 21:27:00,ef9df9799131f86666a58299351b9cc7,0,17,0,0,0,17
7374,1702,2022-10-26 21:32:00,54e54d6664dd9a866ff1dabc81b10391,0,17,0,0,0,17
7375,1702,2022-10-26 21:36:00,46b39a08299e685868096ed796161e5c,0,27,0,0,0,27
7376,1702,2022-10-26 21:41:00,0f086d9e3ebd7ce8ae627d8f463161c6,0,21,0,0,0,21
7377,1702,2022-10-26 21:47:00,e9e586e9575e147bacf2d4a1b5b075d4,0,24,0,0,0,24
7378,1702,2022-10-26 21:52:00,53024d97aa51be56efb6491ffd1b6256,0,17,0,0,2,19
7379,1702,2022-10-26 21:56:00,935b317933739a8e1d51cd6d224dbaf3,0,11,0,0,1,12
7380,1702,2022-10-26 22:02:00,4ecd04d51b400e58b2dcd792c76f3365,0,11,0,1,2,14
7381,1702,2022-10-26 22:07:00,7c81197f527d1d3b4e74903182b916d6,0,10,0,1,0,11
7382,1702,2022-10-26 22:11:00,7bd2e866122cdec3165c1cd6b8ced8c9,0,14,1,0,2,17
7383,1702,2022-10-26 22:17:00,6d43e018bccb1795e6b9f53d97e11e53,0,15,1,2,1,19
7384,1702,2022-10-26 22:21:00,f0279fc9067e0b04915122b676bfa00c,0,14,1,2,2,19
7385,1702,2022-10-26 22:26:00,b19810c28362576b90cce66598fe5d0f,0,17,0,0,0,17
7386,1702,2022-10-26 22:32:00,8db65feb72a9b97016bea7fda8df4dd9,0,13,0,1,1,15
7387,1702,2022-10-26 22:37:00,029c1e21ab51c69f27e81225421680ad,0,21,0,1,0,22
7388,1702,2022-10-26 22:41:00,f38be0217c10ac650e0dc5bcdfa8bef6,0,15,1,0,0,16
7389,1702,2022-10-26 22:48:00,8ca4cf9a9b2f9f2cd767cf611c53b06f,0,10,0,0,0,10
7390,1702,2022-10-26 22:51:00,fa8d3ca067146a4ca6b0c9b5f6420dc7,0,7,0,0,0,7
7391,1702,2022-10-26 22:57:00,091ecd9dc2104f686dfca15ab0799f45,1,10,0,0,1,12
7392,1702,2022-10-26 23:01:00,fac737700f7894a23458f47c4cb27856,0,9,0,1,0,10
7393,1702,2022-10-26 23:07:00,3345d23a245e362f00f10637005a6a29,0,9,2,1,0,12
7394,1702,2022-10-26 23:11:00,0ae4a82949032ac9ae8d5e6f249a1dac,0,13,0,0,1,14
7395,1702,2022-10-26 23:16:00,28e432d1c56e26cdea65ad940fea8385,0,7,2,1,0,10
7396,1702,2022-10-26 23:21:00,9dcdea70b5f42fb4c642ee706ab732f0,0,8,0,0,0,8
7397,1702,2022-10-26 23:26:00,289e54172993b584e190e802ab5c4efe,0,12,0,0,0,12
7398,1702,2022-10-26 23:31:00,68d9fbd3b5a1b9815ef04c9a198f5553,0,11,0,0,1,12
7399,1702,2022-10-26 23:38:00,c0cb2310f51937810f0ec7aadebbdba1,0,10,0,0,2,12
7400,1702,2022-10-26 23:41:00,4fb6ab2d0298b7f70a74719772b24557,0,7,0,0,1,8
7401,1702,2022-10-26 23:46:00,b638cce1424b51179b59f44dd6042cf6,0,13,0,0,0,13
7402,1702,2022-10-26 23:53:00,6ff7d4927c96ca809f7943a61395dec5,0,4,0,0,0,4
7403,1702,2022-10-26 23:56:00,a1e7198da3b9da2d7f38567c924d498c,0,4,0,0,0,4
7404,1702,2022-10-27 00:02:00,127e71d8a2e906ed1ce0946aa09be445,0,7,0,1,0,8
7405,1702,2022-10-27 00:06:00,38db3b12981bbd31f9c3562c87e79f18,0,12,1,0,1,14
7406,1702,2022-10-27 00:12:00,83a8032a6a0dcdfb65d02925aa8b1e4d,0,8,0,1,0,9
7407,1702,2022-10-27 00:17:00,917cd0de5f101eb5d2f4b9986b8b33a5,0,11,0,0,0,11
7408,1702,2022-10-27 00:21:00,01e12973e4cffa36d857f0ce0d0a2566,0,8,0,0,0,8
7409,1702,2022-10-27 00:27:00,f494146a48977cfe3b411c040e9795f9,0,2,0,0,0,2
7410,1702,2022-10-27 00:31:00,1f0d6d01536c8acb5f4f38504ab116aa,0,6,0,2,1,9
7411,1702,2022-10-27 00:37:00,57466c96a2ea01dba5e0740014c7ae71,0,8,0,0,0,8
7412,1702,2022-10-27 00:41:00,0a214fa87914143d94dc7fc13cb7d876,0,13,0,0,0,13
7413,1702,2022-10-27 00:47:00,361bc74d2a427690c4d5378a2e9cccf9,0,12,0,0,0,12
7414,1702,2022-10-27 00:51:00,d8614ec329b66552f53bbde2bbdfafac,0,7,0,0,0,7
7415,1702,2022-10-27 00:57:00,4ca78a630853b5b2e6fef641d9c1fcfe,0,11,0,0,1,12
7416,1702,2022-10-27 01:02:00,0fc60bf4088176f02367dbadee7f973d,0,10,0,0,0,10
7417,1702,2022-10-27 01:17:00,3ba12cce7761368f5a4d9a437e892e13,0,8,0,0,1,9
7418,1702,2022-10-27 01:21:00,22d9cebd8a72d45c9151737302267410,0,6,1,0,0,7
7419,1702,2022-10-27 01:27:00,87a2e011eb8a4918c46627f69bf28f3d,0,12,0,0,1,13
7420,1702,2022-10-27 01:33:00,37b0401f7eb481eccd7a866a6f9777e0,0,9,0,0,0,9
7421,1702,2022-10-27 01:37:00,852f68bc3a0bab89525edc09312bf326,0,7,0,0,0,7
7422,1702,2022-10-27 01:41:00,ae0c8f118beb6758d84ea6d62b5fc099,0,9,0,0,0,9
7423,1702,2022-10-27 01:47:00,e9aaa897095607b146cead64482fc983,0,9,0,0,0,9
7424,1702,2022-10-27 01:51:00,2c857ba16142f3b3a3ea512c201bf541,0,4,0,2,1,7
7425,1702,2022-10-27 01:57:00,75742d8fbd1a1a57b2bfff51a22cbeb6,0,3,0,1,0,4
7426,1702,2022-10-27 02:02:00,b27ccf29fdbc1765a96267cf2679c2bb,0,2,0,0,0,2
7427,1702,2022-10-27 02:08:00,b04fcab42cd750c6a20aaef24acc26bc,0,4,0,0,0,4
7428,1702,2022-10-27 02:11:00,0722ececb40cb2d77ef24cc7960fd85a,0,1,0,0,0,1
7429,1702,2022-10-27 02:16:00,0a4a5b5cb9c699fab53ddc4322eb96a0,0,0,0,0,0,0
7430,1702,2022-10-27 02:21:00,312a5bbf8a874a92a5c986e98f361905,0,1,0,0,0,1
7431,1702,2022-10-27 02:27:00,73568aa044cefb3ebb08e5c9bcd2cea8,0,0,1,0,0,1
7432,1702,2022-10-27 02:32:00,117f5572bcbf8d1b7a1bb853cb2b4e5b,0,2,0,0,1,3
7433,1702,2022-10-27 02:37:00,f755a07698540b2a3f403e1abce77856,0,0,0,0,0,0
7434,1702,2022-10-27 02:42:00,a0c499e1771b7d393420fbf3ec030b56,0,6,0,0,0,6
7435,1702,2022-10-27 02:47:00,ce1c99faa0983bdd65eec73b32c03dd2,0,5,0,0,0,5
7436,1702,2022-10-27 02:52:00,75b9688a3ec2b24bc026511886528a4c,0,1,0,0,0,1
7437,1702,2022-10-27 02:57:00,6b7000ee0647dac61b9cf7d9d005c93f,0,6,0,0,0,6
7438,1702,2022-10-27 03:02:00,448223677a4e7c580b82718b4aac8151,0,1,0,0,0,1
7439,1702,2022-10-27 03:07:00,ba7f313a74632436a60eac7d6998a1c2,0,0,0,0,0,0
7440,1702,2022-10-27 03:11:00,67d0d0c9a703628e944154aa0405f473,0,0,0,1,1,2
7441,1702,2022-10-27 03:17:00,a181de345d086d1e886a3d8b1c1ed73b,0,3,0,0,0,3
7442,1702,2022-10-27 03:22:00,23e46641a026705d4a369e8e5221a5aa,0,3,0,0,0,3
7443,1702,2022-10-27 03:27:00,02bc8b5448b87e034fe064e9097adfd7,0,5,0,0,2,7
7444,1702,2022-10-27 03:32:00,d0a393ce591eabd6e5926028cf0e46bd,0,3,0,0,1,4
7445,1702,2022-10-27 03:37:00,acff81545589489832dfef29292a5571,0,8,0,0,1,9
7446,1702,2022-10-27 03:41:00,a3fac3a26b5e02f11bcb6e953a1196de,0,4,1,0,0,5
7447,1702,2022-10-27 03:47:00,15315df199645fe99ce01ada998e7825,0,0,0,0,0,0
7448,1702,2022-10-27 03:52:00,348b8264af9c2514ee16a501fd4e842e,0,0,3,0,0,3
7449,1702,2022-10-27 03:57:00,447b70af66e84decf6dbc1e1d0f8848c,0,1,0,0,1,2
7450,1702,2022-10-27 04:02:00,8f725d70af4a6db86c11d27fa19aaf85,0,3,0,0,0,3
7451,1702,2022-10-27 04:07:00,6ecb12b33c66b133ce607cf5cfb18e0c,0,1,0,0,0,1
7452,1702,2022-10-27 04:12:00,4b45d3e488e8efbc5a9f590ba00b9b9c,0,0,0,0,0,0
7453,1702,2022-10-27 04:17:00,068f6e2af72a8d0566c9def9f337b282,0,2,0,0,0,2
7454,1702,2022-10-27 04:22:00,85938c8ed6c834b6a61dabcd8bd8b6c5,0,2,0,0,0,2
7455,1702,2022-10-27 04:26:00,419c6fa2bd565ee903a47ea052404be2,0,2,0,0,0,2
7456,1702,2022-10-27 04:32:00,06655b711c6f33074c55005f0f4bdde6,0,2,0,0,0,2
7457,1702,2022-10-27 04:36:00,1206951741128b7385887da5e4ebae18,0,2,0,1,0,3
7458,1702,2022-10-27 04:41:00,52b2c008580b5700d0136570e9d4aeb1,0,4,0,0,1,5
7459,1702,2022-10-27 04:47:00,5c778a8382302025b809b540279902fe,0,2,0,0,0,2
7460,1702,2022-10-27 04:51:00,027a65e9884663794d44c364ea6a1b46,0,3,0,0,0,3
7461,1702,2022-10-27 04:56:00,c87af8da7af7c3a843486194f002f8f8,0,0,0,0,0,0
7462,1702,2022-10-27 05:02:00,ea37bf8724a40af656284963134479fd,0,1,1,0,0,2
7463,1702,2022-10-27 05:07:00,05d8309c55d1ced5069d545e170cfab7,0,5,0,0,1,6
7464,1702,2022-10-27 05:11:00,ae3dadb7fc475d7ca7570ab32ba6e1d3,0,4,0,0,0,4
7465,1702,2022-10-27 05:17:00,8aca8af682517cffbb3c0ca188f9ccdc,0,0,0,2,0,2
7466,1702,2022-10-27 05:21:00,20ec010fa415c3f9e0fd8e7126561877,0,3,0,0,0,3
7467,1702,2022-10-27 05:26:00,673b987f3dcb2e7d58ed58b534f5547f,0,2,0,1,1,4
7468,1702,2022-10-27 05:31:00,b824ca02df957c439825cb0589ee3b6d,0,2,0,0,0,2
7469,1702,2022-10-27 05:37:00,e583ed716bcbe22b2f3ebb8ff073fd9a,0,3,0,0,0,3
7470,1702,2022-10-27 05:41:00,a3284ae24bcec3640c817eb6a067cc83,0,6,0,2,1,9
7471,1702,2022-10-27 05:46:00,3dbba6f3d56598d4362b0231aabb6a85,0,0,0,0,0,0
7472,1702,2022-10-27 05:51:00,39e56f6d58952a8cffc98059a2a9549a,0,2,0,1,0,3
7473,1702,2022-10-27 05:56:00,65f9c112ab01670a62da71923a393661,0,1,0,1,1,3
7474,1702,2022-10-27 06:02:00,6981c08b7f669b344ee5da4caa05b3bf,0,0,0,1,0,1
7475,1702,2022-10-27 06:06:00,e8a902fc2ddc144a85bae6ce8fac79d3,0,6,0,0,1,7
7476,1702,2022-10-27 06:11:00,abc0c99dad281c7464bee6873a124a43,0,4,1,0,0,5
7477,1702,2022-10-27 06:17:00,136a3c2a3393d837cef54edee6376003,0,5,0,1,0,6
7478,1702,2022-10-27 06:21:00,9953909d103758e13de9ec1f559c8841,0,3,1,0,1,5
7479,1702,2022-10-27 06:26:00,b4224401c1e026b2f68a197af6954039,0,7,0,1,2,10
7480,1702,2022-10-27 06:31:00,37885e358c125d65b520e3dc0af00972,0,15,0,0,1,16
7481,1702,2022-10-27 06:37:00,50d7bac2c1aba984cab1a5213c423776,0,12,2,2,0,16
7482,1702,2022-10-27 06:42:00,141ff01cf9e112d8190e9b88073374b9,0,21,0,0,1,22
7483,1702,2022-10-27 06:47:00,d5f574b552b9a5215c5bb11919e13a55,0,17,0,2,4,23
7484,1702,2022-10-27 06:52:00,2daa4532c875367b11057ad1da3569f9,0,15,0,2,5,22
7485,1702,2022-10-27 06:56:00,cd060cfa02c6394d85fa01f6e88959a9,0,20,1,1,5,27
7486,1702,2022-10-27 07:02:00,0ddc34b3db714a034c47e51d1d973094,0,21,0,1,5,27
7487,1702,2022-10-27 07:07:00,02e3747b7c6cc896c60dcea9209c8e48,0,13,0,1,8,22
7488,1702,2022-10-27 07:12:00,98916b86f3416ef0c3da898decd5ac9b,0,12,0,2,12,26
7489,1702,2022-10-27 07:17:00,e1b1fd270220f575a6eb6c14cebf209b,1,11,0,1,14,27
7490,1702,2022-10-27 07:22:00,3812187756abb491b02f2979db4b8b1d,0,12,0,4,7,23
7491,1702,2022-10-27 07:26:00,bef9a9a98506b032a7d75b59e66dff7b,0,11,0,1,11,23
7492,1702,2022-10-27 07:32:00,06b41d7be6ab7a2162b9cdb828259976,1,11,0,1,14,27
7493,1702,2022-10-27 07:37:00,07121f00c1fee00bc6e3f9b88da49fff,1,11,0,4,9,25
7494,1702,2022-10-27 07:42:00,7e381a7cf8de8f1ab4ac39bef313072a,1,21,0,4,4,30
7495,1702,2022-10-27 07:47:00,9d226c45c9f78ed46d12a33c6c4a5b88,0,19,0,0,7,26
7496,1702,2022-10-27 07:52:00,c8f860cd5571aa1b2ed75cdd52494638,0,14,0,2,15,31
7497,1702,2022-10-27 07:56:00,b12996ef805727c57ac30a3a63588d45,0,13,0,1,12,26
7498,1702,2022-10-27 08:02:00,1ce2a8f3ea4e794046c3911f8b1520d4,0,18,2,5,6,31
7499,1702,2022-10-27 08:07:00,e58e516b45c5fa99fef5040545942769,0,19,0,1,9,29
7500,1702,2022-10-27 08:11:00,ea3b3ac8e05455dfc9c34f66eb248388,0,14,0,1,6,21
7501,1702,2022-10-27 08:17:00,09a2631d73798df6f92085ff56efd3de,0,17,0,1,7,25
7502,1702,2022-10-27 08:23:00,b3c466a26b9a5508feed84e43e1b3324,0,16,0,1,12,29
7503,1702,2022-10-27 08:27:00,f64dc639ab420be8fcc8ceba168a162c,0,18,0,1,3,22
7504,1702,2022-10-27 08:33:00,4a3aa92d7240cccafaa0c7c7ad6e80c4,0,20,0,2,5,27
7505,1702,2022-10-27 08:38:00,71ab1577bf1009b48f12a2eb8099e3a5,1,17,1,3,6,28
7506,1702,2022-10-27 08:42:00,215f87b49424649953376cdcd70e2a5a,0,16,0,1,7,24
7507,1702,2022-10-27 08:47:00,10ae76575c88966cb9c97067a81829d7,0,14,0,2,8,24
7508,1702,2022-10-27 08:52:00,5b1b21569ba339682b87afbf84e824b1,0,22,1,1,3,27
7509,1702,2022-10-27 08:57:00,b320bcb6db6190111a5b95606c5796ec,0,13,0,0,11,24
7510,1702,2022-10-27 09:03:00,e1e980572f7bbb44fd0193991ed82589,1,6,0,1,9,17
7511,1702,2022-10-27 09:07:00,e6d637ce25adf8bab6b37079bab2caa4,0,13,0,1,9,23
7512,1702,2022-10-27 09:12:00,254d569318cec50479f9424d639ac2fa,0,12,0,1,8,21
7513,1702,2022-10-27 09:17:00,cc28e28945d5d1086a62122ef8817c80,0,5,1,2,12,20
7514,1702,2022-10-27 09:23:00,745553e5e2c09ddeae6cde1e95b743e6,0,13,0,2,10,25
7515,1702,2022-10-27 09:27:00,596c91bb68ff8234a6fed4a3a25bc15a,1,10,0,2,9,22
7516,1702,2022-10-27 09:32:00,0a6d195befe99255b1e2169450e57a76,0,12,0,1,13,26
7517,1702,2022-10-27 09:38:00,c11c0e6e6dd85dd2f270a3a873896029,0,15,0,4,11,30
7518,1702,2022-10-27 09:42:00,56e271111001b721a3eeb5529b56c59f,0,11,0,3,9,23
7519,1702,2022-10-27 09:47:00,8c3040698dd897c4b244477da7f9f0a5,0,16,0,1,12,29
7520,1702,2022-10-27 09:53:00,44d494519145544a12c58c61ad2548d9,0,11,0,1,6,18
7521,1702,2022-10-27 09:58:00,2c96a7ad130a9993152c325e7836caa8,0,21,0,0,6,27
7522,1702,2022-10-27 10:03:00,42d541a433af6db3e98abd6edcfafb6a,0,7,0,6,5,18
7523,1702,2022-10-27 10:08:00,21d5fa7e4e4295fe0cdcaebe1d45deb4,0,11,0,1,10,22
7524,1702,2022-10-27 10:12:00,d01f713900ed3cee4968bb9da59e4082,0,13,0,1,9,23
7525,1702,2022-10-27 10:17:00,7d3fcc957ec2dd986c9a28db9c889bb1,0,18,0,1,8,27
7526,1702,2022-10-27 10:24:00,04792a32f8bddf6d947da78860f8c059,0,13,1,1,12,27
7527,1702,2022-10-27 10:28:00,bbf34422594340c10c174d6b6678c3f7,0,9,0,0,9,18
7528,1702,2022-10-27 10:33:00,667c8b58d39d172ca4fa8fd2b6d5551a,0,10,2,3,10,25
7529,1702,2022-10-27 10:39:00,9695420042a0bffe7ace9ef1db6675e5,0,12,0,3,9,24
7530,1702,2022-10-27 10:43:00,cbb7cbb24b4a20ab0ee56fc43827aa5c,0,13,0,1,8,22
7531,1702,2022-10-27 10:47:00,a47fc38ed934c469aec47edc6d81e522,0,13,0,3,8,24
7532,1702,2022-10-27 10:53:00,772d56742510d787db440fc70056cc1c,0,18,0,6,1,25
7533,1702,2022-10-27 10:59:00,1ef8407f345147d4928933ace4105880,0,15,0,1,8,24
7534,1702,2022-10-27 11:03:00,3b3e9df94b1407bd33080680ed445f9d,0,14,1,3,10,28
7535,1702,2022-10-27 11:08:00,8b3ab033a44571f2125f1b093329a22d,1,15,0,0,13,29
7536,1702,2022-10-27 11:12:00,4fabaf14588884a95154229d73ca2cf7,1,7,0,0,11,19
7537,1702,2022-10-27 11:17:00,4516930fc48d3a197eb4886a1fa94411,0,12,0,2,5,19
7538,1702,2022-10-27 11:22:00,14696e2af14a15f77a48112d7a1aa911,0,17,0,4,8,29
7539,1702,2022-10-27 11:27:00,1beee82bfd3f21cb218161c115d189e5,0,16,1,2,1,20
7540,1702,2022-10-27 11:33:00,a0dabbbf769fca5feee784bba8585bbe,0,12,0,3,9,24
7541,1702,2022-10-27 11:37:00,efca7ef8dbf6c9eb9f745a4cf34df96d,0,17,0,4,3,24
7542,1702,2022-10-27 11:42:00,3ddd98b9280c4c54ca3637e38f1bf064,0,19,0,5,5,29
7543,1702,2022-10-27 11:48:00,8cd719400873ac86885433bb50ee0f28,0,17,0,4,5,26
7544,1702,2022-10-27 11:53:00,036f8a8e6d88c1c28f73b9f95228f6fa,0,13,0,1,11,25
7545,1702,2022-10-27 11:58:00,3cf9f018472fc06e953eb1ace946011b,0,11,0,6,5,22
7546,1702,2022-10-27 12:03:00,0d0adff6e6fc41f41781877a9ce8c077,0,15,0,5,4,24
7547,1702,2022-10-27 12:07:00,f04117f0acd7aa85fb6a1d5c1086c9fe,0,10,0,8,12,30
7548,1702,2022-10-27 12:12:00,04d58e0d83eb91f7f334537edcd4b5bb,0,19,0,5,4,28
7549,1702,2022-10-27 12:18:00,1363b4a6ad74483abcde0c6138126483,0,13,0,7,5,25
7550,1702,2022-10-27 12:23:00,2bcdb88579c7ba15a5b1d2e93f619512,0,14,0,3,7,24
7551,1702,2022-10-27 12:27:00,1034d4dfded33d0f46f529b91f8ba86d,0,13,0,3,2,18
7552,1702,2022-10-27 12:32:00,0987fb5596406f786d809d685306afaa,0,9,0,4,4,17
7553,1702,2022-10-27 12:38:00,723f42749fffc4e92cbb1f40bdef21e7,1,17,0,5,3,26
7554,1702,2022-10-27 12:43:00,ca75de5decd513b09c055312a978d07e,0,14,0,3,5,22
7555,1702,2022-10-27 12:48:00,33d42712a9dae1ea9a3a754a7ab3b191,0,14,0,3,4,21
7556,1702,2022-10-27 12:53:00,8d4f120450071cea16b84ea985a7449b,0,19,0,6,5,30
7557,1702,2022-10-27 12:57:00,94be131d80df7407e3dade1d48f07adb,0,17,0,3,1,21
7558,1702,2022-10-27 13:04:00,fdde169e93bc4d3aa1b0a81bca0430a9,0,20,1,3,3,27
7559,1702,2022-10-27 13:07:00,994ab0aed6ca3c56f6a286cd0d2284af,0,13,0,5,3,21
7560,1702,2022-10-27 13:12:00,eaa84ed74899a776ad0807b7be8ed77b,0,20,0,1,4,25
7561,1702,2022-10-27 13:18:00,3c4db57ed2028d955ded5dfaf882a624,0,13,0,3,4,20
7562,1702,2022-10-27 13:23:00,98b21b7a1d4057210a047bae9a4290d4,0,12,0,5,6,23
7563,1702,2022-10-27 13:27:00,c636b7c955f2d0a92a882599ecdc080b,0,17,0,4,5,26
7564,1702,2022-10-27 13:33:00,a1f9d9d242d532ff9924472b57ff8a7d,0,17,0,4,2,23
7565,1702,2022-10-27 13:38:00,83f5dd6c97ea6cbb9592217c476a3d26,0,24,0,6,3,33
7566,1702,2022-10-27 13:43:00,cb377e640b95934c531b8886f34b4634,0,14,0,9,9,32
7567,1702,2022-10-27 13:48:00,aea88bea91633aca02b2c1cbc57677ad,0,16,1,8,6,31
7568,1702,2022-10-27 13:53:00,75018cd2f8da4f69602b8c5ce256a9dd,0,11,0,5,11,27
7569,1702,2022-10-27 13:59:00,6dfc219907cc026371ae26f00b6a7fa6,2,19,0,4,5,30
7570,1702,2022-10-27 14:03:00,13abaa0a7afb3365ae48f22946596947,0,20,0,1,5,26
7571,1702,2022-10-27 14:09:00,b59db433efe8f338aed460aa90568a45,0,19,0,0,12,31
7572,1702,2022-10-27 14:13:00,7e4200b5e14d267f97544a21cfbe6dcc,0,9,0,4,6,19
7573,1702,2022-10-27 14:18:00,e1189afa03060d480421104c1fdeb8b9,0,15,0,1,7,23
7574,1702,2022-10-27 14:23:00,0f0b1bfeac8cf2d48a72e1ca89ae5c08,0,21,1,1,10,33
7575,1702,2022-10-27 14:27:00,63b4e9640fd1349af8d0421896a483c0,2,18,0,2,5,27
7576,1702,2022-10-27 14:33:00,52497f86ad189a50e06fd7322d4e5428,0,13,0,9,7,29
7577,1702,2022-10-27 14:37:00,8f46be5903a0f6cab5b681dba9a67a5d,1,12,0,6,6,25
7578,1702,2022-10-27 14:43:00,e71eecca62b728e1df14730d8b13292c,0,13,0,4,9,26
7579,1702,2022-10-27 14:47:00,32186fd9907497a5fdfbbcc16b4c686f,1,13,0,1,11,26
7580,1702,2022-10-27 14:52:00,13056b54d37ae6765165ee425cbc1986,0,20,0,2,7,29
7581,1702,2022-10-27 14:57:00,8a1c187741dca2d326e48ec4d909a7ea,1,10,0,1,10,22
7582,1702,2022-10-27 15:03:00,9e3899c668257c95ddc2f515e5d1e670,1,11,0,4,5,21
7583,1702,2022-10-27 15:08:00,c0d83fc8eea6e80b49b962edf09f444c,0,9,0,0,12,21
7584,1702,2022-10-27 15:13:00,789accad59406abca8be63100b0e5e11,1,16,0,5,4,26
7585,1702,2022-10-27 15:18:00,00946d9e0d5e70fcfe9bf1bf8c7908ac,0,14,0,2,6,22
7586,1702,2022-10-27 15:23:00,5730476bded825dfe63983234df6106d,0,19,0,2,4,25
7587,1702,2022-10-27 15:28:00,701a7fe34f1731f44c30bf45965a22d2,0,10,0,1,10,21
7588,1702,2022-10-27 15:33:00,10ef34632291824aa2f939bb17405272,0,12,0,1,8,21
7589,1702,2022-10-27 15:39:00,bbaa5402efcc2133029d086fadc678c8,0,12,0,2,2,16
7590,1702,2022-10-27 15:42:00,0622f43fa5ef538138177eb081c1d7f9,0,12,0,2,4,18
7591,1702,2022-10-27 15:48:00,5e13716ec604faed8ec902bc3699eb0f,0,14,0,0,14,28
7592,1702,2022-10-27 15:52:00,f29e0a22f4437f0ac6710093f911181d,0,8,0,0,8,16
7593,1702,2022-10-27 15:57:00,c7e6b873dd687a92eda2c62562479a8c,0,11,0,1,5,17
7594,1702,2022-10-27 16:03:00,0e9ffa470c5e8a7097d4b58db5764575,0,9,0,1,7,17
7595,1702,2022-10-27 16:07:00,7035e1b2d148093447e78049676e84bc,0,10,0,0,10,20
7596,1702,2022-10-27 16:12:00,a41bdd847769bfa051690720a398f692,0,13,0,3,9,25
7597,1702,2022-10-27 16:18:00,db96cc9b07b21c614a82d13335eb1ce4,0,13,1,1,9,24
7598,1702,2022-10-27 16:22:00,6037aa3fdd695a88f32ee2f5ac165f55,0,9,0,1,9,19
7599,1702,2022-10-27 16:27:00,0a26c781d7e3d45b5ab1512cb2230eec,0,15,0,2,11,28
7600,1702,2022-10-27 16:33:00,4924a0bc615d14261df0236b17e717c4,0,10,0,2,12,24
7601,1702,2022-10-27 16:38:00,82943c5573c7ebc6df056d8c09a3a036,0,14,0,2,6,22
7602,1702,2022-10-27 16:44:00,bb5dc921c8d0bd1e4418d9ceaa8f469d,0,14,1,0,5,20
7603,1702,2022-10-27 16:48:00,ca38e5e9bd10dc81ac6b61ff63134e54,0,9,0,5,12,26
7604,1702,2022-10-27 16:54:00,af54f760fe5da112945200c29c6e1218,0,21,0,1,8,30
7605,1702,2022-10-27 16:58:00,cf0ac02a03457264f2cabc43452f1b4d,1,18,0,5,3,27
7606,1702,2022-10-27 17:03:00,249ea646c279710733709e3ef10dbc34,0,19,0,1,8,28
7607,1702,2022-10-27 17:08:00,1e3b6078fb38669f0e7b2a6963ac6d8d,0,13,0,11,9,33
7608,1702,2022-10-27 17:12:00,f706e5a7bf992a7ebbd08db5db05f0fd,1,19,0,7,11,38
7609,1702,2022-10-27 17:17:00,33ec5e2cbea939ebcc35c524671b748b,3,18,0,2,14,37
7610,1702,2022-10-27 17:22:00,2c7ddef5844a23dfac36f072ae059269,0,12,0,8,10,30
7611,1702,2022-10-27 17:27:00,26c2aa09a9ecf0a4a0a300b1fa2ff44e,0,14,0,7,10,31
7612,1702,2022-10-27 17:32:00,51f60aa19e6bbab73723811455bf6c38,0,21,0,8,4,33
7613,1702,2022-10-27 17:38:00,41a73700dab4e2f437497d7f6307e73b,0,15,0,6,10,31
7614,1702,2022-10-27 17:41:00,41619657b3e76a4bf943a59425991002,1,15,0,8,12,36
7615,1702,2022-10-27 17:48:00,ada7fc3fc1244f68a5fbda2c5c30ccd7,2,18,1,8,8,37
7616,1702,2022-10-27 17:52:00,76ae4e38d5338317d3c6b47039be8f5c,0,21,0,3,10,34
7617,1702,2022-10-27 17:56:00,298c1ec9c4f0dff1d35906738d34d731,0,21,0,4,8,33
7618,1702,2022-10-27 18:02:00,649d372666080b95d72ca01c7c5154dc,0,19,0,4,15,38
7619,1702,2022-10-27 18:07:00,106136977614a4050d1b4943bc28dba2,0,15,0,3,17,35
7620,1702,2022-10-27 18:12:00,f5cbc1eed176dbbff13bcaf1822b341f,4,14,0,13,4,35
7621,1702,2022-10-27 18:18:00,7e2efdb576615e09c78cf48d6c3a783c,0,22,0,3,9,34
7622,1702,2022-10-27 18:22:00,996ca2511d9b81ab1d1cda9867b7d57a,3,21,0,5,6,35
7623,1702,2022-10-27 18:26:00,ae48bd3c559ee38c6d5766e5c9aca63c,0,17,0,5,11,33
7624,1702,2022-10-27 18:33:00,a564498edf7f7c0d6222beb9523608b5,1,19,1,6,10,37
7625,1702,2022-10-27 18:37:00,03b33611f0964b60ae21085fa4f3bd38,2,17,2,3,12,36
7626,1702,2022-10-27 18:41:00,2aeb96a4ce7b5c1a19c57c99e506c75b,1,17,0,1,15,34
7627,1702,2022-10-27 18:47:00,a8311ed63499ce3a401b1c72ce049f52,0,14,0,3,11,28
7628,1702,2022-10-27 18:52:00,18a875787d6db4acd66097dbfcccaebf,0,19,0,1,7,27
7629,1702,2022-10-27 18:57:00,73e020736b52e0e359fd5a1c6d5bb204,0,23,2,1,11,37
7630,1702,2022-10-27 19:02:00,92e2ff0d63f66ac1d89818f55b535667,1,30,0,2,2,35
7631,1702,2022-10-27 19:07:00,4cb01cd4988d3fb1edb1ad84be4c724d,0,19,0,0,3,22
7632,1702,2022-10-27 19:11:00,c30f5357c9a2fa26d4941b9e44cbc2c8,0,29,0,1,0,30
7633,1702,2022-10-27 19:17:00,da6894f21963ca3509ee92de83656e96,0,23,2,1,0,26
7634,1702,2022-10-27 19:21:00,c7b787bf73b8473096e1f3cd1fd212a1,0,24,0,0,0,24
7635,1702,2022-10-27 19:26:00,6ad56490e77430de75f943b75267c92b,1,14,1,1,2,19
7636,1702,2022-10-27 19:31:00,56660bd36dce1cb220175d299d1dd629,0,12,1,0,3,16
7637,1702,2022-10-27 19:37:00,9908417fde192781d0b7b447d6721929,0,12,2,1,1,16
7638,1702,2022-10-27 19:42:00,e2b5df3439a312040e7161be50dff962,0,17,0,0,1,18
7639,1702,2022-10-27 19:48:00,65ac91525e03e0141c63187154575a33,1,18,1,1,1,22
7640,1702,2022-10-27 19:52:00,60e2f41b566fe42d71e30e80f213e55c,0,14,0,0,0,14
7641,1702,2022-10-27 19:57:00,5fdac567bb031e61262dbc0b20e79185,0,18,0,0,0,18
7642,1702,2022-10-27 20:02:00,4bb25323c6288e1616e1d2e634963fa0,0,19,0,2,1,22
7643,1702,2022-10-27 20:08:00,26b6d1e5ddf54defce4e82179a630e1f,0,18,0,1,0,19
7644,1702,2022-10-27 20:12:00,b489dc1ef1e7a2a31bc880b4a847dacb,0,19,0,0,1,20
7645,1702,2022-10-27 20:17:00,6bd9c7248fd36b28da47aa28ab0239a9,0,16,1,0,0,17
7646,1702,2022-10-27 20:22:00,ddbb5fd6c6e9e934b853e066255ef4b2,0,21,0,1,2,24
7647,1702,2022-10-27 20:26:00,b3796b2f3f3ac12165ec14faa7e3be5d,0,12,2,0,1,15
7648,1702,2022-10-27 20:32:00,c7869a6ef34a335803320391494ffea4,0,18,0,1,2,21
7649,1702,2022-10-27 20:37:00,636ac92493f2926cd77268d1b2df7cc2,0,9,2,0,0,11
7650,1702,2022-10-27 20:42:00,da018211f7387fe7fe2b71aff277629d,0,18,1,0,2,21
7651,1702,2022-10-27 20:47:00,a0b7c0a21a66ebfc247ded8251d49301,0,18,0,2,0,20
7652,1702,2022-10-27 20:51:00,8fdc388cc9fb9c42c7c0de361bb9e8f9,1,21,0,0,1,23
7653,1702,2022-10-27 20:59:00,73d195210f65e862a4589ada379336bc,0,21,0,0,0,21
7654,1702,2022-10-27 21:05:00,d5a8b0b288f03681b322fca452eddfa1,0,22,0,0,0,22
7655,1702,2022-10-27 21:13:00,00fa2bda0050fbfa9122e803b19dac57,0,15,1,2,0,18
7656,1702,2022-10-27 21:17:00,da94dea1cf16849f530710f72b6e56c5,0,14,0,0,1,15
7657,1702,2022-10-27 21:22:00,42914691203e250f477bec38276be32b,0,9,0,1,0,10
7658,1702,2022-10-27 21:26:00,3f8715c56b42508f5fd87b3aa3c28ec4,0,14,0,0,1,15
7659,1702,2022-10-27 21:33:00,6f45afe5c1cff040d0397d654d5c4b6c,0,19,0,1,1,21
7660,1702,2022-10-27 21:37:00,b26c55c5e85fdd9001617d5a739817e2,0,23,0,1,0,24
7661,1702,2022-10-27 21:42:00,3c0496f882885a16c7987a6afc0d963e,0,14,0,0,2,16
7662,1702,2022-10-27 21:47:00,e82cac1f086b3e3e326486360d713334,0,24,0,1,1,26
7663,1702,2022-10-27 21:53:00,299a35802ff689f6f4f33652ff467c27,0,13,0,2,1,16
7664,1702,2022-10-27 21:57:00,ee82befed50ae82bd2482f6d6c7bbc41,0,15,0,1,0,16
7665,1702,2022-10-27 22:02:00,eed43e6ea3f1a3ebbe1090b4c2ba05e9,0,16,0,1,2,19
7666,1702,2022-10-27 22:07:00,591671a84b1482852d4a6e4c2e2bbd64,0,14,2,2,1,19
7667,1702,2022-10-27 22:12:00,851c797442012cfcc25e40cb419d92d6,0,21,1,2,0,24
7668,1702,2022-10-27 22:18:00,0e47852094154ca89994babf2c0823b7,0,10,1,0,0,11
7669,1702,2022-10-27 22:22:00,a9a9b18c9ff7403061c9bbc3366d78b4,0,9,1,3,1,14
7670,1702,2022-10-27 22:27:00,41c0865403b694d7817f1292070e8b3c,0,18,0,0,0,18
7671,1702,2022-10-27 22:32:00,a9dc70c43bfc3725c09dcae463b06631,0,20,0,1,1,22
7672,1702,2022-10-27 22:37:00,5e6849948c92cd44fb5cf303444028dd,0,21,0,0,0,21
7673,1702,2022-10-27 22:42:00,2f3b762335f0cea50a84fc555a1f834b,0,22,0,0,0,22
7674,1702,2022-10-27 22:47:00,1be8ae7dcb2888106f0fc2b07017c2a3,0,17,1,3,0,21
7675,1702,2022-10-27 22:52:00,8ebbd761a117dd09cfb510117712ab15,0,7,0,2,1,10
7676,1702,2022-10-27 22:57:00,970dcd490d53a1836bcea76ddd692f37,0,15,1,1,0,17
7677,1702,2022-10-27 23:02:00,f3a33fba090f6133e1412adcadfd2384,0,17,0,0,0,17
7678,1702,2022-10-27 23:07:00,fbcc29def4b2cd4eb64179a90bbfe99b,0,8,6,0,1,15
7679,1702,2022-10-27 23:11:00,3e027b71200279ce6205353a8d6a19d6,0,14,1,0,0,15
7680,1702,2022-10-27 23:17:00,0c91577fb678340c7e933e6ecd0add82,0,15,0,1,0,16
7681,1702,2022-10-27 23:22:00,538d266256a9d39ac131b07f1dfcb335,0,15,0,0,0,15
7682,1702,2022-10-27 23:27:00,0c4e4c6dc2d7394c67dc6ba1dbb4ab99,0,18,1,0,1,20
7683,1702,2022-10-27 23:32:00,efd3958c341027793a0e423275fbbd10,0,12,0,0,0,12
7684,1702,2022-10-27 23:36:00,2ad9c7c7cca47d6c3e1bcd806b40f9c1,0,13,1,0,1,15
7685,1702,2022-10-27 23:42:00,269202c1acd2afb12fbb3bfce9554879,0,10,0,0,0,10
7686,1702,2022-10-27 23:46:00,2e47a72ddcfb7a38095cececce8c09fb,0,7,3,0,3,13
7687,1702,2022-10-27 23:51:00,3af59f14f0ebc33073ec8e03794c55f4,0,7,0,0,0,7
7688,1702,2022-10-27 23:57:00,8dfc081e13e2d166e9510f7e7e9a4207,0,9,2,0,1,12
7689,1702,2022-10-28 00:02:00,f3855163d77f4b07d9faca36fa6fab17,0,5,0,0,0,5
7690,1702,2022-10-28 00:07:00,7bae7bf5cfd29f21f5cb6ae867240152,0,5,1,0,0,6
7691,1702,2022-10-28 00:11:00,02cddaa824dbc76911f882c639276133,0,6,2,0,3,11
7692,1702,2022-10-28 00:17:00,5609d1084cc5553bd1ea2184e7099bcb,0,7,0,0,0,7
7693,1702,2022-10-28 00:21:00,29e1c7e3900b3f4714ccc6ac4adb66b2,0,9,0,0,0,9
7694,1702,2022-10-28 00:26:00,b72a60fddf9039854b2a56b9546e4626,0,15,0,0,0,15
7695,1702,2022-10-28 00:32:00,afb8b58d63dcf509894f57f2001ea59e,0,11,2,1,0,14
7696,1702,2022-10-28 00:37:00,91d5eaed45d71ee00395254bfc4d1feb,0,7,0,1,1,9
7697,1702,2022-10-28 00:42:00,a2a47b8ae4e7c05422dba5c311de2b18,0,12,0,0,0,12
7698,1702,2022-10-28 00:47:00,986ceabea7e070721b541c4c11b39b08,0,5,0,1,1,7
7699,1702,2022-10-28 00:51:00,2c9009eac0b59b9289b330306a54a30f,0,5,0,0,1,6
7700,1702,2022-10-28 00:56:00,abc3f9b8dddf89d68871f3f858698b30,0,8,1,1,1,11
7701,1702,2022-10-28 01:02:00,c463f201d44e8a64c3044f50d1d3aa1f,0,6,0,0,0,6
7702,1702,2022-10-28 01:16:00,196cd5b1188f97a35a2635dcab507786,0,9,0,0,0,9
7703,1702,2022-10-28 01:22:00,e98c86f8542ede06e48451b5229153cf,0,8,0,0,0,8
7704,1702,2022-10-28 01:26:00,9b5f90d152e471e021eb248a5a0b8d67,0,10,0,0,2,12
7705,1702,2022-10-28 01:32:00,f083092a5689c9892c528dc95a606f9e,0,2,0,0,1,3
7706,1702,2022-10-28 01:36:00,1557332187e97dd7af787c9e4175aff8,0,5,0,0,1,6
7707,1702,2022-10-28 01:41:00,1da04d85205f80e8297987b49a1f6287,0,4,0,0,0,4
7708,1702,2022-10-28 01:47:00,f6a8b14feb3bd719db6b32f1b603d236,0,13,2,0,0,15
7709,1702,2022-10-28 01:51:00,d67c6ab95dc81074fc090391bbd9b7a9,0,6,0,0,2,8
7710,1702,2022-10-28 01:56:00,275a82a3cfd28fd041eda1982e0b9ee4,0,5,3,0,0,8
7711,1702,2022-10-28 02:02:00,cdb6e5418716218c5a3be9bc13c021d8,0,8,0,0,0,8
7712,1702,2022-10-28 02:07:00,26d0d3618db3ae6dd8d885962ce332ab,0,6,0,0,0,6
7713,1702,2022-10-28 02:11:00,5b321b929202445bd906d73646d1c42c,0,9,0,0,1,10
7714,1702,2022-10-28 02:17:00,8401aaf5ade202ed895941d4b725a331,0,6,1,0,0,7
7715,1702,2022-10-28 02:21:00,dd7795053503363cfcfa2507fd06ddbf,0,3,0,0,1,4
7716,1702,2022-10-28 02:26:00,72acd3135172a39a008019fb7e430857,0,5,0,0,0,5
7717,1702,2022-10-28 02:31:00,252cf5b6257ebf0a7851bb2d6fbbff36,0,8,0,0,0,8
7718,1702,2022-10-28 02:36:00,c364a2d7743757de001726a99e5e7b2f,0,2,0,0,0,2
7719,1702,2022-10-28 02:41:00,101a9ead53b60efc14b62669e03d9856,1,3,1,0,0,5
7720,1702,2022-10-28 02:46:00,e98c1c3ff6ebdecc91909eeaac004059,0,4,0,0,0,4
7721,1702,2022-10-28 02:52:00,5a536bec2f84cc37c074287290427ef8,0,1,0,0,0,1
7722,1702,2022-10-28 02:57:00,4c064aa2af0fab50dfc6847ab13cdcb3,0,4,0,0,0,4
7723,1702,2022-10-28 03:02:00,a7dc7fec883d47e52e68c7a3a2f7f97e,0,4,0,0,0,4
7724,1702,2022-10-28 03:08:00,310523662cda8b7bd8a37d3d0d5dd1a8,0,1,0,0,0,1
7725,1702,2022-10-28 03:11:00,b657c8a759f795994b98ed5be5e26348,0,2,0,0,0,2
7726,1702,2022-10-28 03:17:00,04ed2047458cfa3c85b996600e7c72fa,0,4,0,0,0,4
7727,1702,2022-10-28 03:22:00,5dbf316eae6495bbeac292097b4c6ac5,0,1,0,0,0,1
7728,1702,2022-10-28 03:27:00,543ddd8fcdb504e5436af4e594b7b779,0,0,0,0,0,0
7729,1702,2022-10-28 03:33:00,88233b36b38d150f03712bc55c4a35bb,0,4,0,0,0,4
7730,1702,2022-10-28 03:37:00,c7805a700950c6d409763700d7212278,0,1,1,0,0,2
7731,1702,2022-10-28 03:42:00,7b354976993187896cfabedf950207f6,0,1,0,0,0,1
7732,1702,2022-10-28 03:47:00,c3499cf82d071784b45032a48eb33def,0,3,0,0,0,3
7733,1702,2022-10-28 03:52:00,d265f6bd6f964a61b73def48d8290c27,0,3,0,0,0,3
7734,1702,2022-10-28 03:56:00,09158e3182fc18b04a57ac85a6f790c3,0,3,0,0,0,3
7735,1702,2022-10-28 04:02:00,c6a66907b3709ce5f9da1e258a86fc3e,0,6,0,1,0,7
7736,1702,2022-10-28 04:08:00,b812a22dbc4e55a352ed13fa69022920,0,3,0,0,0,3
7737,1702,2022-10-28 04:12:00,0adeeebba05cdfd7f1d238abfbd08287,0,5,0,0,0,5
7738,1702,2022-10-28 04:17:00,160379680780423a0cae75c8a82f2984,0,1,0,0,0,1
7739,1702,2022-10-28 04:22:00,8e7befccce82458a99a731527027d304,0,2,0,0,0,2
7740,1702,2022-10-28 04:27:00,e7226ac1e4a13666c9718402025d48ac,0,3,0,0,0,3
7741,1702,2022-10-28 04:31:00,899f78adf8ea2b1730ac5643a6d69aea,0,1,0,0,0,1
7742,1702,2022-10-28 04:37:00,d62ebfb78f31b275ace9f23c038ef2b3,0,0,0,0,0,0
7743,1702,2022-10-28 04:42:00,d961bb2d2ec69bce16b41f457ffec56f,0,5,0,0,1,6
7744,1702,2022-10-28 04:48:00,a3ddd5a00d5f8cf04597a07640f9c3fb,0,3,0,0,0,3
7745,1702,2022-10-28 04:52:00,c8be4698861e5aa490366d8213d605ff,0,0,0,0,0,0
7746,1702,2022-10-28 04:57:00,d027665bcab3db3a2b2e5388535e989c,0,5,0,0,0,5
7747,1702,2022-10-28 05:02:00,3f9c27caec0a516083b59658521f279e,0,2,0,0,0,2
7748,1702,2022-10-28 05:07:00,c545d699eca914f0711c88c586d564aa,0,5,0,0,0,5
7749,1702,2022-10-28 05:12:00,219c94a174c5ebcf0be59451435d4b13,0,2,0,1,0,3
7750,1702,2022-10-28 05:18:00,9af3275f03008262fe9a9949438d5d8b,0,2,0,0,1,3
7751,1702,2022-10-28 05:23:00,13c9436e1164a85777f574f38d38c3c5,0,0,0,0,1,1
7752,1702,2022-10-28 05:27:00,e60399a7ef3c5252472aef16f32d5d79,0,1,0,0,0,1
7753,1702,2022-10-28 05:32:00,cf2bc73afd526c8b6298d128086e1f07,0,4,0,0,2,6
7754,1702,2022-10-28 05:36:00,9e91fe2d99ce3cc9cce4770923479fba,0,0,0,0,0,0
7755,1702,2022-10-28 05:42:00,3c40c72b2816228acbef92f66525728b,0,6,0,1,2,9
7756,1702,2022-10-28 05:48:00,ba00c77a810587ddab95439f7fc0ed54,0,0,0,0,0,0
7757,1702,2022-10-28 05:52:00,1d29edccfdef532963a9e67b04b79521,0,7,0,1,1,9
7758,1702,2022-10-28 05:57:00,f8e3f18b791d01718550d31664e4c888,0,7,0,1,0,8
7759,1702,2022-10-28 06:02:00,71cdaddb35533f86bac521b1bf21a1a9,0,4,2,2,0,8
7760,1702,2022-10-28 06:07:00,7e61cd841956dea9363e32529e33f4b9,2,8,0,0,0,10
7761,1702,2022-10-28 06:12:00,31ec61ab3eafcf6b0f810125129f5565,0,4,0,4,0,8
7762,1702,2022-10-28 06:17:00,249ef7f87c8223e8d3c40e6958bc460f,0,5,0,0,2,7
7763,1702,2022-10-28 06:22:00,5ca75bb93f8ecb569ab2403272af2ebe,0,4,0,0,1,5
7764,1702,2022-10-28 06:26:00,8244f2ae5a2391df224ad06d4eb8cdf1,0,6,1,1,0,8
7765,1702,2022-10-28 06:32:00,fab84e7b851acaa18d5379e1644a21e2,0,9,2,1,2,14
7766,1702,2022-10-28 06:37:00,c7a87190130b3befc1efba14b1eecf7d,0,5,5,1,0,11
7767,1702,2022-10-28 06:42:00,040e433bf46197e28309e661a7976978,0,15,3,0,2,20
7768,1702,2022-10-28 06:47:00,4c732b273512a11e7b23441dc11f0244,0,17,0,1,3,21
7769,1702,2022-10-28 06:58:00,af59a17c17996e507ee5e56696c6ba0f,0,15,0,3,3,21
7770,1702,2022-10-28 07:02:00,1d41aa8c80259dafc3ae6d62622d5f0d,0,16,0,1,8,25
7771,1702,2022-10-28 07:09:00,7696812fdd589df36a370e2919f81675,0,13,0,1,10,24
7772,1702,2022-10-28 07:11:00,0990cf81db732f07cc9e15db8b9be956,0,21,0,1,7,29
7773,1702,2022-10-28 07:17:00,bfa0148b8c78f2cd171d896df32aa92f,0,15,0,0,8,23
7774,1702,2022-10-28 07:21:00,99c614756ef562ad235da225f5bc75e5,0,18,1,0,4,23
7775,1702,2022-10-28 07:27:00,a2dfdb306e50053bcf32f5901c862ebd,1,17,0,0,5,23
7776,1702,2022-10-28 07:34:00,6b9297e7ae7ecdfe27c38e76a797b6a8,0,17,0,0,6,23
7777,1702,2022-10-28 07:37:00,00096249e74b41725faba8ae7a94c78f,0,10,0,1,10,21
7778,1702,2022-10-28 07:42:00,ad7d48bbea635822100cf56abe23f3c0,0,21,1,3,6,31
7779,1702,2022-10-28 07:47:00,14be7c92f0990f6e2256480294d40c8a,0,24,1,2,6,33
7780,1702,2022-10-28 07:53:00,f1f3a315185ca9ef8277dbc2e95204af,1,16,1,0,7,25
7781,1702,2022-10-28 07:57:00,45350897f58c1d14d02171584b0910f3,0,18,0,3,7,28
7782,1702,2022-10-28 08:03:00,ea7550c811f5d78c7c42e80b151f3bf2,0,14,0,1,11,26
7783,1702,2022-10-28 08:08:00,cd34aaf3904500ee49589f2c75b6572e,0,12,0,4,9,25
7784,1702,2022-10-28 08:12:00,56aa9ce0f820896fdc17ba499355ae71,0,8,0,0,14,22
7785,1702,2022-10-28 08:17:00,5e76b55913ee93218081a5495c63416c,0,12,0,0,13,25
7786,1702,2022-10-28 08:22:00,d384822b5d4cf1a1c116e4458fae6a2e,0,16,0,5,9,30
7787,1702,2022-10-28 08:27:00,4d8d36ecadc1b93a3de568144d04b2c5,0,10,1,1,13,25
7788,1702,2022-10-28 08:33:00,460d3959f96e4b44c73b7c4b8432ede9,0,22,0,1,4,27
7789,1702,2022-10-28 08:37:00,4354256d238ca468e67f75e67edc6f85,0,15,1,0,11,27
7790,1702,2022-10-28 08:41:00,ca42f401e055f4f7f1320320bc6eeba2,0,13,0,0,13,26
7791,1702,2022-10-28 08:47:00,b8a1750fef75b0a68f87e32461df2302,0,11,0,0,10,21
7792,1702,2022-10-28 08:53:00,a6e45e8910a57072c391a2a351d5ac8b,0,14,0,0,13,27
7793,1702,2022-10-28 08:57:00,d69c44efb25656b222f0e6637267709f,0,13,1,2,11,27
7794,1702,2022-10-28 09:04:00,6a1ab3217119fdf0cbc7df5b3932d17f,0,8,1,1,7,17
7795,1702,2022-10-28 09:07:00,c897280442b2649a4c22bb8aaab6e828,2,13,0,4,10,29
7796,1702,2022-10-28 09:12:00,82291b735a46bf681875282c5cd4e338,0,12,0,0,8,20
7797,1702,2022-10-28 09:17:00,e51640327653671280ab8d210cdfc475,0,18,0,1,3,22
7798,1702,2022-10-28 09:23:00,cb71c2307ac296144c204442f8e5f6fb,0,11,0,3,4,18
7799,1702,2022-10-28 09:27:00,b8ad6a864967ed3b4cd4afab4b80825d,0,16,0,2,9,27
7800,1702,2022-10-28 09:32:00,cdfcd6d786e48a5fd8a229d12354dac0,0,17,0,3,11,31
7801,1702,2022-10-28 09:38:00,22b583e5c65643275320801ccbf3ad63,0,16,0,1,7,24
7802,1702,2022-10-28 09:42:00,4f74891fad49e62f89d3ab33729c5687,0,9,0,4,7,20
7803,1702,2022-10-28 09:48:00,bf961b7717c930a72b3ac5ddc071a65c,0,5,0,1,15,21
7804,1702,2022-10-28 09:52:00,c8d050e6741624a92c8526852a9a90c8,0,13,0,1,11,25
7805,1702,2022-10-28 09:57:00,116902c0f0f087cca5b7d54e93a45fe6,0,13,0,3,16,32
7806,1702,2022-10-28 10:03:00,4fec74aa4c8551cd315f915c01308ff5,0,19,0,0,7,26
7807,1702,2022-10-28 10:07:00,00242509dd741a47a5ac547a4b8db7e0,0,13,1,3,7,24
7808,1702,2022-10-28 10:12:00,bf6b166587dd2e5d3ade5db317b5d58e,0,17,0,1,6,24
7809,1702,2022-10-28 10:18:00,a29ed5dece6764aef0f285db3fb51864,0,15,0,3,10,28
7810,1702,2022-10-28 10:22:00,dc482e77c55dbd56460c07aff56989ad,1,18,0,2,7,28
7811,1702,2022-10-28 10:29:00,b9971190bcb7890a4036e4adff46dc5b,0,19,0,3,5,27
7812,1702,2022-10-28 10:33:00,03eca57a7c3778828b7a95605f898f55,0,14,0,3,8,25
7813,1702,2022-10-28 10:38:00,2c9cb667cd64fd9a52acc162ee207477,0,16,0,1,17,34
7814,1702,2022-10-28 10:42:00,2bb304d4cce1e2ec54944b1c1f9c16dd,0,12,0,0,10,22
7815,1702,2022-10-28 10:47:00,bdb59edf0e22479414fd830ed0cfbebd,0,13,1,0,9,23
7816,1702,2022-10-28 10:53:00,8c35ebc02b211f454a2497ca1178ff2a,0,17,0,0,9,26
7817,1702,2022-10-28 10:57:00,bd5b4a0d7835723f1cf4c83764457b9f,1,18,0,1,3,23
7818,1702,2022-10-28 11:03:00,42591c4e6813ddffb97ca3b46fb0d822,0,12,0,1,10,23
7819,1702,2022-10-28 11:08:00,486d95df81d112d653b3b0300485aae1,0,15,0,3,4,22
7820,1702,2022-10-28 11:13:00,964eb0635b3c04a19d4d2ac6ae17d63e,0,17,0,0,6,23
7821,1702,2022-10-28 11:18:00,83b6ac3eaa58518f83f1060190fb83b9,0,14,1,0,8,23
7822,1702,2022-10-28 11:22:00,a298f16097fa054282ef4f27e6f0557f,0,11,0,2,10,23
7823,1702,2022-10-28 11:27:00,1d4d148b933e113d2a7a4067358f3666,0,12,0,5,6,23
7824,1702,2022-10-28 11:33:00,7b865cf81db06ad042e3fb55c31b470b,0,16,0,0,2,18
7825,1702,2022-10-28 11:37:00,35606ac221391c935ce59bc1dc24f86b,0,12,0,2,5,19
7826,1702,2022-10-28 11:41:00,a17e7969ff9ee2d235bb1a721ddbe33f,0,14,0,7,4,25
7827,1702,2022-10-28 11:47:00,dfac1b65bbc51dc6cf0c19a0ca43feeb,0,20,0,7,4,31
7828,1702,2022-10-28 11:53:00,65d8956403a8d64f89e2a9347264bc2a,0,18,0,5,3,26
7829,1702,2022-10-28 11:57:00,a98c259a567ab26abc89dbd6220bdd09,0,21,0,2,3,26
7830,1702,2022-10-28 12:02:00,10874869d4d70bd2975c2e6f78f04ffd,0,19,0,4,6,29
7831,1702,2022-10-28 12:09:00,c515e15f718803695870680cb888a9e2,0,21,0,5,3,29
7832,1702,2022-10-28 12:13:00,10f4f0b8a217af970587d326826b17a9,1,13,1,3,2,20
7833,1702,2022-10-28 12:19:00,c5e163b6ed4daa10791456b6499f7910,0,17,0,6,3,26
7834,1702,2022-10-28 12:23:00,defdc471293a975a604bfa9033012c01,0,19,0,5,4,28
7835,1702,2022-10-28 12:28:00,b74d837c7e8f0a871e5e6e83aef897f6,0,15,1,5,8,29
7836,1702,2022-10-28 12:33:00,ff211b2cbbd607c4deeb6a0e14f08e8c,0,15,0,5,4,24
7837,1702,2022-10-28 12:37:00,d5a8f7b37e17a2e83ffa2539d94385d3,0,12,0,8,6,26
7838,1702,2022-10-28 12:42:00,10bfbde2560dca6bcf1bcb751eb30f3b,1,17,0,2,3,23
7839,1702,2022-10-28 12:47:00,cc957bcbea2e2bfb8b9c38810613a6c9,1,14,1,3,6,25
7840,1702,2022-10-28 12:52:00,93215bd3075cd512e4844008f754a0a5,0,18,0,1,3,22
7841,1702,2022-10-28 12:58:00,449b33bb537343da0152c92f8ae61fb5,0,18,0,2,6,26
7842,1702,2022-10-28 13:03:00,d1f09a941a88702bcad0fe77c3130bd3,0,15,0,5,4,24
7843,1702,2022-10-28 13:09:00,8fdbd1232e081eb65a443fac23143b1f,0,21,0,2,2,25
7844,1702,2022-10-28 13:12:00,1b2c2a944fec37796c36881c4aa4b95c,0,12,0,6,3,21
7845,1702,2022-10-28 13:18:00,46f3f7559964dd65c8a055b0fa23d88d,0,16,0,0,8,24
7846,1702,2022-10-28 13:22:00,91db64a9c23728417fc707d561d599e1,0,18,0,5,4,27
7847,1702,2022-10-28 13:28:00,335ae785c9a5509399c2e12d8f4df43a,0,13,0,5,1,19
7848,1702,2022-10-28 13:33:00,4febd88ab91633403829326274e63dcc,0,21,2,2,8,33
7849,1702,2022-10-28 13:38:00,d870128b0cbbf49107f34f6b6dc5a58d,0,16,0,3,4,23
7850,1702,2022-10-28 13:42:00,997208871d8946571ecc57787af8edc9,1,17,0,4,10,32
7851,1702,2022-10-28 13:47:00,b4e10285250f7b45a04ef3f163fb0884,1,18,0,4,4,27
7852,1702,2022-10-28 13:52:00,05b52033fc69c2488b7274e4a6d36f28,0,20,0,3,4,27
7853,1702,2022-10-28 13:59:00,62aa3159def38f4c02ef00874ca2a936,0,22,0,1,5,28
7854,1702,2022-10-28 14:03:00,40f34b7ee6cf4e93d0a38819d3aef9f6,0,12,0,3,6,21
7855,1702,2022-10-28 14:07:00,34ec3e1fd1f39873ef4ceabea2007b91,0,20,0,1,6,27
7856,1702,2022-10-28 14:12:00,aac5570ffc998d94687677687251c216,0,16,1,9,4,30
7857,1702,2022-10-28 14:17:00,d2746ac275df00a4e4c95933676807ed,0,16,0,3,2,21
7858,1702,2022-10-28 14:23:00,5fb349a65bea511d3500da87e15223a7,0,16,0,7,5,28
7859,1702,2022-10-28 14:27:00,712933313b12159c578398d0e50288d9,0,17,0,4,7,28
7860,1702,2022-10-28 14:34:00,a54696fbe77e0628ed7a794aa3b94a1e,0,17,1,1,11,30
7861,1702,2022-10-28 14:38:00,4d678f9556a795d94466f89123f31a30,0,15,0,4,13,32
7862,1702,2022-10-28 14:42:00,c6665ceb0dcf5e291e01a7b7bf23b342,0,15,0,0,13,28
7863,1702,2022-10-28 14:47:00,cfa06f300bc4b2b19f17f22eadb6dae4,0,13,0,6,7,26
7864,1702,2022-10-28 14:53:00,2686dc2312b23da8d3e7ba65b44ca48f,0,18,2,0,6,26
7865,1702,2022-10-28 14:57:00,6e82777701131cd05c3c4cbef3ee667d,1,17,0,2,11,31
7866,1702,2022-10-28 15:02:00,27d15bc10c6e15f04954e18e52a3d467,0,15,0,0,11,26
7867,1702,2022-10-28 15:07:00,918f4cbec6c7bfd4ada7dba141e7ec4d,0,14,0,3,5,22
7868,1702,2022-10-28 15:11:00,02d177aefcf31b0ff79110cf654f55e9,0,7,0,3,19,29
7869,1702,2022-10-28 15:17:00,ebeb7442a7f93783c4be6d25d6292396,0,13,0,12,7,32
7870,1702,2022-10-28 15:23:00,208323a16763f8eb01b8478cba7332b6,0,15,0,3,9,27
7871,1702,2022-10-28 15:28:00,6ff202ea4dfc599193b2f9ac4510e4b3,0,9,0,2,11,22
7872,1702,2022-10-28 15:32:00,5833ce3115dcdc1130ce9a2ab7a80d72,0,15,0,1,10,26
7873,1702,2022-10-28 15:38:00,3f78de7b9aa69088b680abb369a73f21,0,15,0,0,10,25
7874,1702,2022-10-28 15:42:00,1070907b41887411050a0e649d93b910,0,10,0,2,11,23
7875,1702,2022-10-28 15:48:00,dae7fda20b7b204249eec610364ebf29,0,16,0,8,10,34
7876,1702,2022-10-28 15:53:00,5fe17fbe9ddfd80e3925c72d20d2bfd9,0,10,0,1,9,20
7877,1702,2022-10-28 15:57:00,1ba97d2e491ec716abc44f76fa684d3b,0,9,1,5,4,19
7878,1702,2022-10-28 16:02:00,9997f6af296bad1e007d470c9f9e7e31,0,13,0,2,8,23
7879,1702,2022-10-28 16:07:00,531b9b40c53d552b9a8120a867b61e77,0,12,0,6,10,28
7880,1702,2022-10-28 16:12:00,ec7ebc404a85b2ff1b8bc1f212470421,0,9,0,1,16,26
7881,1702,2022-10-28 16:18:00,407fcce57aade39dd951d1e6157c1a39,0,11,0,4,15,30
7882,1702,2022-10-28 16:23:00,0099284a39c8fbc20060e46714005626,0,16,0,3,8,27
7883,1702,2022-10-28 16:27:00,e76b240813f767c3cc9d6d39408d7c23,0,10,0,0,16,26
7884,1702,2022-10-28 16:33:00,c0c943c6c1c5e66cd6455c39d9b91e9e,0,9,0,3,8,20
7885,1702,2022-10-28 16:42:00,cfc053501e70b1e06fa403ab19e62ff3,0,14,0,5,7,26
7886,1702,2022-10-28 16:47:00,821914706698725ffad0535573379921,0,17,0,5,12,34
7887,1702,2022-10-28 16:52:00,ba541035125ffa6f76c72bfa336b58ef,0,9,0,6,15,30
7888,1702,2022-10-28 16:57:00,c2bf8623c18c984a4218fdb5173922e2,0,18,0,8,11,37
7889,1702,2022-10-28 17:02:00,3ae44d0c10135b53ab3555b265a73448,1,14,0,5,11,31
7890,1702,2022-10-28 17:07:00,09339d6a129b9b76c7fb4ebafec73476,0,9,0,6,11,26
7891,1702,2022-10-28 17:13:00,8ec66b42575399ff095ccdd1c747c0c2,0,14,1,4,17,36
7892,1702,2022-10-28 17:18:00,880b07a3a96ee0baf59dcf008ae5cc88,2,16,1,5,12,36
7893,1702,2022-10-28 17:22:00,c49f2b54741c9c12990fd16e8907eb7c,1,17,0,11,14,43
7894,1702,2022-10-28 17:27:00,3dfb99ed6e1deb0145d5bc683ae5a149,0,15,1,6,11,33
7895,1702,2022-10-28 17:33:00,395d14beaa1c717f1209221e8726ddc4,2,20,0,7,11,40
7896,1702,2022-10-28 17:38:00,8b7e40abc0eade235e574b778779f236,0,20,0,3,12,35
7897,1702,2022-10-28 17:42:00,4144fb15c4f3824bd32b96da8fff8207,0,20,1,2,10,33
7898,1702,2022-10-28 17:47:00,09a9e2959e48c511e296c372a18bf4e0,0,21,0,7,4,32
7899,1702,2022-10-28 17:53:00,03ea479e4643fe1c87dfa3f4d686da0b,0,14,1,3,14,32
7900,1702,2022-10-28 17:57:00,768735f7fce55d60979e3d8db7e3b230,0,17,0,3,14,34
7901,1702,2022-10-28 18:02:00,b69f99e2515231b6f02f5d0e86010b01,0,15,0,3,14,32
7902,1702,2022-10-28 18:07:00,8de8e7f4434850f0f4539aab2c61eff5,0,17,0,4,10,31
7903,1702,2022-10-28 18:12:00,e15b1fe3d6e5628ebad05a40a54e602a,0,20,0,5,8,33
7904,1702,2022-10-28 18:17:00,f9defea407833322a49145f2695eb93c,1,20,0,0,9,30
7905,1702,2022-10-28 18:22:00,f62066efe96123952781f2fdd1bd0c4f,1,15,1,0,11,28
7906,1702,2022-10-28 18:27:00,0276055f690e1d211925af89cdfc3819,2,21,0,1,6,30
7907,1702,2022-10-28 18:32:00,d9238872e57c8aaeb67a0c816bb0ee95,0,17,0,2,12,31
7908,1702,2022-10-28 18:37:00,136286bc1d4bf0b769d808de0166f5fa,0,15,2,2,11,30
7909,1702,2022-10-28 18:42:00,8ae06e29cf630de2acadc7d18214affa,2,18,0,0,10,30
7910,1702,2022-10-28 18:47:00,51f36e357779e9ad84a3ee2c1f5b62c7,0,20,0,2,10,32
7911,1702,2022-10-28 18:52:00,082edb34fa94df4cf56934159dd554de,0,16,0,1,8,25
7912,1702,2022-10-28 18:57:00,73c1b21ef361af6e1111e0035d9b5941,0,21,1,3,5,30
7913,1702,2022-10-28 19:02:00,5f7ae056307b59a69b53bcdb6e3608fe,2,25,0,2,4,33
7914,1702,2022-10-28 19:07:00,b56c87a5aa023dcec5d89b519768ca63,0,24,3,2,2,31
7915,1702,2022-10-28 19:12:00,80e1274632ebbd1e384a697b9d52838f,0,19,1,2,1,23
7916,1702,2022-10-28 19:17:00,ba14e464e84d57fa48d41647b94d261b,0,16,2,1,0,19
7917,1702,2022-10-28 19:22:00,0b721403aa30d09ae830693c6077d2af,0,18,0,0,4,22
7918,1702,2022-10-28 19:27:00,3f210ee8c65c5e3e19d50e5f2bbe6d84,0,17,2,1,2,22
7919,1702,2022-10-28 19:31:00,82a76ac1dc6e48d386d24dc2ff3a9567,0,14,0,1,4,19
7920,1702,2022-10-28 19:37:00,3240068d848c3e1f4f5a995ac63f5365,0,20,0,1,0,21
7921,1702,2022-10-28 19:41:00,7550090c3254e5a18627742edbb3acd8,0,12,0,1,0,13
7922,1702,2022-10-28 19:46:00,a68a60d2c1af77823300343629154355,0,20,3,0,0,23
7923,1702,2022-10-28 19:52:00,1c5d692560868882194bcd1f59360c1b,0,20,0,2,0,22
7924,1702,2022-10-28 19:56:00,f299e74571705cbdf9e5bdc3515fabf0,0,12,2,1,3,18
7925,1702,2022-10-28 20:02:00,79d70eb6dbc2af783c68e98bf99f522a,0,13,0,2,1,16
7926,1702,2022-10-28 20:07:00,e63b1cdcdd7e8b7f4f67a44e7fd9e853,0,19,1,2,0,22
7927,1702,2022-10-28 20:12:00,441ca4828619f649d3c904d324dad4f9,0,16,1,1,0,18
7928,1702,2022-10-28 20:17:00,6dfb2ca4833dda8601080fca92ce8ea7,0,18,0,0,0,18
7929,1702,2022-10-28 20:22:00,d3611f9bacec15f12d5b53b9ccb9f323,0,19,1,0,2,22
7930,1702,2022-10-28 20:26:00,6cf990ffcfbd468195e9381bb33ea8f0,0,19,0,2,0,21
7931,1702,2022-10-28 20:31:00,51552bad4ecdc5b858f02d1465f8fcf5,0,25,2,0,0,27
7932,1702,2022-10-28 20:36:00,b61a73b4039a4d29f72b2bf582b5f582,0,18,0,0,1,19
7933,1702,2022-10-28 20:42:00,fc0ebfa469da59eed8735d438f8ea51e,0,25,1,0,1,27
7934,1702,2022-10-28 20:47:00,68a0085911f44530d9dece831d38c520,0,21,1,0,0,22
7935,1702,2022-10-28 20:52:00,679eaf910b85ccc3ec83c5b3a0df09a1,0,23,0,0,2,25
7936,1702,2022-10-28 20:57:00,54e4e8d74233f5023c31fce77ccaefad,0,21,0,0,0,21
7937,1702,2022-10-28 21:02:00,196085f77bf0993183625f4623acdad6,0,16,5,0,2,23
7938,1702,2022-10-28 21:06:00,a2b0ceb2759667e6ff0e2721aadfc6ac,0,19,2,0,0,21
7939,1702,2022-10-28 21:11:00,d7453114d816319f8c3fd9487cf47fb1,0,17,0,0,1,18
7940,1702,2022-10-28 21:16:00,188beb05392f18b080dfefd1af21654c,0,22,0,1,0,23
7941,1702,2022-10-28 21:22:00,f5fac99a7fef836a8685abc1585a6eab,0,18,1,0,1,20
7942,1702,2022-10-28 21:27:00,a3b28b869a9bb92b3b7ad9b718aee145,0,14,0,1,1,16
7943,1702,2022-10-28 21:31:00,54d64261dd61a1bc7aca725557c4ef29,0,22,3,0,0,25
7944,1702,2022-10-28 21:37:00,b4ed5693ca022737c54f54e45ca98a40,0,15,0,2,0,17
7945,1702,2022-10-28 21:42:00,60b930e5c8593fea089a78138d219eb6,0,22,3,0,0,25
7946,1702,2022-10-28 21:47:00,7a271a87455fb7fbda686a684711dce7,0,22,0,1,0,23
7947,1702,2022-10-28 21:52:00,212fddf98c604684ecfc6634613acf4e,0,18,0,0,1,19
7948,1702,2022-10-28 21:57:00,dbc9a7a003488d1262569d1b79872a07,1,18,4,0,1,24
7949,1702,2022-10-28 22:01:00,3dc7458c5e98edc0c4b625fb41fc4fe1,0,29,1,0,0,30
7950,1702,2022-10-28 22:07:00,4002573585a5e3a1cc603a2b2e1e7544,1,24,2,1,4,32
7951,1702,2022-10-28 22:12:00,91d8e0443c3dce41af801f9f5d69f56c,0,20,1,0,0,21
7952,1702,2022-10-28 22:17:00,085b60d055432ad8ba31ecace67507b3,0,19,0,0,2,21
7953,1702,2022-10-28 22:22:00,21fc158fb9d2ab3fa5927eb40f8f758e,0,19,0,2,2,23
7954,1702,2022-10-28 22:27:00,14ba97790a2a8f5c6dacd413c716ce53,0,19,4,0,0,23
7955,1702,2022-10-28 22:32:00,f48dc0dff11e9a783420917b2b4506f4,0,22,0,1,0,23
7956,1702,2022-10-28 22:36:00,f9b6f5df2e3333f222cbe1c105b003e7,0,18,0,1,1,20
7957,1702,2022-10-28 22:42:00,87a0251c53c16d9e623fc9ae41d79184,0,16,1,0,1,18
7958,1702,2022-10-28 22:47:00,823698deb78e238d15851986d4be65f9,0,19,0,0,0,19
7959,1702,2022-10-28 22:52:00,f58f5cb5d602ef9a04fda9fffd5f92f8,1,21,0,1,1,24
7960,1702,2022-10-28 22:56:00,c1b50bd6dc0cb692b2f077782157398c,1,12,0,0,0,13
7961,1702,2022-10-28 23:02:00,bf62650134f789d96f40b58fd9475e09,0,11,3,0,1,15
7962,1702,2022-10-28 23:08:00,a74f7a947da6ab173fa083e82b8cc3b3,0,18,0,0,1,19
7963,1702,2022-10-28 23:12:00,60baa0f61b47c0ffcf64ccd3056499aa,0,20,0,1,0,21
7964,1702,2022-10-28 23:17:00,ee2adae20dc696bf828a8dfb36dd7f8d,0,13,0,1,1,15
7965,1702,2022-10-28 23:22:00,70f8ed8969279a21e80e8f765adc4f4d,0,9,0,0,0,9
7966,1702,2022-10-28 23:27:00,06dc1268f950eb7e1f81c75b1f749f54,0,13,0,0,0,13
7967,1702,2022-10-28 23:32:00,b400e9fff3f0183ad3a0b15dfd2f9b3b,0,18,1,0,2,21
7968,1702,2022-10-28 23:37:00,6aa0b143fb050d1ad88102c5dc9bcd92,0,8,0,0,1,9
7969,1702,2022-10-28 23:42:00,07372de258eb2558d1b6ef830de27777,0,12,0,0,0,12
7970,1702,2022-10-28 23:47:00,ff18e52669a471a270d700550316f296,0,10,0,0,0,10
7971,1702,2022-10-28 23:51:00,971e346bbf0560ea80f3b3a8a495c472,0,15,0,0,1,16
7972,1702,2022-10-28 23:57:00,807fa49cda59a68dac544f6fb668b0d1,0,21,1,0,1,23
7973,1702,2022-10-29 00:02:00,8f5df128f32d056a158698fdc007f5a2,0,20,2,1,0,23
7974,1702,2022-10-29 00:07:00,06491eab97a4491ef7167f5daafd6d57,0,13,3,0,0,16
7975,1702,2022-10-29 00:12:00,557fdd60e1b0a69a09ca6b5cd1587995,0,14,0,0,1,15
7976,1702,2022-10-29 00:17:00,9839ba3c6db6359d92f420ee85ff56d0,0,5,0,2,0,7
7977,1702,2022-10-29 00:21:00,3f59f9f95ace0ce8c79ba1f668064f2d,0,20,0,1,1,22
7978,1702,2022-10-29 00:27:00,3522e035a26daa44293f02b0cf728acf,0,12,1,0,1,14
7979,1702,2022-10-29 00:33:00,87676e8ae78dfd8794429ea5e7286c81,0,7,1,0,0,8
7980,1702,2022-10-29 00:37:00,c93597cad35c66619021547570fac104,0,13,0,0,2,15
7981,1702,2022-10-29 00:41:00,181d7cbe20c01bc8fc62b3e804e70da4,0,4,2,1,1,8
7982,1702,2022-10-29 00:46:00,c9fb76e40ce0f43fb3b576d0e08aea61,0,9,1,0,1,11
7983,1702,2022-10-29 00:52:00,7f99e0ee1fe6a6e5b33de5f7c0bd40bc,0,11,1,0,0,12
7984,1702,2022-10-29 00:58:00,3f666866e19ec8ec7582677bbae2c402,0,12,0,0,0,12
7985,1702,2022-10-29 01:02:00,1d7fd88b119c8811f88ec3b1c8e0888d,0,7,0,0,1,8
7986,1702,2022-10-29 01:11:00,f6ed2a73de4b8fa86201685a986f756c,1,11,0,0,0,12
7987,1702,2022-10-29 01:17:00,61f880051311aea74496e9dd1f45c0c5,0,15,0,0,2,17
7988,1702,2022-10-29 01:22:00,231578bdabad2c48fed77b90eca5adc1,0,7,0,0,2,9
7989,1702,2022-10-29 01:26:00,5e299a1064f2d20168f0bcda49a131a0,0,11,0,0,1,12
7990,1702,2022-10-29 01:32:00,9334e909a66fe751ed889f9ffae4d7e5,0,6,1,0,0,7
7991,1702,2022-10-29 01:38:00,4cb15efabe1aa3a4b97f9b983987e68a,0,10,0,1,0,11
7992,1702,2022-10-29 01:42:00,8c58b5d6ac84916361e105a1915132a2,0,9,0,0,1,10
7993,1702,2022-10-29 01:48:00,622bbd582a2c109e22709740a1b8b4ec,0,12,1,1,0,14
7994,1702,2022-10-29 01:52:00,3fbc2a16afd12456a08a7c9916c9e19b,0,11,0,0,1,12
7995,1702,2022-10-29 01:56:00,19b8110a818760024db24c0f2e6cc82d,0,4,1,0,1,6
7996,1702,2022-10-29 02:02:00,950bd103fbcbc63f3aea09be1c887065,0,11,0,0,0,11
7997,1702,2022-10-29 02:08:00,80e950f8e29400811942349f1a0aa6bc,0,6,0,0,0,6
7998,1702,2022-10-29 02:12:00,f92e20d7bd050117ccf6f29df866b140,0,6,2,0,1,9
7999,1702,2022-10-29 02:18:00,3a1b503d21934d16a81061dcce9ace79,0,3,0,0,1,4
8000,1702,2022-10-29 02:22:00,79f4da6cbfa9906d5aa877e99e39d0fb,0,10,1,0,0,11
8001,1702,2022-10-29 02:27:00,9eff1f7d012c07486c4899c3e20aa7ea,0,5,0,0,0,5
8002,1702,2022-10-29 02:31:00,e01c0a8b245a2de12211fcfb23ae4797,0,7,1,0,0,8
8003,1702,2022-10-29 02:37:00,e0a6e072c81352fd27ae48ce07b93cfc,0,12,1,0,0,13
8004,1702,2022-10-29 02:42:00,0e7995eebc412a33664f613c3a25da41,0,10,0,0,2,12
8005,1702,2022-10-29 02:47:00,327415561e17266c67b819cbc9e02fe7,0,10,0,0,1,11
8006,1702,2022-10-29 02:51:00,484665c77f031d857a9cd8e4b1324fa2,0,7,0,0,0,7
8007,1702,2022-10-29 02:57:00,be0c1b5eba2eabcbfcbaf862b6751d25,0,16,2,0,0,18
8008,1702,2022-10-29 03:01:00,957e03d319af25f3a9bd9eb2aa6cfae2,0,10,0,0,0,10
8009,1702,2022-10-29 03:07:00,996a9fe0417be4566aace944adfa9d46,0,5,0,0,0,5
8010,1702,2022-10-29 03:11:00,d195f9d3b2283b1824a6e4b67918d9b8,0,9,0,0,0,9
8011,1702,2022-10-29 03:17:00,35c878c34f503f0bd19e5d1642a69751,0,8,0,0,0,8
8012,1702,2022-10-29 03:21:00,9fe51e7cb31bca804e3eabc0f82691a9,0,9,1,0,0,10
8013,1702,2022-10-29 03:26:00,6a885faa23ac4d7f398148108a580b08,0,5,0,0,0,5
8014,1702,2022-10-29 03:32:00,a52d9738cb37d3e56248cc8aeaa72639,0,11,1,0,0,12
8015,1702,2022-10-29 03:37:00,e669efa20f29c0f8bb2004732d2068e6,0,9,0,0,1,10
8016,1702,2022-10-29 03:41:00,d31c6493d27f0d1c8722428d2e707e69,0,7,0,0,0,7
8017,1702,2022-10-29 03:47:00,578ba2694569e1cc9221d37e2fdd0376,0,5,0,1,0,6
8018,1702,2022-10-29 03:52:00,2c4caabc3746f7c5e3237f52ec2bbcf4,0,10,0,0,0,10
8019,1702,2022-10-29 03:56:00,7904592720cfbc22d66cc537482b0ce8,0,5,1,0,1,7
8020,1702,2022-10-29 04:02:00,f467b87f3e5afcd24779e5beded511aa,0,10,0,0,1,11
8021,1702,2022-10-29 04:07:00,830ea8a088d4521c26c34066bb7e065f,0,6,0,1,0,7
8022,1702,2022-10-29 04:12:00,3f6ac27449a73f84d4d5e5e9d8f6c3f3,0,2,0,0,0,2
8023,1702,2022-10-29 04:17:00,92030a87d135159a860c42f3c86560ae,0,3,0,0,1,4
8024,1702,2022-10-29 04:22:00,417c09f830173760b9096800ccfe5ce3,0,16,0,0,0,16
8025,1702,2022-10-29 04:27:00,5f786f0d4922f0ef4aa8f2791c6667b7,0,10,0,0,0,10
8026,1702,2022-10-29 04:31:00,1f4b8e1123051a32d55e108d113930f4,0,4,1,1,2,8
8027,1702,2022-10-29 04:37:00,a57a108fd01633f1a8ca8a34fa4922ec,0,4,0,1,1,6
8028,1702,2022-10-29 04:41:00,de840b48d7125e1e3794c41620d5d821,0,9,0,0,0,9
8029,1702,2022-10-29 04:47:00,527c640fdbb244fffaac09e950c0dec9,0,5,1,0,1,7
8030,1702,2022-10-29 04:51:00,cfa4083585788e070197ca7dbd166504,0,7,0,0,0,7
8031,1702,2022-10-29 05:02:00,e9e868d1c2f98e18e088fb552e1e2d43,0,9,0,0,1,10
8032,1702,2022-10-29 05:06:00,4fb053752b450077bd2568fc6275eb52,0,2,0,0,0,2
8033,1702,2022-10-29 05:12:00,1b0fd4d6d082110d9e3f37254598100c,0,5,0,0,0,5
8034,1702,2022-10-29 05:17:00,8ee93cbcd3f4317708d0a90985ae0bb9,0,6,3,1,0,10
8035,1702,2022-10-29 05:24:00,7d0cb4634dfc265b5af57dc7cd4e0522,0,2,0,0,1,3
8036,1702,2022-10-29 05:26:00,496fbb4a36c0f31437f1aa6de7f77185,0,6,0,1,0,7
8037,1702,2022-10-29 05:32:00,5afc4a18ee67f0129694ba10b6c778da,0,7,0,1,0,8
8038,1702,2022-10-29 05:37:00,6f505fd2fb5f10f181cafa1747c37e23,0,7,0,0,1,8
8039,1702,2022-10-29 05:41:00,20a72a504b35fc838a25d29eff186519,0,4,2,0,2,8
8040,1702,2022-10-29 05:47:00,52db4461b2634a337cd35766ca420edd,0,9,0,1,1,11
8041,1702,2022-10-29 05:52:00,44f1eb9146b4bc915d50c64e9bc4e830,0,8,1,0,0,9
8042,1702,2022-10-29 05:56:00,bcf9446c99445dc154b6f0643e4dd96e,0,7,1,0,1,9
8043,1702,2022-10-29 06:02:00,876a388f201cab5d2f019f023d5f3374,0,14,0,0,0,14
8044,1702,2022-10-29 06:06:00,c1a2adf1ac4b1a3ca94ee3cda00ce2cf,0,2,0,0,0,2
8045,1702,2022-10-29 06:11:00,c70f0d4d2ab0dee651588b588ba9f834,0,7,0,0,2,9
8046,1702,2022-10-29 06:18:00,0e19808edeeb76ade4c59db0dbff63a7,0,3,0,0,2,5
8047,1702,2022-10-29 06:23:00,7a17e6a0f2b3471c7663f7cf584476dc,0,9,0,0,4,13
8048,1702,2022-10-29 06:27:00,2249dc1c8734d33628e0549c2e21edcb,0,5,1,0,1,7
8049,1702,2022-10-29 06:31:00,5c6ecbf087eba8b88f9b4d1db13d3dfb,0,6,1,1,0,8
8050,1702,2022-10-29 06:37:00,5e11c7a4fedb4ffd9d881b1ef1eca52d,0,12,0,1,3,16
8051,1702,2022-10-29 06:42:00,c581b33413943d462830acb1c9e876a9,0,8,0,1,4,13
8052,1702,2022-10-29 06:47:00,e639eee5aa9bdf512bbe608292acd2df,0,14,0,2,2,18
8053,1702,2022-10-29 06:52:00,4283fcc39ec9392c5c06e69552ef209e,0,13,0,0,4,17
8054,1702,2022-10-29 06:57:00,e0299fe6df3f0ebc75390a3bef9f0294,0,13,0,0,4,17
8055,1702,2022-10-29 07:03:00,020144c7e04ca1c5de167d2a0a2b3d34,0,5,0,1,3,9
8056,1702,2022-10-29 07:08:00,1aecee7364ec6c48ae5d115d97ea89b7,0,8,0,0,7,15
8057,1702,2022-10-29 07:11:00,ec69ac33d54dd8330d18051fee11da67,0,6,0,1,4,11
8058,1702,2022-10-29 07:18:00,8cd3e2daa6fc3333f1822834005805c1,1,11,0,0,8,20
8059,1702,2022-10-29 07:23:00,dbc3cffe1dd5dc4f2fab03adfe74b12c,0,12,0,0,10,22
8060,1702,2022-10-29 07:27:00,b9cd513d23e402a7a7d3671087ed9b11,0,13,0,0,5,18
8061,1702,2022-10-29 07:33:00,bbfa01fbbf49e79d742e6b6395d0f68b,0,10,0,3,3,16
8062,1702,2022-10-29 07:38:00,2349138248bacfd6f6654bedbf8db7d1,1,11,2,1,7,22
8063,1702,2022-10-29 07:42:00,f5941af3c03ea175c4c90edeb216b057,2,14,0,1,14,31
8064,1702,2022-10-29 07:47:00,5e6e470b8a5624e3f8f959ff6f3b40ac,0,17,0,2,5,24
8065,1702,2022-10-29 07:52:00,88bc028a55dea543b0d9f3d8ca6da25b,0,9,0,2,11,22
8066,1702,2022-10-29 07:57:00,652f2a3fc03fc93414eac822ff186274,0,12,0,1,12,25
8067,1702,2022-10-29 08:02:00,34bc1ac27f3ac693e025c0e6fc0c0f1f,0,12,0,1,10,23
8068,1702,2022-10-29 08:07:00,c33e2e6a7ba28d53aea4f66c5c895d29,0,21,0,1,12,34
8069,1702,2022-10-29 08:13:00,c98839541e4bd8607fd3581584995fa4,1,11,0,2,9,23
8070,1702,2022-10-29 08:18:00,06aa98bc927ef20cb0a79534954c6a45,0,10,0,1,12,23
8071,1702,2022-10-29 08:22:00,f6f7b12a7cfcb6ec63bc14c2cc95860e,0,13,0,0,10,23
8072,1702,2022-10-29 08:28:00,e5fc64e327426349e3623a4066a505e3,0,10,0,2,8,20
8073,1702,2022-10-29 08:32:00,a5bdc9c0f8a07df401e4177916a718d8,0,12,0,1,8,21
8074,1702,2022-10-29 08:37:00,8c156c8c1fd9c33f1d1e2e8ec571910e,0,18,2,2,8,30
8075,1702,2022-10-29 08:42:00,42013ad1e8ef4d26dc619981e396e4f4,2,15,0,4,6,27
8076,1702,2022-10-29 08:48:00,53fd91334f0d6a12345269dc27dc2acc,0,14,0,4,11,29
8077,1702,2022-10-29 08:53:00,c55c9bd0a9d2cc331235dc0ff2046071,0,13,1,6,7,27
8078,1702,2022-10-29 08:57:00,a0630cb5bba27a00f48c96b9a21c25c0,0,15,0,0,14,29
8079,1702,2022-10-29 09:03:00,0a371504ccac49cdd01293c106c68574,0,18,3,2,12,35
8080,1702,2022-10-29 09:08:00,6ea7092af934f723ae30979acf728760,1,12,1,4,12,30
8081,1702,2022-10-29 09:12:00,21d8539d9c2186aa036d88389dac5017,0,16,0,0,8,24
8082,1702,2022-10-29 09:17:00,2b2957485e0f5956d00a4eac3d3aa4bc,0,9,0,4,12,25
8083,1702,2022-10-29 09:22:00,66067f85cf584679843aa23a55dcdc46,1,12,0,1,10,24
8084,1702,2022-10-29 09:27:00,28890f4f27541070d9a83c99f3724a61,0,12,0,2,6,20
8085,1702,2022-10-29 09:32:00,d88385592e44e565f6c42f4396c29d87,2,16,0,1,11,30
8086,1702,2022-10-29 09:38:00,ab76d7085aeeef23edc27641b9ea8a79,0,14,0,0,10,24
8087,1702,2022-10-29 09:42:00,0a3d9e98b5984017c991aac12497490d,0,13,0,2,9,24
8088,1702,2022-10-29 09:48:00,44a89f65b08699707f370072eb652fc8,0,15,0,4,8,27
8089,1702,2022-10-29 09:53:00,0221bdcaa66bd9f767a10494320215b1,0,20,0,3,9,32
8090,1702,2022-10-29 09:57:00,26c30217c2615428c68358a2c9d6b442,0,16,0,4,12,32
8091,1702,2022-10-29 10:02:00,8de34caf38ae23d474b7c253651f6ccd,0,18,1,10,5,34
8092,1702,2022-10-29 10:08:00,51b681771ac2f4e5a9180b1d37a99eb6,0,15,1,2,9,27
8093,1702,2022-10-29 10:11:00,d037806d9382d7904c8a9365653e2bc6,0,16,0,3,9,28
8094,1702,2022-10-29 10:17:00,f758c1430031986d9ff273bca67e9972,0,12,0,6,5,23
8095,1702,2022-10-29 10:22:00,1cb8a28385314bfdd315332c8315a972,0,16,2,2,17,37
8096,1702,2022-10-29 10:27:00,b29aea4f4800cb3ac96dc09e8fb20cc2,1,6,0,2,13,22
8097,1702,2022-10-29 10:32:00,d3802e343b7459f817558c7ea6a6fbf6,0,12,0,5,12,29
8098,1702,2022-10-29 10:37:00,9c02b6366614440ab100f3c3cf9a8e60,0,13,0,1,13,27
8099,1702,2022-10-29 10:43:00,6ee24e16570359bad49c0a3a12e95d81,0,14,0,1,13,28
8100,1702,2022-10-29 10:47:00,def6e9a2b5c16c9564837f7258a18ee3,0,13,0,1,12,26
8101,1702,2022-10-29 10:52:00,1e8a6fac374ed7ba119a02948bb5f8e1,0,13,0,1,13,27
8102,1702,2022-10-29 10:57:00,8cae0a0312693a4f43f824984ffc2be0,0,13,0,2,12,27
8103,1702,2022-10-29 11:03:00,162ba2b40c11cc9f4cdb02a0115d98ad,0,6,0,3,11,20
8104,1702,2022-10-29 11:07:00,318cf8ac6b3d21dafd3ea56d875a3d8a,0,8,0,4,15,27
8105,1702,2022-10-29 11:12:00,50e863c4ff08db504fc4ea4224f5fcbc,2,8,0,1,10,21
8106,1702,2022-10-29 11:18:00,233f7fa4c77c2a9da405b18437070a79,0,17,0,1,12,30
8107,1702,2022-10-29 11:22:00,ada3604fc84fa45d09f66d2dc8c53f92,1,19,0,3,10,33
8108,1702,2022-10-29 11:26:00,5cf22f76949fb0fb3320bfa8bcea9cb0,0,13,0,1,12,26
8109,1702,2022-10-29 11:32:00,49d31d1bb7d3b1ee3cd6fc2a7031cbfc,0,14,0,3,9,26
8110,1702,2022-10-29 11:38:00,4094387587740430828d20846837487c,0,19,0,1,6,26
8111,1702,2022-10-29 11:42:00,4257f29934735a77a507b0f3418a963e,0,11,0,2,8,21
8112,1702,2022-10-29 11:47:00,ac3e07595a8fb25312154f82a2968f84,0,12,0,2,13,27
8113,1702,2022-10-29 11:52:00,ade29e9ee7c8acb0969f1d24f948a672,0,11,0,3,6,20
8114,1702,2022-10-29 11:56:00,e7e0df2dbf672defd40a1176ad081d2c,0,13,0,4,7,24
8115,1702,2022-10-29 12:02:00,a1812a64edbc1d9764aae42115da0aec,0,16,0,1,9,26
8116,1702,2022-10-29 12:07:00,1829421fce58939ffa3b7b2003e51ee9,0,10,0,2,10,22
8117,1702,2022-10-29 12:11:00,d7d439e1ce33fe8cbf87f94ff9c56cad,0,11,0,3,12,26
8118,1702,2022-10-29 12:18:00,7893f08a5f7e4b90249e7bc200a05d58,0,13,1,1,9,24
8119,1702,2022-10-29 12:23:00,e3a0c529feb0f9a6a3b861b0ad0a8e21,0,15,0,1,11,27
8120,1702,2022-10-29 12:28:00,585a813e374a3d47dca0586c3ec85da6,0,10,0,2,11,23
8121,1702,2022-10-29 12:32:00,d3fba3258af299e0c4c2b7d5e396bf34,0,11,0,4,11,26
8122,1702,2022-10-29 12:37:00,f0722e157ca435d4a54aeee413060f4c,0,18,0,2,6,26
8123,1702,2022-10-29 12:42:00,ae5f7cb9a5b765350251a5a88fc34277,0,13,0,0,9,22
8124,1702,2022-10-29 12:48:00,282c685685d1eb0f2169a764028324f4,0,10,1,1,10,22
8125,1702,2022-10-29 12:52:00,951f20c237b98e1b61d034bc7105fe11,0,16,0,3,6,25
8126,1702,2022-10-29 12:56:00,2d361ddd16764e4c82539ca31efe576b,0,14,0,1,9,24
8127,1702,2022-10-29 13:02:00,bb4657e8f418c25f06e641aac3f122b2,0,15,0,3,6,24
8128,1702,2022-10-29 13:07:00,32791050b469a347b65ec2374b89139e,0,16,0,0,5,21
8129,1702,2022-10-29 13:12:00,1e8be090c9e4dd1c57dce134d7bd35f2,0,17,0,3,7,27
8130,1702,2022-10-29 13:17:00,3c08913abc78caff98cf4f336d1665ec,0,12,0,1,12,25
8131,1702,2022-10-29 13:23:00,4760d4941459444dc1c77e51f9322dc9,0,18,0,5,5,28
8132,1702,2022-10-29 13:27:00,c4a085b0395d7e2426840bd0273992f1,0,21,0,3,1,25
8133,1702,2022-10-29 13:34:00,fdde98e0d8b1cebaed5d255b413c03bb,0,17,0,7,3,27
8134,1702,2022-10-29 13:37:00,e251b902a9dbc1b88c7b9c17d900825c,0,14,0,1,10,25
8135,1702,2022-10-29 13:43:00,4a683afc9d1ab16eaa38cc7d6ba41eb5,0,10,0,7,11,28
8136,1702,2022-10-29 13:47:00,eaecfa078de53fb3d864b3249c41542f,0,15,0,2,10,27
8137,1702,2022-10-29 13:52:00,9fea1d298942f785aeddfddf5bdf8de5,0,20,0,6,5,31
8138,1702,2022-10-29 13:56:00,5a400b9de87bede24fac9d9242da4830,0,17,0,2,9,28
8139,1702,2022-10-29 14:02:00,ab9396dd796f3b03274edad12e1500d5,0,21,0,2,6,29
8140,1702,2022-10-29 14:07:00,fec7a013d58c2997d82f1dd1c8858e2a,1,11,0,7,7,26
8141,1702,2022-10-29 14:13:00,d181085ee4efd3da875410ecbf2d983a,0,14,0,3,9,26
8142,1702,2022-10-29 14:17:00,1fa0800e2da70c79b7c3b9aa51a36020,0,20,0,1,7,28
8143,1702,2022-10-29 14:22:00,0ea1126fe308b7e6a1fe2594228ca08a,0,20,0,3,4,27
8144,1702,2022-10-29 14:27:00,73e7f8c23126591acb64ea24e942df54,0,18,0,4,8,30
8145,1702,2022-10-29 14:32:00,ae9870286b403ab9c607976381ff3722,0,18,0,0,8,26
8146,1702,2022-10-29 14:38:00,20a3ef2db4b6415c43958b4cd29b505d,0,18,0,0,7,25
8147,1702,2022-10-29 14:42:00,00f8a13b14e8ccb64ed5f77da0057995,0,23,0,4,3,30
8148,1702,2022-10-29 14:47:00,b8c33c0557c30dc8b756c691e8aa842a,0,12,1,2,5,20
8149,1702,2022-10-29 14:53:00,ca459517dd5744020543e8d2b9c995de,0,16,1,0,7,24
8150,1702,2022-10-29 14:56:00,5200cad4b616437930b7e25fd04aefad,0,14,0,2,10,26
8151,1702,2022-10-29 15:03:00,b9fa3d48624f401195946aa27debb7a2,0,19,0,1,13,33
8152,1702,2022-10-29 15:08:00,7d989523d9be856b008298638b3defd8,0,11,0,1,10,22
8153,1702,2022-10-29 15:12:00,c5e29466d8ed1dcebd57b6d417a17227,0,12,1,1,8,22
8154,1702,2022-10-29 15:18:00,bffd84223041134b4d79e0f6eaaf2ba3,0,10,0,5,7,22
8155,1702,2022-10-29 15:23:00,153ce62ae0348bb0827a649d22a16202,0,15,0,3,14,32
8156,1702,2022-10-29 15:27:00,4218d645ab5891b8ea715e39c993b04e,0,12,0,1,8,21
8157,1702,2022-10-29 15:32:00,633834c3a9e182bbd4ce25a91eca6e5e,0,17,0,0,6,23
8158,1702,2022-10-29 15:37:00,89c50ebf0179aa718d76b51fecc9bfd7,0,19,0,6,7,32
8159,1702,2022-10-29 15:42:00,73e11b851095ae7c502341800ce334ac,0,12,0,0,9,21
8160,1702,2022-10-29 15:48:00,8dd66724ffbf0dabe1e818d5e8626e3a,0,19,0,3,6,28
8161,1702,2022-10-29 15:53:00,d6071c182960a109ccdfac552b71c8f2,1,10,0,2,11,24
8162,1702,2022-10-29 15:57:00,7c1d6b8b5f08d96d1096b069e70e7c76,0,13,0,3,7,23
8163,1702,2022-10-29 16:03:00,72777659ccbce788a43abcd4c014e2e3,0,7,0,3,10,20
8164,1702,2022-10-29 16:07:00,d9fcf3dec73e19463f2a13625d9ff8b6,0,18,0,2,9,29
8165,1702,2022-10-29 16:12:00,04ddc6b32e7bda85ffb6dedac2b1d2a0,0,13,0,1,17,31
8166,1702,2022-10-29 16:17:00,6cbe4a21b204a9e14bdbc2a713cb6e05,0,17,2,1,9,29
8167,1702,2022-10-29 16:22:00,0f698b6ee3e530e5665ca58216f26b38,0,14,2,4,3,23
8168,1702,2022-10-29 16:27:00,778c83bda6d49095435a922b5be29dbb,0,8,0,0,11,19
8169,1702,2022-10-29 16:32:00,9268f46e6a7bb4da289666393f982c64,0,16,0,1,9,26
8170,1702,2022-10-29 16:37:00,4eb3289405c45ac8989f74f187af2a97,0,15,0,3,7,25
8171,1702,2022-10-29 16:43:00,280362e9a1005244b37755fbb1edcd75,1,21,1,3,10,36
8172,1702,2022-10-29 16:47:00,b90b3b97e0c3d82fcfb3e3670e073a5f,0,10,0,0,13,23
8173,1702,2022-10-29 16:53:00,1d69e599681e2348a6a6a37856301c38,0,9,0,1,13,23
8174,1702,2022-10-29 16:57:00,ad63607f2b7c87022a2647aa08df9451,0,16,0,0,10,26
8175,1702,2022-10-29 17:02:00,9940735319ffdd44ddcacfb8f1940773,0,9,0,2,14,25
8176,1702,2022-10-29 17:07:00,0435eaef45f707ca5a897a00cf4ce20d,1,9,0,0,14,24
8177,1702,2022-10-29 17:12:00,ed2efda5ef968555b872615ae936cc4d,0,12,0,1,13,26
8178,1702,2022-10-29 17:17:00,51fd20b8694334527d37c784f6c93161,0,13,0,3,4,20
8179,1702,2022-10-29 17:22:00,b5e772db5f5265951216ce8b539d30f6,0,11,0,0,12,23
8180,1702,2022-10-29 17:27:00,d0cc0e04950ead90b3f9afbba776b301,0,12,0,8,8,28
8181,1702,2022-10-29 17:33:00,5e6c1722ecb1eb8d3bdeed3798bf1a43,0,21,0,2,4,27
8182,1702,2022-10-29 17:37:00,24a5fce70d8ee1fb92adca4ce2404d35,0,16,0,3,8,27
8183,1702,2022-10-29 17:42:00,7b91144308c1f20fc0587e558c04006a,0,13,0,0,12,25
8184,1702,2022-10-29 17:47:00,4e3952cdc3c87ca994afa9ed50229186,0,24,0,2,6,32
8185,1702,2022-10-29 17:53:00,e593bb6d2e8d8e5cc821abe1bfc21fb7,0,11,0,1,11,23
8186,1702,2022-10-29 17:57:00,b30893c852cb5dd2d29159149f2ea871,0,16,0,4,13,33
8187,1702,2022-10-29 18:03:00,4167599a6aa752611281f1ac8b5dd050,3,18,0,5,8,34
8188,1702,2022-10-29 18:07:00,fa422cac81a03d6078df40c69990ed8a,0,15,1,8,8,32
8189,1702,2022-10-29 18:12:00,226877fb779d23411b426a2c61e8ca61,0,19,0,8,4,31
8190,1702,2022-10-29 18:17:00,1259e24d47f7ac92250e1eb86eab5547,0,16,0,4,10,30
8191,1702,2022-10-29 18:23:00,265a8862de10a97d8b6d3feb4992e0ed,0,17,1,4,8,30
8192,1702,2022-10-29 18:28:00,51e56d63831c4309ff20b327e86adc42,7,16,0,0,19,42
8193,1702,2022-10-29 18:32:00,239733117f408178c439cf064c266b0f,0,19,1,3,13,36
8194,1702,2022-10-29 18:37:00,1b1c1759397a8599fbee4c11518bc0d7,1,23,0,4,13,41
8195,1702,2022-10-29 18:42:00,468ca87570a786b784ed88ddc77e9ef1,0,17,0,2,13,32
8196,1702,2022-10-29 18:48:00,36a4145be4ebf385ffc69003f0e3f79c,0,22,0,1,8,31
8197,1702,2022-10-29 18:52:00,2f0da1d4ea6c0361d21febdfd9687c41,0,27,0,1,4,32
8198,1702,2022-10-29 18:56:00,f62a7bb064dc3a1492c309638e3eaa12,0,26,0,1,11,38
8199,1702,2022-10-29 19:02:00,a09c609e09d5b41a0d64854589b996ee,0,30,0,2,1,33
8200,1702,2022-10-29 19:08:00,f3943c20fe9f205d4da3d68c71b631a8,0,23,3,1,2,29
8201,1702,2022-10-29 19:12:00,b8e3342dfaea58703159bcf4603bbb1c,0,19,0,0,0,19
8202,1702,2022-10-29 19:17:00,8ef0f0f4ab61660ee02721fdf1519d56,0,20,0,3,0,23
8203,1702,2022-10-29 19:22:00,c5616ed7b9f5e18b5817e27f296681c7,0,21,1,0,1,23
8204,1702,2022-10-29 19:27:00,610cfd2427210b00c76868a036e9fa9b,0,17,0,1,1,19
8205,1702,2022-10-29 19:32:00,2630d1b036376c4ea1b11d4e1929c21f,1,22,1,1,2,27
8206,1702,2022-10-29 19:37:00,602bb086a7fc3cccba959a871cb3e176,0,16,2,0,1,19
8207,1702,2022-10-29 19:42:00,f31c6a73a15b63f717c58e561d7f6258,0,22,1,0,0,23
8208,1702,2022-10-29 19:46:00,7d7203814a484965e4b3b6b45d693148,0,20,2,0,2,24
8209,1702,2022-10-29 19:51:00,d3b345c3c5ac20c61ac18bea7d8d3839,0,25,1,1,1,28
8210,1702,2022-10-29 19:57:00,bd2526f601d51fc887777cd11f03be48,0,23,0,0,1,24
8211,1702,2022-10-29 20:02:00,7d6a9bfa56dcd9775f5bd8d8f68de114,0,21,0,0,0,21
8212,1702,2022-10-29 20:07:00,a2bb14eaad24f7b1aa19c41ca691ab1e,0,12,1,0,1,14
8213,1702,2022-10-29 20:12:00,1f04772f2d792e4cff5aff16348c5e2b,0,14,0,0,0,14
8214,1702,2022-10-29 20:17:00,8840d53f2da4cacbfb987b04365bba20,0,11,3,0,0,14
8215,1702,2022-10-29 20:22:00,93627f555ec9d4d4e79cb6a23a988e26,0,17,0,0,1,18
8216,1702,2022-10-29 20:26:00,bb59f4b4496a381cd4af9ec4ca731f9e,0,13,1,0,1,15
8217,1702,2022-10-29 20:32:00,514db27ec5382a030a67e09503b78c05,0,17,0,1,0,18
8218,1702,2022-10-29 20:37:00,c60725589fe1fbb36c15d0d941b20851,0,26,1,0,1,28
8219,1702,2022-10-29 20:42:00,351574f69959699c02906ed87b27588d,1,21,0,0,2,24
8220,1702,2022-10-29 20:46:00,9b01b2e225a9295d22807af63f943c6f,0,15,1,0,0,16
8221,1702,2022-10-29 20:53:00,ffd556b6ffbd91334f0fefe467e03972,0,16,0,0,0,16
8222,1702,2022-10-29 20:57:00,0d9ca1e734a63881a8ef09590cfec1ec,0,20,4,0,1,25
8223,1702,2022-10-29 21:02:00,9260d1a4d359cbe589d4c4368eda2e2c,0,17,0,0,1,18
8224,1702,2022-10-29 21:07:00,231f5a2be8f68c3ab2ced6b001a936f7,0,15,1,0,1,17
8225,1702,2022-10-29 21:12:00,da6ffa3833ec04106a5c1bac7d755918,1,14,2,1,3,21
8226,1702,2022-10-29 21:17:00,f0091f0e1179a04ff52ad0169db5127e,0,13,1,1,0,15
8227,1702,2022-10-29 21:22:00,0fffb80d22ae84184022dbfb3460fb41,0,22,4,0,0,26
8228,1702,2022-10-29 21:26:00,765d630426af934703bf76c9d1813695,0,20,1,0,3,24
8229,1702,2022-10-29 21:32:00,ea9f3e0bf1c879d80afd1441ec03357b,0,18,1,0,0,19
8230,1702,2022-10-29 21:37:00,e871d712d0fcfe2b28357b85598217d5,0,15,3,0,2,20
8231,1702,2022-10-29 21:42:00,3464b25bffa29d540d2e5b60674f858c,0,22,1,0,0,23
8232,1702,2022-10-29 21:47:00,2452adfab3610a577f88d87c7738f477,0,23,0,1,0,24
8233,1702,2022-10-29 21:52:00,1cbfad573c1389f3f5f1c45b27b61e1c,0,14,0,0,1,15
8234,1702,2022-10-29 21:56:00,7e99d2ce18a131c52a0160d6564b7e9c,0,28,0,0,0,28
8235,1702,2022-10-29 22:01:00,c50bd72f2e8f05e3ea07328ad50622eb,0,19,0,0,1,20
8236,1702,2022-10-29 22:06:00,d84ae26ca2f952b4da2b05f7ad62ebac,0,20,0,0,1,21
8237,1702,2022-10-29 22:12:00,5a839e96d14a302c6e7df020d13197cc,0,19,2,0,1,22
8238,1702,2022-10-29 22:17:00,3cd45420f95f36cd9baf1d7157ceb7e4,0,18,1,0,0,19
8239,1702,2022-10-29 22:22:00,2b922b72b35c1072c035de0961419c01,0,21,0,0,2,23
8240,1702,2022-10-29 22:26:00,9aca52518aec1901d9acb8ff7b5e0bc7,0,13,0,0,0,13
8241,1702,2022-10-29 22:32:00,4c33ca99ee547b644810a5e5b5d5b920,0,15,0,1,1,17
8242,1702,2022-10-29 22:37:00,4e71832210bd5a55f77fbb5d66341959,0,20,0,0,1,21
8243,1702,2022-10-29 22:42:00,89e1b1c117a6f4ceadb7ada2b691fa36,0,16,0,1,1,18
8244,1702,2022-10-29 22:47:00,972ec87989c0e16c983f7607d1177188,0,21,0,0,1,22
8245,1702,2022-10-29 22:52:00,4c0dc8798e5cc476370a131ab4fd2081,0,15,2,1,1,19
8246,1702,2022-10-29 22:56:00,3d6e17191ecb5b3ff143f0335444fa27,0,11,1,0,0,12
8247,1702,2022-10-29 23:02:00,f6327aaf2a7d6dfc1aed29a732e48fe3,0,14,1,0,1,16
8248,1702,2022-10-29 23:07:00,f3731646b2d00fec709a4b64754c2b80,0,17,0,0,0,17
8249,1702,2022-10-29 23:11:00,02fc20baafbde629f8e2ff8373efceec,0,12,1,0,0,13
8250,1702,2022-10-29 23:18:00,4dcd62994391553f9a4e8af70fbc100b,0,7,3,0,0,10
8251,1702,2022-10-29 23:22:00,1ec53587d18587e8d6efbe7c0e365c24,0,15,1,0,1,17
8252,1702,2022-10-29 23:27:00,89034e21f3f84951a89d557ba2ca1d70,0,8,1,0,1,10
8253,1702,2022-10-29 23:33:00,08624f55461fc6789487ba6b52b80ee0,0,18,3,0,0,21
8254,1702,2022-10-29 23:37:00,366ce7dbc933208b28c82f96cfb20d08,0,20,0,0,0,20
8255,1702,2022-10-29 23:42:00,09810fb68e6a44978733e1cef783f059,0,20,0,0,0,20
8256,1702,2022-10-29 23:47:00,b917900820d8bdeff84192ce1245be46,0,17,0,0,0,17
8257,1702,2022-10-29 23:51:00,0e07abcf08da03fdd68e110584d97c52,0,15,0,0,3,18
8258,1702,2022-10-29 23:56:00,39fcf74a00c55dec9d57a17a72f06314,0,16,0,2,0,18
8259,1702,2022-10-30 00:01:00,009b474e880a72961fd244776d88f70b,0,15,1,0,0,16
8260,1702,2022-10-30 00:06:00,1fe0023726316a491fc267a32f461ae0,0,17,0,0,0,17
8261,1702,2022-10-30 00:12:00,7d776a61b71c84ca6a47f6147c76eca7,0,12,1,0,0,13
8262,1702,2022-10-30 00:17:00,b78c20fd5d0738556fa82a8d79d818e7,0,10,0,0,0,10
8263,1702,2022-10-30 00:21:00,58f0752a5b934ec6332f331c22b2b801,0,11,0,0,0,11
8264,1702,2022-10-30 00:26:00,361fa0f516c638a614bd99d954ea7c7f,0,12,0,0,1,13
8265,1702,2022-10-30 00:32:00,c7f53bc2d76874d09b7179b263c686af,0,9,0,0,1,10
8266,1702,2022-10-30 00:37:00,db4a52d44a1f99a0190b754bccb8f0da,0,5,2,0,0,7
8267,1702,2022-10-30 00:42:00,1dba63d7b9aeecab4ea65e7812d30855,0,9,1,0,0,10
8268,1702,2022-10-30 00:47:00,e1238dd2b8c24b17c5bbb558f42ba491,0,8,0,0,0,8
8269,1702,2022-10-30 00:52:00,4a8d72dd2277928328bf5251bc48bd7e,0,13,0,2,0,15
8270,1702,2022-10-30 00:56:00,aca6385458b795b451803be7cb53640f,0,11,0,0,1,12
8271,1702,2022-10-30 01:02:00,4451493ff6dc36e3f29f53fa87f7d666,0,6,0,0,0,6
8272,1702,2022-10-30 01:17:00,509f094b7c51eda376a0f318412513d1,0,7,2,0,2,11
8273,1702,2022-10-30 01:21:00,15a5839e4c3ca7f273405ebd761301c0,0,12,1,0,2,15
8274,1702,2022-10-30 01:26:00,4388c966346e6571b1730d62ebab3421,0,5,2,0,1,8
8275,1702,2022-10-30 01:32:00,4f3a3574b8dbe5b4a4df234d13686d4f,0,9,0,1,0,10
8276,1702,2022-10-30 01:37:00,5a9a06fed22a46b61da6ef3bedf4d64f,0,3,2,0,0,5
8277,1702,2022-10-30 01:42:00,b7acd775071671619f243c18c68904d6,0,8,0,0,0,8
8278,1702,2022-10-30 01:47:00,9af81be9bc15054bbe41d825c887bf30,0,11,1,0,0,12
8279,1702,2022-10-30 01:52:00,c905c6b9f256abfffd3c1df55da6098c,0,12,0,0,2,14
8280,1702,2022-10-30 01:57:00,43388776bb9b83273e83134430e23fb7,0,8,0,0,0,8
8281,1702,2022-10-30 02:02:00,e9892088160cd54a770c05a92ae58d1e,0,7,2,0,1,10
8282,1702,2022-10-30 02:07:00,815912c51221a14477e9a7db3b6006cd,0,2,0,0,0,2
8283,1702,2022-10-30 02:12:00,d4fbc53597db5702f5a62c764f393e50,0,9,0,0,0,9
8284,1702,2022-10-30 02:17:00,b56ec4b5542e8521e0792f2b6dcbc399,0,14,0,0,0,14
8285,1702,2022-10-30 02:21:00,c267302f2c15e2ec6afacb7d6c88938e,0,9,2,1,0,12
8286,1702,2022-10-30 02:26:00,09765588b3a8e7ae707a5acfa0d10cca,0,7,2,1,1,11
8287,1702,2022-10-30 02:32:00,9945839fc8dafad4ec545479bf6a16fc,0,11,0,0,0,11
8288,1702,2022-10-30 02:37:00,51be666285085913d1c843818b691cb4,0,8,0,1,0,9
8289,1702,2022-10-30 02:41:00,cc983f25304ffce6a81e8859687e5204,0,7,1,0,0,8
8290,1702,2022-10-30 02:47:00,97eb4c79a0b471ef6002109540bfe599,0,7,1,0,0,8
8291,1702,2022-10-30 02:51:00,86c34d63749d3d43ebaa64b8020d9aa0,0,17,0,0,0,17
8292,1702,2022-10-30 02:56:00,1114872b870bc41d022d0bfc23c265b5,0,7,0,0,0,7
8293,1702,2022-10-30 03:01:00,6854088de3dc79bfba9162503f94b2b0,0,3,0,0,0,3
8294,1702,2022-10-30 03:07:00,23da017130283ca49e42d19e0de93eb2,0,6,0,0,1,7
8295,1702,2022-10-30 03:12:00,aff4df876f3a9a93e88a63923a789038,0,1,0,0,0,1
8296,1702,2022-10-30 03:17:00,47b72f3f2a485f5cd395a277a40504ff,0,7,0,0,0,7
8297,1702,2022-10-30 03:21:00,8b1fb2feb571800e477496b9d4a28477,0,9,1,0,0,10
8298,1702,2022-10-30 03:26:00,201fb14012655394b7f726f0e924d765,0,6,2,0,1,9
8299,1702,2022-10-30 03:32:00,c492436d2f08033a2e3710dbd1610016,0,7,1,0,1,9
8300,1702,2022-10-30 03:36:00,d2f2faa250bbdb342bfa69d5df34ea28,0,14,0,0,1,15
8301,1702,2022-10-30 03:41:00,31f107e73b40857d8b58799222a2dfb4,0,8,0,0,0,8
8302,1702,2022-10-30 03:47:00,c933d0958dc1f42f8b0b6da489168f69,0,4,0,0,2,6
8303,1702,2022-10-30 03:52:00,fc61d32b20766fe5ec06a0edd4b2c388,0,10,0,0,1,11
8304,1702,2022-10-30 03:56:00,0f5edc1f46009b4a8f3fa26ac7636b5f,0,4,0,0,0,4
8305,1702,2022-10-30 04:06:00,1821aad9fd706f693b7f5e675aec61c8,0,8,0,0,0,8
8306,1702,2022-10-30 04:12:00,b4aff1e8633352d431bd2a77fa6d822a,0,11,0,0,0,11
8307,1702,2022-10-30 04:17:00,c708cfc71e7f5f6ed8c364e05dd28c0f,0,10,1,0,1,12
8308,1702,2022-10-30 04:22:00,fda931f6ca38c123a5668616ba8ec758,0,3,1,0,0,4
8309,1702,2022-10-30 04:26:00,f22343a3f49d2c1310a8d8d8092af466,0,4,0,0,1,5
8310,1702,2022-10-30 04:31:00,67c8a152d50defadff3b737525f36579,0,10,1,0,2,13
8311,1702,2022-10-30 04:36:00,2d289d8e015139abdfd2838194c8c5b5,0,5,0,0,3,8
8312,1702,2022-10-30 04:41:00,70b2826265e0efe51e1a5ef508ec7270,0,13,0,0,0,13
8313,1702,2022-10-30 04:46:00,73c4c9519a99b69ba6883fe4a5663ef7,0,6,1,0,0,7
8314,1702,2022-10-30 04:52:00,ff709366b76b6c6f8728b504bfaad452,0,4,1,0,0,5
8315,1702,2022-10-30 04:56:00,21fae62700635e3a9fefe147bb1e716c,0,6,0,2,1,9
8316,1702,2022-10-30 05:01:00,143a41dbdd80391e739df3ee24e56e2a,0,3,1,0,0,4
8317,1702,2022-10-30 05:07:00,c7a896c544c8e0f306f0eb7df2df110a,0,6,0,0,0,6
8318,1702,2022-10-30 05:11:00,dd1b01f9903fb2f81b5525d6381902e5,0,4,0,1,0,5
8319,1702,2022-10-30 05:17:00,11a13e88a0ee95670e0f1a487db7bf9b,0,4,1,0,1,6
8320,1702,2022-10-30 05:22:00,0ed31cf8f9c0e6f6ffd0fac77a11db67,0,7,1,0,0,8
8321,1702,2022-10-30 05:27:00,de6f40d53d9413c5b08c7df1acbb49c4,0,4,0,0,1,5
8322,1702,2022-10-30 05:32:00,bcb264995ca2b880fb6e4b4044c488f6,0,4,1,0,0,5
8323,1702,2022-10-30 05:36:00,8e75f9bdce9319d2fff5524212053bc5,0,7,0,0,0,7
8324,1702,2022-10-30 05:42:00,5cf09b7ce0634899d78722d6f146057e,0,3,0,0,1,4
8325,1702,2022-10-30 05:47:00,95353053007422d908148156f61549bb,0,6,1,1,1,9
8326,1702,2022-10-30 05:52:00,a287463faf89d901769672d1259a4cbf,0,10,0,1,1,12
8327,1702,2022-10-30 05:57:00,710d8c916de4d49ad0806e4b54350fef,0,9,0,0,0,9
8328,1702,2022-10-30 06:02:00,8328f5dda0c4539f38000869603ad110,0,1,0,0,1,2
8329,1702,2022-10-30 06:07:00,04a19a70f9f15c78538b2e9f6acc333a,0,6,0,1,0,7
8330,1702,2022-10-30 06:12:00,fc39799208c1d242846c80d73e0c0cee,0,3,0,0,0,3
8331,1702,2022-10-30 06:16:00,6a657ce585536c5c7c719ae0feb76624,0,12,0,0,0,12
8332,1702,2022-10-30 06:22:00,6d696a488a018151b85cc192b841a93a,0,6,0,0,0,6
8333,1702,2022-10-30 06:27:00,2027fd732c04ca4c954a97182cb039f8,0,13,0,0,0,13
8334,1702,2022-10-30 06:31:00,baadaaabdd5b41e62cc971980e79e121,0,9,2,0,0,11
8335,1702,2022-10-30 06:37:00,91cd747147f62ec2e46540915b6e4b4d,0,6,0,0,0,6
8336,1702,2022-10-30 06:42:00,aefc49b29d2a720b3701940b89e58e89,0,14,2,0,1,17
8337,1702,2022-10-30 06:47:00,1d4e79e38ecf803ee38dc12d7db27af4,0,7,0,0,0,7
8338,1702,2022-10-30 06:52:00,77a2ebc0f84eb62c48f84187371a06ee,0,8,0,1,1,10
8339,1702,2022-10-30 06:56:00,d2dd46f731278e963c546aad1cdda633,0,18,1,0,1,20
8340,1702,2022-10-30 07:02:00,b1dd37a9d9f96a054c37ac1d844fbaa9,0,6,0,0,3,9
8341,1702,2022-10-30 07:07:00,766f4d61be00c1c4e9d4c2bb79f71cc0,0,13,0,0,4,17
8342,1702,2022-10-30 07:12:00,d56f95eb256f3931bebcd26181161108,0,9,0,1,5,15
8343,1702,2022-10-30 07:17:00,17d3eaa7b82a59dfb922681d6dfcaa23,0,11,0,0,2,13
8344,1702,2022-10-30 07:23:00,36dafbcaae1d3c46f72a91dd6cb35dda,0,10,0,1,2,13
8345,1702,2022-10-30 07:26:00,f2edbef975703eb894e45a3426a07633,0,17,1,0,5,23
8346,1702,2022-10-30 07:32:00,d70e44d139cb9a874423993333105cd2,0,4,0,2,5,11
8347,1702,2022-10-30 07:37:00,ebe2afb3e54b1365fa1efa34e499559f,0,12,0,0,6,18
8348,1702,2022-10-30 07:42:00,27347442bb8435cb76e05573d86c599c,0,16,1,1,2,20
8349,1702,2022-10-30 07:47:00,ba4a8c02e9ff1d346cd59a3524fe18ef,0,13,0,0,7,20
8350,1702,2022-10-30 07:52:00,4f2590729e13917b6424f2552c3fddfb,0,9,0,1,7,17
8351,1702,2022-10-30 07:56:00,dcc4a81c7d8f005a1abad2093b8dbaef,0,12,0,0,6,18
8352,1702,2022-10-30 08:01:00,8f6c1d885cd9c9bb4d1c2a1002ec30ec,0,14,1,0,7,22
8353,1702,2022-10-30 08:06:00,ee3e81300619285bcd870e05334ba6c8,0,10,0,1,5,16
8354,1702,2022-10-30 08:12:00,1f4652f325fc47e0e44dc1f453bd327e,0,17,0,2,9,28
8355,1702,2022-10-30 08:17:00,7d42983a48746d9de78104944a351532,1,7,0,2,8,18
8356,1702,2022-10-30 08:22:00,37a3b107d1bab82660b23f97c3b960ff,0,12,0,0,8,20
8357,1702,2022-10-30 08:27:00,e8ea4d9b2c7ffad7602e08f59332e9f3,0,17,0,1,5,23
8358,1702,2022-10-30 08:32:00,a9eb76e61fd480647507ed997514cc6d,0,7,0,1,6,14
8359,1702,2022-10-30 08:37:00,c54fe273ecae2c5bb28b97a3c5e6430c,0,19,1,2,6,28
8360,1702,2022-10-30 08:41:00,af013a5056192a47b815325ddafa3ab2,0,14,0,4,7,25
8361,1702,2022-10-30 08:47:00,f75566bd1eab99c42efaf5859a64fedc,0,17,0,3,6,26
8362,1702,2022-10-30 08:52:00,d945a6d436fd0819f4d4ad2f169ffd65,0,11,0,0,9,20
8363,1702,2022-10-30 08:56:00,23dbba03710fe253ebef82dca706fe95,0,15,0,0,11,26
8364,1702,2022-10-30 09:03:00,34e002db215b0df81b471c5ac5684631,0,13,0,2,9,24
8365,1702,2022-10-30 09:07:00,dbfd7ac050280c581e18df3e3997295a,0,12,0,2,4,18
8366,1702,2022-10-30 09:13:00,419a7be5734ef417a52afd95cbcc8337,0,11,0,3,9,23
8367,1702,2022-10-30 09:17:00,086bb02b510f76d88e47acfbdc005fe2,0,17,1,2,4,24
8368,1702,2022-10-30 09:23:00,2a63310fbe9137acdb1805e62cb8cd1c,0,15,0,1,10,26
8369,1702,2022-10-30 09:27:00,23efe8ecf612fc79c1243ecc990c7d5b,0,18,0,1,3,22
8370,1702,2022-10-30 09:33:00,e709e22d4c0cf777618c5ecc386916fa,0,17,2,3,8,30
8371,1702,2022-10-30 09:36:00,65dc9a420c43bf07424be754760cdb0b,0,13,0,2,11,26
8372,1702,2022-10-30 09:43:00,26cc925e43e97c52fec2557302e71e7a,0,13,0,6,4,23
8373,1702,2022-10-30 09:47:00,a455a809a84df7666af4d3e6c13b9024,1,14,0,1,11,27
8374,1702,2022-10-30 09:53:00,ff311e1db1036583c7b3f7b7d9261196,0,16,0,4,4,24
8375,1702,2022-10-30 09:58:00,0e5f49e1f6ddabf3f14bf7ccbfe009c1,0,11,0,0,15,26
8376,1702,2022-10-30 10:02:00,8c7ff376817bdf0c40ba713197a5c92b,0,22,0,0,6,28
8377,1702,2022-10-30 10:07:00,58f72bf422d2336e8f8818e14fff2023,0,16,0,3,6,25
8378,1702,2022-10-30 10:13:00,b9026eb795d0ae591f84add8f940a43d,0,14,0,1,5,20
8379,1702,2022-10-30 10:17:00,658b6d81d95ceaf11e2f43460e026fb5,0,17,0,2,6,25
8380,1702,2022-10-30 10:22:00,06fccd93260e8f4b3199617476e4550f,0,12,0,1,5,18
8381,1702,2022-10-30 10:27:00,415a3109bd3ebf9db0fb917978474bef,0,9,0,2,5,16
8382,1702,2022-10-30 10:32:00,9d483f7a1566baeae92025211c3e77a1,0,20,0,1,5,26
8383,1702,2022-10-30 10:38:00,e41a8e7948b397ff5e4db59d46b893f5,0,12,0,1,6,19
8384,1702,2022-10-30 10:41:00,84d5431687c9f7932395f1be50340fd2,0,18,0,0,5,23
8385,1702,2022-10-30 10:48:00,7f439ee70fb87b08c399e5588766470b,0,10,0,0,14,24
8386,1702,2022-10-30 10:52:00,e0ac72bae08d6287b384c502b61d78a2,0,16,0,1,10,27
8387,1702,2022-10-30 10:56:00,cc7d881e0537b72de250ecb39064fe70,0,12,0,2,12,26
8388,1702,2022-10-30 11:02:00,73cab21f3247c90bc225a90b9e9b55f5,0,13,0,5,9,27
8389,1702,2022-10-30 11:07:00,2c5f7abd7828a886f4000b56bdd3ca5b,0,14,0,4,8,26
8390,1702,2022-10-30 11:13:00,824d56f49f637cd43b3f4ad456f8e057,0,16,0,1,9,26
8391,1702,2022-10-30 11:17:00,2e1efc35ac90da327bdb517dd0f28028,0,15,0,2,4,21
8392,1702,2022-10-30 11:23:00,b1089461fb420c08f645869142f3774a,0,15,0,2,5,22
8393,1702,2022-10-30 11:27:00,a61c19559d96c3d59651378d1ad85155,0,17,1,2,2,22
8394,1702,2022-10-30 11:32:00,e02672eff76ee7a6483ef55db337cc95,0,17,0,3,8,28
8395,1702,2022-10-30 11:37:00,4bba9bee955c24db039643b418a6a1e4,1,10,0,3,7,21
8396,1702,2022-10-30 11:42:00,ef782e91a23ba22e05000a667482e7fb,0,15,0,2,6,23
8397,1702,2022-10-30 11:48:00,437dd555d462d8db78942799cb72b029,0,15,0,1,12,28
8398,1702,2022-10-30 11:52:00,3aec29a25c000975ee4cee888832bff3,0,13,1,0,11,25
8399,1702,2022-10-30 11:57:00,7e12f42dc6246a73705ba0ae785c824b,0,12,1,1,4,18
8400,1702,2022-10-30 12:02:00,6ba57406c0f993de1cffaa58e6a924d8,0,28,0,0,5,33
8401,1702,2022-10-30 12:06:00,473d4627891e79cf0d33e58db95f7ddb,0,11,0,3,12,26
8402,1702,2022-10-30 12:12:00,59e8371c86563e1d790909a29f919bcc,0,14,0,2,8,24
8403,1702,2022-10-30 12:18:00,f9d459797f94607c8bbe702a4a436082,0,17,0,2,5,24
8404,1702,2022-10-30 12:22:00,a508675c58d7bd9a7292a1fc9138d894,1,17,0,1,7,26
8405,1702,2022-10-30 12:27:00,66639a6ba683296f36c03c5055da2053,0,18,0,0,10,28
8406,1702,2022-10-30 12:32:00,b2c7611023ac60c7722f4f4404cb76f1,0,17,1,2,7,27
8407,1702,2022-10-30 12:38:00,addb38420b094d55c1fd740b0607cc46,0,13,0,1,7,21
8408,1702,2022-10-30 12:42:00,d45a61a56e91e6c3d82bbdcd31682d87,0,17,0,6,3,26
8409,1702,2022-10-30 12:47:00,5887a60a213f587317c70093df51303a,0,17,0,3,5,25
8410,1702,2022-10-30 12:52:00,e2ec0d903dfab70b0f3c0acc0be98c41,0,13,0,4,3,20
8411,1702,2022-10-30 12:57:00,750a47d565c1855559db74300bf07129,0,19,0,2,5,26
8412,1702,2022-10-30 13:02:00,1b92f3df4d121ad1715e1ac56c26953d,0,21,0,1,6,28
8413,1702,2022-10-30 13:07:00,465633352d7542ff1efd336790b0355a,0,15,1,3,6,25
8414,1702,2022-10-30 13:11:00,33539f3c604ee82edaa263e5573ceff6,0,21,1,1,4,27
8415,1702,2022-10-30 13:17:00,85c50dbcbcc0ed76bdeba4d9443419c8,1,11,0,7,7,26
8416,1702,2022-10-30 13:22:00,3ecf47c189651544347c8b9c137b9f92,2,15,0,0,8,25
8417,1702,2022-10-30 13:27:00,871bfdf9c55538ad97a5aabc69ead713,0,19,0,2,9,30
8418,1702,2022-10-30 13:33:00,0c480517ad201bab95e2bf3a96a7ad00,1,11,0,0,12,24
8419,1702,2022-10-30 13:37:00,5370da25f885cd95e7d7ec24e87cc68b,2,12,1,0,9,24
8420,1702,2022-10-30 13:42:00,5760db1c90ea5d9c772f1977421c54a4,0,13,0,1,16,30
8421,1702,2022-10-30 13:47:00,3ec8e99f53e1f6708159f708a52d6fe1,0,19,0,3,8,30
8422,1702,2022-10-30 13:52:00,422ae86abe067db6d97620d36348b217,0,17,0,1,16,34
8423,1702,2022-10-30 13:57:00,ebcc37f6867122f6c356c3df6d68608f,0,11,0,4,6,21
8424,1702,2022-10-30 14:02:00,354ecc48a3f61ffa6d1d72df624880cc,0,17,0,3,9,29
8425,1702,2022-10-30 14:07:00,e10b28dfb200b0899cb694cb14f88591,0,20,0,2,6,28
8426,1702,2022-10-30 14:12:00,ca520265b1b59c8cfe3c71f3534b7cc6,1,15,0,4,1,21
8427,1702,2022-10-30 14:17:00,d8b7ed40cc3db388fe2275c19e8bc2de,0,14,0,2,11,27
8428,1702,2022-10-30 14:23:00,55df6ec8445cd2ab3516f041b9dc2a59,1,11,1,1,8,22
8429,1702,2022-10-30 14:27:00,d43ce6c8195a33c46c15352bf317b610,0,18,0,0,3,21
8430,1702,2022-10-30 14:32:00,b52ef45d2c9415f641376b4e38b6734e,1,18,0,0,7,26
8431,1702,2022-10-30 14:37:00,433d5ab8b5a05c940c95306a0492f97d,1,13,0,2,7,23
8432,1702,2022-10-30 14:42:00,47562daaae6eddce4d644b386257b181,0,17,0,1,5,23
8433,1702,2022-10-30 14:47:00,a23e241be53835c98cf6defce5bbee42,0,18,1,2,2,23
8434,1702,2022-10-30 14:52:00,7ee2d5160833552ecf7c9801d7e360dd,0,12,0,3,9,24
8435,1702,2022-10-30 14:57:00,1b995a58ab7a6d9835fe6f4613d3e8b8,0,20,0,0,5,25
8436,1702,2022-10-30 15:02:00,7e6df96ba6079d411e8de222966f4fc7,1,14,0,2,6,23
8437,1702,2022-10-30 15:07:00,56e755dfb83e7c3dc9b1eb247731ba8d,0,18,0,1,6,25
8438,1702,2022-10-30 15:12:00,4bf52232f8e3045d1f88f6807b6a14bd,0,20,0,0,3,23
8439,1702,2022-10-30 15:17:00,f269abf42f46211daf65245f23a70d16,0,17,0,2,8,27
8440,1702,2022-10-30 15:22:00,ad998563a0efa9bc095a9678db13b578,0,9,1,0,11,21
8441,1702,2022-10-30 15:27:00,1face1114ce4d94fe31edcf22221b8ee,0,14,1,0,5,20
8442,1702,2022-10-30 15:32:00,893681c50c9ebf502bb93d1bd5b574bc,0,16,0,0,3,19
8443,1702,2022-10-30 15:37:00,525094b27471a2135e43c9c503f34e25,0,13,0,3,7,23
8444,1702,2022-10-30 15:42:00,d41d847297d425291d62fcafaf676d40,0,17,0,0,10,27
8445,1702,2022-10-30 15:47:00,8771197aa9b46db0789b5dc8e1a29a63,0,20,0,1,10,31
8446,1702,2022-10-30 15:52:00,a402dd6a52dbc1a1c98e6924207f4bc1,0,15,0,6,2,23
8447,1702,2022-10-30 16:07:00,1c7349d2102fc8f074a3a8869dd81af7,0,17,0,0,9,26
8448,1702,2022-10-30 16:11:00,ffebbdb28dd1fddeacfc8799bee1591e,1,14,0,3,10,28
8449,1702,2022-10-30 16:22:00,585560d574369c7ea232a477d3c3f578,0,11,0,2,10,23
8450,1702,2022-10-30 16:27:00,754bdf8efeb3941bcdbd723b0d0c38fe,0,20,0,0,11,31
8451,1702,2022-10-30 16:31:00,3f497a3eb3f0bebbaa01c610e871fee0,0,11,0,1,10,22
8452,1702,2022-10-30 16:36:00,3b53ef4fd7cdf66a66061d5c8aba933e,0,18,0,0,11,29
8453,1702,2022-10-30 16:41:00,1e9aceb2a258b2887b25be3da570beb7,1,18,0,4,6,29
8454,1702,2022-10-30 16:47:00,dc1255a13f40998ddbdaec82796a3ea2,0,13,0,0,12,25
8455,1702,2022-10-30 16:51:00,b71c71614595e23578417f531d4099e7,0,8,0,0,12,20
8456,1702,2022-10-30 16:56:00,0747ac07c4fa88929d2cc5df7155a064,0,17,1,0,7,25
8457,1702,2022-10-30 17:01:00,857d9c62d1c636e7c3ae72189eb9697d,0,12,0,2,12,26
8458,1702,2022-10-30 17:07:00,77fae80557af39541affe0fdcfd2e779,0,10,0,3,15,28
8459,1702,2022-10-30 17:11:00,9c39646868938d943c059354a8929503,0,14,1,1,7,23
8460,1702,2022-10-30 17:17:00,b4cdfc00276cbc266154343b0c6245ed,0,12,0,2,12,26
8461,1702,2022-10-30 17:22:00,3dc4fc3fdcd7fcf02994b7146bb7e039,0,16,0,1,7,24
8462,1702,2022-10-30 17:32:00,f8b41f31f61366ec0f82e2e422a2baf1,1,12,0,1,12,26
8463,1702,2022-10-30 17:37:00,2152b9313cec9b4c4a8193a346760c47,0,17,0,1,13,31
8464,1702,2022-10-30 17:42:00,e631a46d7efe4234e60914f464ef87ef,0,15,0,0,11,26
8465,1702,2022-10-30 17:46:00,415e49a192a609c14f7f451e051bf4cb,0,17,0,1,5,23
8466,1702,2022-10-30 17:51:00,9f45fcd14190ccc42ad2fdbac0ee1d52,0,15,0,1,12,28
8467,1702,2022-10-30 17:56:00,adf7798cb42a82b30d6d2f3f49c2590e,0,14,0,4,5,23
8468,1702,2022-10-30 18:06:00,7dad0d7b7d965170af0ba475c35edab7,4,18,0,4,7,33
8469,1702,2022-10-30 18:11:00,cd4b824fc7c2fb81762328ab5238419a,0,18,0,1,4,23
8470,1702,2022-10-30 18:16:00,49abd02aed372afb859450f3f8336614,0,17,0,0,10,27
8471,1702,2022-10-30 18:21:00,5f8562c77cb1cb5996f31b61abe6a295,0,17,1,0,5,23
8472,1702,2022-10-30 18:26:00,4750496656ffaf5d26a1561b765b30c0,0,21,0,1,3,25
8473,1702,2022-10-30 18:31:00,b20aaf7c5bf62c9df73f4bee9cacc048,0,24,0,0,5,29
8474,1702,2022-10-30 18:37:00,af422936ffd25e4cd12aad6d62f8f3f6,0,20,0,0,5,25
8475,1702,2022-10-30 18:41:00,aa0de85ef772e86aefc771748b247a9b,0,24,0,1,5,30
8476,1702,2022-10-30 18:47:00,48743417b986bf2bb94b63426c6731f8,0,16,1,1,4,22
8477,1702,2022-10-30 18:56:00,aa4110607b94854a32686efdec0d36e9,0,21,0,0,3,24
8478,1702,2022-10-30 19:01:00,53567e88086f7eb33482a9d088a517bb,0,20,0,2,1,23
8479,1702,2022-10-30 19:06:00,e846115790b30b0eb96828415fbae774,0,18,2,0,0,20
8480,1702,2022-10-30 19:11:00,67da652ef7b680d7aa548ca299b5f7d6,0,18,0,0,1,19
8481,1702,2022-10-30 19:17:00,43a3130039cc376dcf0705413904e856,1,12,0,0,2,15
8482,1702,2022-10-30 19:21:00,6df59bcd09a5d2b3c40403194b89efa5,0,20,0,1,0,21
8483,1702,2022-10-30 19:26:00,60edb2626d8ac3899fb6dc3add06b6c4,0,13,0,0,0,13
8484,1702,2022-10-30 19:31:00,737dd96342dd8f622425e09739a94272,0,22,1,0,0,23
8485,1702,2022-10-30 19:36:00,39481b4fecb0375fc060d85fd1a80ff4,0,18,1,0,0,19
8486,1702,2022-10-30 19:41:00,a004d37cd4779fbdc2b0dbcb42111ed2,0,11,0,1,1,13
8487,1702,2022-10-30 19:46:00,20c23064539d3abea79b7a453fc87c5f,0,16,0,1,1,18
8488,1702,2022-10-30 19:51:00,f2721c15724177e9fc2d4522679fc006,0,14,0,0,1,15
8489,1702,2022-10-30 19:56:00,6f8102933d06a1e88715c002244fec40,0,4,0,0,0,4
8490,1702,2022-10-30 20:01:00,2c8bea98a923ab8d742d65ce49fcfb74,0,14,0,1,1,16
8491,1702,2022-10-30 20:06:00,ff5ab69351bd7216b4d88141d184df62,0,19,1,1,0,21
8492,1702,2022-10-30 20:11:00,e23d9fa9cec33f03e84eb2034931f1b3,0,15,1,0,1,17
8493,1702,2022-10-30 20:16:00,8ed819177322c006ef8f59761dacc815,0,18,0,0,1,19
8494,1702,2022-10-30 20:21:00,f278f269f779bb80fd73e5ce2c568fba,0,17,0,0,0,17
8495,1702,2022-10-30 20:26:00,c17b87d86755465fc3d23f75e2235475,0,17,0,1,2,20
8496,1702,2022-10-30 20:31:00,a16d9fbbc170ce724ff1dae5abf38bf5,0,14,0,0,0,14
8497,1702,2022-10-30 20:42:00,6d3c0b50dae6163627c7952a8d2c5572,0,10,2,2,1,15
8498,1702,2022-10-30 20:46:00,703b10cd8f4f827f7e0af4c7efde8436,0,22,0,0,0,22
8499,1702,2022-10-30 20:52:00,21a6c2ad18707c21f9acdedd85509267,0,16,0,0,0,16
8500,1702,2022-10-30 20:56:00,41f6d6474b96decbe29b447c8866fa2b,0,22,0,0,1,23
8501,1702,2022-10-30 21:02:00,6add95212772d7568661a40812c0a079,0,12,0,0,1,13
8502,1702,2022-10-30 21:07:00,de7820c2e4c4398bee9c615ca5fed44e,0,17,0,1,1,19
8503,1702,2022-10-30 21:11:00,89eaea1c6f1529c161ae7ac87ae2e93b,0,17,0,0,1,18
8504,1702,2022-10-30 21:21:00,eee1785a8d674cedb06ee1ad028c0f17,0,10,0,0,0,10
8505,1702,2022-10-30 21:36:00,630f1ffe43db51eb182544c08fa69641,0,21,0,0,1,22
8506,1702,2022-10-30 21:41:00,1f9ee4bc0a7e13a611a1a40c34bf375b,1,10,0,1,0,12
8507,1702,2022-10-30 21:51:00,1f9ee4bc0a7e13a611a1a40c34bf375b,1,10,0,1,0,12
8508,1702,2022-10-30 22:02:00,923f5ae6a2004a2333d909f2ddbc45f3,0,6,0,0,0,6
8509,1702,2022-10-30 22:12:00,0e6700a606bd363fb8fa98dbb284d1de,0,9,0,0,0,9
8510,1702,2022-10-30 22:32:00,e89c4d7647c480ed91a363d9fb941103,1,3,0,0,0,4
8511,1702,2022-10-30 23:21:00,871eb12a1fbebd43c6e5fdddd6a41461,0,2,0,0,0,2
8512,1702,2022-10-30 23:56:00,c845f68d78dbb717d920c0114dc3eed3,0,5,1,0,1,7
8513,1702,2022-10-31 00:11:00,e14bb892b063cf4d5f8b3213a8dbe5c2,0,0,0,0,0,0
8514,1702,2022-10-31 00:16:00,edff57b8c0f99952ad5e2c2d93e1f090,0,0,0,0,0,0
8515,1702,2022-10-31 00:22:00,2cfacafe8f7a5cc4923f23e39bb68d5d,0,8,0,0,0,8
8516,1702,2022-10-31 00:27:00,d42dd10ff2bcaf2a716a3b00ac043bf1,0,0,0,0,0,0
8517,1702,2022-10-31 00:31:00,2dde341d3bd94be856c4abb6c72b8eda,0,0,0,0,0,0
8518,1702,2022-10-31 00:37:00,53ce1396a49231400d0a1b9147424e6d,0,1,0,1,0,2
8519,1702,2022-10-31 00:47:00,0be347ed38d34a9b8b3af0119c3b9abf,0,0,0,0,1,1
8520,1702,2022-10-31 00:52:00,8088a8a89a7acb28d34d18c748af9d4b,0,2,0,0,0,2
8521,1702,2022-10-31 01:02:00,652ae07e21d51e52cca1067e6a5782a4,0,1,0,0,0,1
8522,1702,2022-10-31 01:16:00,f7f1b9c896c74d63c5a7a2ef05d25134,0,2,0,0,0,2
8523,1702,2022-10-31 01:32:00,e18a3998d24b31aabea96e57f15e63db,0,0,0,0,0,0
8524,1702,2022-10-31 01:36:00,9f9009855597be195bd2c2815fae3d8d,0,0,0,0,0,0
8525,1702,2022-10-31 01:42:00,c2b3c8325e32ae87c7d4d1602c0be22d,0,0,0,0,0,0
8526,1702,2022-10-31 01:52:00,e3ab12b7bfcc725e9a66152462da837d,0,0,0,0,0,0
8527,1702,2022-10-31 01:56:00,465416d0b64b3a7b7cc17e64ba65f0d3,0,3,0,0,0,3
8528,1702,2022-10-31 02:02:00,047ee8736595bbf692640c5558b01653,0,1,0,0,0,1
8529,1702,2022-10-31 02:11:00,457a645c5ea98d1d075240ed01b18085,0,1,0,0,0,1
8530,1702,2022-10-31 02:16:00,9127553ea428f3a60795e2ceb0e334cd,0,0,0,0,0,0
8531,1702,2022-10-31 02:26:00,fc7279843b5d3342614ffab22846a707,0,2,0,0,0,2
8532,1702,2022-10-31 02:31:00,36851bc8f696b133ba7b2c5713c7d597,0,2,0,0,0,2
8533,1702,2022-10-31 02:37:00,286f3d58174ca2b7dcda18e913dccf2d,0,0,0,0,0,0
8534,1702,2022-10-31 02:42:00,eb42099183dc9513b92d297fff26f583,0,1,0,0,0,1
8535,1702,2022-10-31 02:46:00,a6412842e9470dd95a7b5922a313c60e,0,2,0,0,0,2
8536,1702,2022-10-31 02:51:00,352d70abb91b87f0ea68505e90ef51ef,0,1,0,0,0,1
8537,1702,2022-10-31 02:56:00,15cd92d2d94ecb98f1e375a088896e34,0,0,0,0,0,0
8538,1702,2022-10-31 03:21:00,1534b0addd410465d293a0207dbf68d0,0,2,0,0,0,2
8539,1702,2022-10-31 03:27:00,50eaff78b72dae9976f8b366d744c716,0,1,0,0,0,1
8540,1702,2022-10-31 03:32:00,a7f5e81dc56c438f449d3080627034e9,0,1,0,0,0,1
8541,1702,2022-10-31 03:37:00,83e3be7953e1832312b0bfc1b422226b,0,0,0,0,0,0
8542,1702,2022-10-31 03:41:00,0bdd742e3d57735c456a1d75719a4219,0,2,0,0,0,2
8543,1702,2022-10-31 03:46:00,4bbdabf961b2802b39a1135e01b0bf6d,0,0,1,0,0,1
8544,1702,2022-10-31 03:51:00,bbb40878c58d4518a015759a6035fe74,0,2,0,0,0,2
8545,1702,2022-10-31 03:57:00,51c81c92f7d61a728c4bbcb53935f4cb,0,3,0,0,0,3
8546,1702,2022-10-31 04:01:00,6983ac1bf41eebb646f8750094ff1b70,0,0,0,0,1,1
8547,1702,2022-10-31 04:06:00,3b74c427759320238e2c6f4532fea626,0,3,0,0,0,3
8548,1702,2022-10-31 04:21:00,1f79e62153053c2287de43473f6f0786,0,3,0,0,0,3
8549,1702,2022-10-31 04:26:00,2e85d9cf163b626e6fdb3d1d37afc257,0,2,0,0,0,2
8550,1702,2022-10-31 04:31:00,8b3b7332fd6008e670089c41033ed4df,0,3,0,0,0,3
8551,1702,2022-10-31 04:42:00,959aefcaad7f78074ee23ff1e8ec5e95,0,5,0,0,0,5
8552,1702,2022-10-31 05:06:00,924e07f522b0ac3f6e0671ffe3a5a869,0,2,0,0,0,2
8553,1702,2022-10-31 05:12:00,caa8d8c843978dff41857321551734b2,0,3,0,0,0,3
8554,1702,2022-10-31 05:41:00,1e028c20b325d089db317cbf69c06b31,0,1,0,0,0,1
8555,1702,2022-10-31 05:51:00,c2dd1a4393744498caf025bb47e6cb93,0,7,0,2,1,10
8556,1702,2022-10-31 05:56:00,04f30fbe5a7964f2459d92672cc66958,0,5,0,1,0,6
8557,1702,2022-10-31 06:12:00,720b06b3ff394d6877fc9a718350348b,0,4,0,1,0,5
8558,1702,2022-10-31 06:16:00,49060b4de5a6e773fea5bfb1545402fa,0,5,0,0,0,5
8559,1702,2022-10-31 06:37:00,7a65f1ad835017bd77338a170fb1816e,0,6,0,1,0,7
8560,1702,2022-10-31 06:42:00,4940edc66b5edaf7d511b390852d7631,0,1,0,0,1,2
8561,1702,2022-10-31 06:46:00,7463f871d620faf02394e19671f884cf,0,9,0,0,0,9
8562,1702,2022-10-31 06:52:00,608bd9454c0ea55f6d0675e9bc84ed53,0,10,0,0,6,16
8563,1702,2022-10-31 06:57:00,405921ed7e2c58bd810d82355e733fc1,0,23,1,1,2,27
8564,1702,2022-10-31 07:01:00,57bca0cdd7d7d5fd3b54ab68af4209c4,0,19,0,1,6,26
8565,1702,2022-10-31 07:16:00,d3865d6ca62c18676966aed6e4363141,1,13,0,2,10,26
8566,1702,2022-10-31 07:41:00,46862b8560a9a17521d6987d2738aa86,0,15,0,2,11,28
8567,1702,2022-10-31 07:46:00,cae19fe0f6ba73f8c739b5943f76f38c,2,16,0,4,8,30
8568,1702,2022-10-31 08:12:00,b2c79332dff0edaeb2e75c52e45de441,0,17,0,3,7,27
8569,1702,2022-10-31 08:17:00,c4fdbc8cd6d440bf542636f492efd1fe,0,11,1,6,7,25
8570,1702,2022-10-31 08:22:00,e900b40e933c27a17701262c842c1360,0,16,0,3,5,24
8571,1702,2022-10-31 08:46:00,e900b40e933c27a17701262c842c1360,0,16,0,3,5,24
8572,1702,2022-10-31 08:57:00,e900b40e933c27a17701262c842c1360,0,16,0,3,5,24
8573,1702,2022-10-31 10:19:00,d12a5f37a85b5985e6df2c197a5188ff,0,9,0,4,14,27
8574,1702,2022-10-31 10:22:00,2b9b8e7b2c3c6aedc55eb4f2b6d40736,3,16,0,1,10,30
8575,1702,2022-10-31 10:27:00,ce9f9e173a9d2fe75e64d6fe083535ba,1,17,1,6,6,31
8576,1702,2022-10-31 10:33:00,0cc90c7fd718ed9e1418c26fb60a05b8,2,11,0,8,5,26
8577,1702,2022-10-31 10:37:00,e24ac470ec39a885104202b874522631,0,18,0,3,4,25
8578,1702,2022-10-31 10:42:00,a5b543f7e279010e4d005b5a83739527,0,16,0,5,10,31
8579,1702,2022-10-31 10:49:00,3820be06b12bbd7c707ae4027ee20526,0,18,1,0,10,29
8580,1702,2022-10-31 10:53:00,1d237861fafb205cc3151e1ff0604165,0,8,0,5,14,27
8581,1702,2022-10-31 10:57:00,973475adbe6c6ac4f4655590fbd8e977,2,12,1,2,8,25
8582,1702,2022-10-31 11:02:00,7e596a34a03747e95810c026dcb4cc2c,2,13,0,2,7,24
8583,1702,2022-10-31 11:08:00,f6af1733305861be85440131e2413ec8,0,14,0,2,7,23
8584,1702,2022-10-31 11:14:00,2e258178d7375b6adfdbd27dbaf77bd5,0,15,0,2,13,30
8585,1702,2022-10-31 11:17:00,03e8b455a5112d5f4d50d629827f8b53,0,11,1,1,10,23
8586,1702,2022-10-31 11:23:00,b9b9edd46313a861fa23367a1d3098ed,2,16,0,2,3,23
8587,1702,2022-10-31 11:27:00,40e06d85c2a6c58e552d4b0b12cafe64,0,8,0,0,13,21
8588,1702,2022-10-31 11:32:00,e945007683dae6389796bb4e3601b011,0,12,0,0,10,22
8589,1702,2022-10-31 11:36:00,64007c1f9ad2fdc96c2a9a82161d3243,0,17,0,3,8,28
8590,1702,2022-10-31 11:42:00,7361e1d6b1a801168283cfdefeba8480,0,11,0,0,7,18
8591,1702,2022-10-31 11:47:00,403a0b33b1946ee27ec763d3db6df103,0,11,1,5,7,24
8592,1702,2022-10-31 11:52:00,ae46461734c66a064491e43a7b764617,0,20,0,1,7,28
8593,1702,2022-10-31 11:57:00,352506cb699554cab66ca5c199f6bc89,0,12,1,3,5,21
8594,1702,2022-10-31 12:02:00,ca9582314f93fb574a396f588542552c,0,20,0,7,10,37
8595,1702,2022-10-31 12:07:00,c6e007b553fab96875c0555edead3145,0,11,1,3,9,24
8596,1702,2022-10-31 12:12:00,835d7a0adc9cb591bfb0e7c5af27de72,0,14,0,2,5,21
8597,1702,2022-10-31 12:18:00,4aee862411adc9b118e86acd66775e41,0,11,0,3,6,20
8598,1702,2022-10-31 12:23:00,2c223ec19c6370fd3db8cdb99e0e3447,0,11,0,0,12,23
8599,1702,2022-10-31 12:29:00,e36bf45b399c4574920224be3a454754,1,13,0,1,9,24
8600,1702,2022-10-31 12:32:00,ab35700da0da4b4e0311bdf010518349,0,13,0,1,7,21
8601,1702,2022-10-31 12:38:00,99d92abce195e6e05e6a6dc8e67d7c34,1,14,0,2,3,20
8602,1702,2022-10-31 12:42:00,3f641ad5ef6bff3b1095ebed0e1a175b,0,15,0,3,5,23
8603,1702,2022-10-31 12:49:00,daf901562ee4d458b2af6b331eb1a5bf,0,10,0,1,5,16
8604,1702,2022-10-31 12:52:00,5394d440206660175e99c8fb4248abc1,1,19,1,4,7,32
8605,1702,2022-10-31 12:58:00,e98ebe38a1282898b21d119a2a85febd,0,19,0,2,6,27
8606,1702,2022-10-31 13:03:00,f522930afc597ce72d0ff78d51ef8776,0,15,0,3,13,31
8607,1702,2022-10-31 13:06:00,2bd712dee85e7011f4ad94ce1a330cf4,1,7,0,5,7,20
8608,1702,2022-10-31 13:13:00,9aaf8544535bee13414421002b372bbc,0,10,0,3,9,22
8609,1702,2022-10-31 13:18:00,287161a7bd961f8ae5b942c8678bfd04,0,13,1,3,2,19
8610,1702,2022-10-31 13:23:00,4d99a0be43bcda02291e3c43061ad29b,0,17,0,2,8,27
8611,1702,2022-10-31 13:28:00,ea1278c8b006798692c269d4c7a328b2,0,12,0,3,12,27
8612,1702,2022-10-31 13:32:00,b4340e6065d83342dd77bf7ecb2296c8,0,12,1,3,4,20
8613,1702,2022-10-31 13:38:00,5e0f6d6dfae6688595612d386d647548,0,12,0,8,5,25
8614,1702,2022-10-31 13:43:00,edcf2da30dda48876dade1dd6ff2eecd,1,20,0,4,3,28
8615,1702,2022-10-31 13:47:00,29352c50f1aa470fbbdc1c8944051fc3,0,21,0,3,12,36
8616,1702,2022-10-31 13:53:00,0fc74054a82a3a8f6c1a34eb6c7260e4,0,14,0,3,6,23
8617,1702,2022-10-31 13:57:00,65a117706efba499014a00ca274b7c1e,0,14,0,3,8,25
8618,1702,2022-10-31 14:03:00,4ddaaf5b1bd44369b0f40e0b536f3b27,0,11,0,7,10,28
8619,1702,2022-10-31 14:08:00,2d89b11799111ffd8f47e603f43bdb5b,0,18,0,3,6,27
8620,1702,2022-10-31 14:12:00,acc643b638466c6db74201fab2cdd585,0,9,0,1,11,21
8621,1702,2022-10-31 14:18:00,c075ed67a85dd6fe105c7c88687e0e33,0,10,0,2,4,16
8622,1702,2022-10-31 14:22:00,1cb2cf2cf717b439de1713a93bd0958d,1,12,0,4,4,21
8623,1702,2022-10-31 14:28:00,7062452d04805d6e0cf29042bc59d4c0,0,14,0,5,7,26
8624,1702,2022-10-31 14:33:00,78ec5260dd7e1ad43f748d5ccd1eeaaf,0,12,1,1,8,22
8625,1702,2022-10-31 14:38:00,7b251d404a95cfc31671bca5e281b47f,1,14,0,2,5,22
8626,1702,2022-10-31 14:42:00,c0650ad50e258ed1bec221e8288a60c8,0,15,0,4,4,23
8627,1702,2022-10-31 14:47:00,0299490331a85e4d5ec39f19b293482f,0,18,0,1,14,33
8628,1702,2022-10-31 14:52:00,bd0bbbbe8b678d9972d42e2ce8b86057,0,10,0,4,9,23
8629,1702,2022-10-31 14:57:00,de7b8a8bbe4dcaa75fc3dcfba6ff458a,0,15,0,1,9,25
8630,1702,2022-10-31 15:02:00,981ac3f835c426543638d0aeec9b3c79,1,10,0,2,9,22
8631,1702,2022-10-31 15:08:00,0b0a4d058d2d3baa3ebdbe5e90d18505,0,15,0,4,7,26
8632,1702,2022-10-31 15:13:00,48539b28bfd35669e059978c23aedb20,0,13,0,1,10,24
8633,1702,2022-10-31 15:17:00,1f5d252b84e7b0f748b512165bfadddc,0,6,0,6,10,22
8634,1702,2022-10-31 15:23:00,6ed0a364471e99eb6d01b4cf407d7a18,0,15,0,3,3,21
8635,1702,2022-10-31 15:27:00,c3fb4fa93b093c469bb2272eb4c0e3f9,0,16,0,0,13,29
8636,1702,2022-10-31 15:32:00,ee7fa126816c35da795710e7ebd7f140,0,10,0,4,5,19
8637,1702,2022-10-31 15:38:00,0d5a5f3d09598597805487b9102a81ba,0,15,0,6,6,27
8638,1702,2022-10-31 15:44:00,1f85e5da2b9a9196b8eea7819d1d4089,0,19,0,4,4,27
8639,1702,2022-10-31 15:47:00,f024aad1608d3eeac7e9d45c7842805e,0,15,0,4,3,22
8640,1702,2022-10-31 15:53:00,566649e80a648cb596ace284bc0f5057,2,14,0,3,9,28
8641,1702,2022-10-31 15:57:00,91c56442b3f9078e07bcfa01d895af28,0,16,1,5,6,28
8642,1702,2022-10-31 16:08:00,b5442ede2fa05794952ca31ab1e96f56,4,13,0,4,7,28
8643,1702,2022-10-31 16:12:00,714099dc79e76329eb9a3cebb1a29944,1,6,0,4,12,23
8644,1702,2022-10-31 16:17:00,69703f30da27cbe33ce720230debe132,0,16,1,7,5,29
8645,1702,2022-10-31 16:23:00,ccd71b3630091a60acaf7df766900b4b,1,6,1,2,12,22
8646,1702,2022-10-31 16:26:00,22c8f407b59f95830d76066ad30e90d5,1,16,0,0,14,31
8647,1702,2022-10-31 16:32:00,c03dd41338ec2c73ffcbd10390b2ca9d,0,16,0,2,9,27
8648,1702,2022-10-31 16:37:00,232d9351254af749884712aa52f481ff,1,14,1,3,11,30
8649,1702,2022-10-31 16:42:00,844e4fc84b0565608970d59444052227,0,11,0,1,14,26
8650,1702,2022-10-31 16:47:00,199f58b3eb9e81b61d2a9157063154f9,1,17,0,3,16,37
8651,1702,2022-10-31 16:54:00,49241bfe9c9bc1d834dc347e5364a1e7,3,11,1,3,13,31
8652,1702,2022-10-31 16:57:00,04c71b2c7fcf3732ce755457fe2d48b5,1,15,0,5,14,35
8653,1702,2022-10-31 17:03:00,f78b9346201b678a68df650866a6366d,0,13,0,1,12,26
8654,1702,2022-10-31 17:08:00,b9b6a47317386d62f843ed78d76dc159,0,10,0,6,10,26
8655,1702,2022-10-31 17:13:00,6c62dd0777d7f9d63f895d3b867be2f3,1,15,0,3,9,28
8656,1702,2022-10-31 17:17:00,23c7008c7d606886b44d0439a8357be3,0,20,1,4,5,30
8657,1702,2022-10-31 17:22:00,ae68a523b803ae179f3fe584bf4f8b7d,0,15,0,4,8,27
8658,1702,2022-10-31 17:26:00,052fc1b8bf6e45ad70b34e441ecdaf24,1,20,0,3,6,30
8659,1702,2022-10-31 17:32:00,e87a8d07783767745674ee7b6dea8f83,0,17,0,1,8,26
8660,1702,2022-10-31 17:38:00,48452802ae48b429ea44b580934bd408,0,16,2,4,10,32
8661,1702,2022-10-31 17:42:00,360e181cd67c0d69273f2ab33baff5d2,0,17,1,2,7,27
8662,1702,2022-10-31 17:48:00,bd33ecd8bbf1fb6715134e9b15817b51,0,16,0,3,13,32
8663,1702,2022-10-31 17:53:00,0a1cff3f9d74d3e1bbb5ffb03e7e185a,0,24,0,2,9,35
8664,1702,2022-10-31 17:57:00,40615bdad7f347e91a0b39005818ddd1,1,16,2,1,13,33
8665,1702,2022-10-31 18:02:00,9ef2fdb994c32a5fb7ea339cfe8a38a7,1,16,0,1,9,27
8666,1702,2022-10-31 18:08:00,ad7e605046920227912ec29d9fa33358,0,19,0,2,7,28
8667,1702,2022-10-31 18:13:00,f180a533a85fd7b291d7acaa5f4a9b30,1,13,0,2,4,20
8668,1702,2022-10-31 18:17:00,17ba4f0d4032600c77f10deee3165bf1,0,10,1,4,14,29
8669,1702,2022-10-31 18:22:00,6362261c108b8dd8b2f275c2e53d7fd8,0,20,0,3,10,33
8670,1702,2022-10-31 18:27:00,4d3018668daf701c37aa768f1bf42e3a,0,22,0,1,10,33
8671,1702,2022-10-31 18:32:00,84ee69486c5e2c13dadf8fe0cb8c1653,1,21,0,5,7,34
8672,1702,2022-10-31 18:37:00,1f1b07a4ab60d35d0be13d90084ec8f2,0,19,0,8,6,33
8673,1702,2022-10-31 18:42:00,e996afd892f18fb3ecdf926f1f781d21,2,14,0,6,14,36
8674,1702,2022-10-31 18:47:00,874ad9a25a4ede844d859ba62917c31f,1,18,0,4,9,32
8675,1702,2022-10-31 18:52:00,de9d1ff4b607251342218f31ca29b0bd,1,20,0,2,3,26
8676,1702,2022-10-31 18:56:00,43f6fc3dbf0e8d8efd8653faf43cf828,0,19,4,0,7,30
8677,1702,2022-10-31 19:02:00,c8bd239927334757e93ca87d3fbf5c81,0,26,1,0,4,31
8678,1702,2022-10-31 19:06:00,cc99cea7ad1ba366f8d3e227a56ce128,0,24,3,0,2,29
8679,1702,2022-10-31 19:11:00,f15ebdd333de49205d4c56584b3f806d,0,26,0,1,1,28
8680,1702,2022-10-31 19:18:00,7a6f753bb2af56fea9eada9676fa15ec,0,25,0,1,1,27
8681,1702,2022-10-31 19:21:00,1a75dbc307f538237d2c4e5d685d0c91,0,27,1,0,2,30
8682,1702,2022-10-31 19:27:00,d7cc33119cdf1e473d09ddebcd7008f8,0,29,1,1,0,31
8683,1702,2022-10-31 19:32:00,0b7079d71e21485a04c86c61c681276a,0,21,0,0,0,21
8684,1702,2022-10-31 19:37:00,237cc3b4394593327610f659adee574d,0,24,0,0,1,25
8685,1702,2022-10-31 19:42:00,6b55a568ac19906b69bf06d6c9c3fa6b,0,22,1,0,1,24
8686,1702,2022-10-31 19:48:00,fdd06873999e900c4b4015526c349036,0,24,0,1,0,25
8687,1702,2022-10-31 19:52:00,0a655a4e9aa5e61120d305a64f44c8f8,0,13,1,2,3,19
8688,1702,2022-10-31 19:56:00,0006a683714cf1d65405749d17581cd0,0,19,0,1,1,21
8689,1702,2022-10-31 20:02:00,57874458ecee9684027f3fe6cbe81b99,0,16,1,1,0,18
8690,1702,2022-10-31 20:07:00,a11c1f101097ed27855090c4b607f29e,0,26,0,0,1,27
8691,1702,2022-10-31 20:11:00,af6feb5470c94ab0c408f4fae843aed7,0,19,0,0,1,20
8692,1702,2022-10-31 20:17:00,e56833d5fd722dee72003c860785c257,0,14,0,0,1,15
8693,1702,2022-10-31 20:23:00,6412795d82025603184417419041415c,0,15,0,1,2,18
8694,1702,2022-10-31 20:26:00,1b591843e5a99af08c71759db11e2b5f,0,10,0,1,2,13
8695,1702,2022-10-31 20:32:00,ebcb6a2db441163df84929bda04fc627,0,13,0,1,0,14
8696,1702,2022-10-31 20:37:00,53cbd79f4354182cb857ea0cfc9f8329,0,18,1,3,0,22
8697,1702,2022-10-31 20:42:00,9ba3fefd7a9650e7f2600c8df6def9d4,0,12,3,0,0,15
8698,1702,2022-10-31 20:46:00,6415bee1881a891c3f356a580f2c670d,0,13,0,1,1,15
8699,1702,2022-10-31 20:52:00,e220cd4087d6721930636d8185c6b41a,0,16,0,0,0,16
8700,1702,2022-10-31 20:57:00,ca316a81a672f6aff1021027b9a95b03,0,20,1,0,2,23
8701,1702,2022-10-31 21:02:00,999b1d5a787840bcf4cf2b071ef62bb7,0,14,1,1,0,16
8702,1702,2022-10-31 21:06:00,b55bd31661164b7ef5c04e50e72dd21a,0,13,0,1,2,16
8703,1702,2022-10-31 21:12:00,ab079274246d414d4dda294056147f02,0,25,0,1,1,27
8704,1702,2022-10-31 21:16:00,ff1086ddaf4fc4f9488b1115c02bb0b6,0,16,0,0,0,16
8705,1702,2022-10-31 21:22:00,96ff36ce763ec94a88d42932cc8bf57c,0,23,0,0,1,24
8706,1702,2022-10-31 21:27:00,f13ba793d3ae2d98aaaa22e143f574fb,0,24,0,1,2,27
8707,1702,2022-10-31 21:33:00,c736e4c88913c15eb2c2dc2f5b7f1b9c,0,20,1,0,1,22
8708,1702,2022-10-31 21:38:00,afe80cfcad8ed5bc953722142ef3b156,0,15,0,2,0,17
8709,1702,2022-10-31 21:42:00,324f27c426f6cc4bf578ca9e0143961b,0,13,2,0,1,16
8710,1702,2022-10-31 21:47:00,6fac31d54743f6d86aac1c40e0d483d7,0,18,0,1,0,19
8711,1702,2022-10-31 21:53:00,e942bcb01583bc6a10c882681c80ead3,0,18,0,1,0,19
8712,1702,2022-10-31 21:57:00,f03181cdf8efce5c4ae6e76e360c7303,0,14,0,3,0,17
8713,1702,2022-10-31 22:01:00,1ad097d4666d287480233be36a9e60f5,0,22,0,0,0,22
8714,1702,2022-10-31 22:07:00,733736f9e8584ad361c87e01ee4045ad,0,10,0,2,2,14
8715,1702,2022-10-31 22:12:00,3b33ebbb27c935f06131a33b667558c3,0,16,0,0,1,17
8716,1702,2022-10-31 22:17:00,da93de2c09316b58804c4d5905898b19,0,18,1,0,0,19
8717,1702,2022-10-31 22:23:00,a0942fa8a0672c50673ca2626bed2545,1,18,1,0,0,20
8718,1702,2022-10-31 22:28:00,908b6b285fc9686d92c86a732c3d252e,0,7,1,1,0,9
8719,1702,2022-10-31 22:32:00,f51ef8246f1f2a4d30fddd25a0b54cc0,0,12,2,0,1,15
8720,1702,2022-10-31 22:37:00,5ada9c23da911e9d59c5dab4feac1c2e,0,7,1,0,1,9
8721,1702,2022-10-31 22:42:00,da530f6c0014cff87b97f69c307e9198,0,18,0,0,1,19
8722,1702,2022-10-31 22:47:00,87c552f1b42398c81e0cf9af34c45076,0,21,1,0,1,23
8723,1702,2022-10-31 22:52:00,f79335119dc574a45b3190b0354c7157,0,11,0,1,0,12
8724,1702,2022-10-31 22:56:00,878e46d78850c1b32595e77f0e5f536c,1,15,0,0,0,16
8725,1702,2022-10-31 23:02:00,a264e293d00d907ef858f15541060367,0,17,0,0,0,17
8726,1702,2022-10-31 23:07:00,c3824c625c03de680fb4c6169880bde6,0,6,0,0,0,6
8727,1702,2022-10-31 23:12:00,2f2b88bbc226ac80b2455e929eac1bfb,0,4,4,0,0,8
8728,1702,2022-10-31 23:17:00,bcfec475f4cc1fa91482ff9f1d499ce1,0,2,0,0,1,3
8729,1702,2022-10-31 23:22:00,ddda08be165d46c1bf7ff07a7d3af98c,0,2,0,0,0,2
8730,1702,2022-10-31 23:27:00,0f261c7d427d3685271591b3a26c891c,0,7,0,0,1,8
8731,1702,2022-10-31 23:32:00,18caecab2a39df0f1d00bbc9189db8c8,0,12,1,0,0,13
8732,1702,2022-10-31 23:37:00,293c7cc3f11d0ee60dbe9289f9462c8b,0,9,0,0,0,9
8733,1702,2022-10-31 23:41:00,3ec914d54cb63fd57a57b87f19c26c59,0,11,0,1,0,12
8734,1702,2022-10-31 23:47:00,7762d95e4a4fb7e727f01a1df879ee88,0,6,1,0,0,7
8735,1702,2022-10-31 23:52:00,29c4f8487d658043ef5b6485665a877d,0,7,0,0,1,8
8736,1702,2022-11-01 00:01:00,6383df6e788a67e23a0653738191a843,0,8,0,0,0,8
8737,1702,2022-11-01 00:06:00,112a2da48715e51d33b48a9236ce03d6,0,4,0,0,0,4
8738,1702,2022-11-01 00:11:00,9a2d71aa2a279713df1a634d25828777,0,14,0,0,0,14
8739,1702,2022-11-01 00:17:00,d4c832a20601d921fd09644d2e75e34d,0,4,1,0,1,6
8740,1702,2022-11-01 00:23:00,5c309f882821e472c70127fea01420d5,0,5,0,0,0,5
8741,1702,2022-11-01 00:27:00,c5b82276ad25f3cc0168fbc65b807e84,0,7,0,0,0,7
8742,1702,2022-11-01 00:32:00,fe00f9282ea48a6fee042faa623f1e21,0,9,0,1,2,12
8743,1702,2022-11-01 00:38:00,3cfb5fff5c0b83e129d0c7d31c6fd81a,0,10,1,0,0,11
8744,1702,2022-11-01 00:42:00,07ed396d5969428962338d1e10a56d0b,0,9,2,0,0,11
8745,1702,2022-11-01 00:48:00,486e66e2f58bacf2dbc636b35d837943,0,11,0,0,1,12
8746,1702,2022-11-01 00:52:00,ae3599f50ed1e92ddb7cd2ba4d653a5b,0,11,0,0,0,11
8747,1702,2022-11-01 00:56:00,1936d1f5adeb964727fe94ea8deab60f,0,7,0,0,0,7
8748,1702,2022-11-01 01:02:00,77b02533cdd19ac06af49b4dde0e942c,0,6,1,1,0,8
8749,1702,2022-11-01 01:17:00,7a81d1cb3550eb59dd1abb11958c2624,0,5,0,0,0,5
8750,1702,2022-11-01 01:22:00,a779b87d0588f23dcbbbfe9ace9fb1bf,0,7,1,0,2,10
8751,1702,2022-11-01 01:26:00,a91e1ed7092ca9e91ef08c31264bc556,0,2,0,0,1,3
8752,1702,2022-11-01 01:31:00,d8c7de1f5be64c80c413fd3973d73b3a,1,2,0,0,0,3
8753,1702,2022-11-01 01:37:00,c787e4285ed713123536cfbc813da740,0,3,0,0,1,4
8754,1702,2022-11-01 01:41:00,3a159719fc43a0eb6e464d2107c1f7cc,0,7,0,0,1,8
8755,1702,2022-11-01 01:46:00,06c686bbcd9371ad9b9658bd3cbc8cf8,0,3,0,0,0,3
8756,1702,2022-11-01 01:52:00,5bdf3b9186ee00ddf88c22518a3808de,0,4,1,0,0,5
8757,1702,2022-11-01 01:56:00,930eb0d9d7540274ca32b27a3267850e,0,3,0,0,1,4
8758,1702,2022-11-01 02:02:00,b28bba83a607bf2523e726d1096a6854,0,6,0,0,0,6
8759,1702,2022-11-01 02:06:00,ca744654374e5fee74fc0654b8d63092,0,5,0,1,0,6
8760,1702,2022-11-01 02:12:00,d13860908463223d976752f028001014,0,3,0,0,0,3
8761,1702,2022-11-01 02:17:00,ff6b26daa7c4b4db02c729fe69acfbc7,0,8,1,0,0,9
8762,1702,2022-11-01 02:22:00,c7ede63788ba85c23c7d4855cc48f2cd,0,7,1,0,1,9
8763,1702,2022-11-01 02:26:00,62119ae6e95c686b95ee8b63f98fb44f,0,9,0,0,1,10
8764,1702,2022-11-01 02:32:00,ce3fdf2f582fea48e562fda6d151d653,0,2,0,0,0,2
8765,1702,2022-11-01 02:37:00,0f690f0f259d03a88860bf8ddc9275cc,0,3,0,0,0,3
8766,1702,2022-11-01 02:42:00,f9d9ac1bff48b65be5e88222b271eb26,0,3,1,0,0,4
8767,1702,2022-11-01 02:47:00,82d484e4ade4ac639bf2f5fe232bb0dc,0,8,0,0,0,8
8768,1702,2022-11-01 02:53:00,84bda287896ba8fb81b27970663dab52,0,9,0,0,0,9
8769,1702,2022-11-01 02:56:00,450ebd2689ff435a3123591ed56be7d0,0,8,0,0,0,8
8770,1702,2022-11-01 03:02:00,e8c62af05963b04f285df2852adf3dd7,0,2,0,0,0,2
8771,1702,2022-11-01 03:06:00,00686c8e2ba55fe2d0fb0d9b2cdd7e17,0,4,0,0,1,5
8772,1702,2022-11-01 03:12:00,9cb08c4494cbabeaa995b57b06f78310,0,2,4,0,0,6
8773,1702,2022-11-01 03:16:00,09f760aba313f674eda1090f4ee92315,0,6,2,0,0,8
8774,1702,2022-11-01 03:22:00,74515d2711ea37e084acb74a08ab3fed,0,2,0,0,0,2
8775,1702,2022-11-01 03:27:00,facb78a1252a00ce2e428a858d12bf2c,0,2,0,0,0,2
8776,1702,2022-11-01 03:32:00,06c81b6065f9bca2d7a4b266743db58f,0,5,0,0,0,5
8777,1702,2022-11-01 03:37:00,9950473cf0f0661dde65c761e4978640,0,4,0,0,0,4
8778,1702,2022-11-01 03:41:00,7ab10278c9203b200b60386c6bb9eeac,0,1,0,0,0,1
8779,1702,2022-11-01 03:46:00,a62a850e7c6fdb68914e940e75a83d25,0,7,0,0,1,8
8780,1702,2022-11-01 03:52:00,5bce5395a01de27b26c29c24cdd39363,0,3,0,0,0,3
8781,1702,2022-11-01 03:56:00,ee95e60ee3142f0392ebd8b8dfccd9ea,0,1,0,0,0,1
8782,1702,2022-11-01 04:02:00,87a137eed8f6b4bb90cdd6a65a5ed62b,0,6,0,0,0,6
8783,1702,2022-11-01 04:06:00,7512cf53bff69d4a810608aa8d5f8363,0,2,1,0,0,3
8784,1702,2022-11-01 04:12:00,edc3ebd0766215a98286dce4120f3693,0,5,0,0,1,6
8785,1702,2022-11-01 04:17:00,ae462c2ab1163498aa70351fb08d518b,0,1,0,0,0,1
8786,1702,2022-11-01 04:22:00,cdf759e8b4dbe3fc9f39bc3eedbcea44,0,5,2,0,1,8
8787,1702,2022-11-01 04:26:00,5a1ffae8ee58348c080cc1a4395c9539,0,5,0,0,0,5
8788,1702,2022-11-01 04:31:00,a6236674693a6210a92cdc383f709795,0,3,0,2,0,5
8789,1702,2022-11-01 04:36:00,449d6169d84b89770fb1ad735cef39ac,0,5,0,0,0,5
8790,1702,2022-11-01 04:41:00,a933703524aa15774c2cf1e8de8836d7,0,3,0,0,0,3
8791,1702,2022-11-01 04:47:00,e3db4daa37b6a385179ed7f94553a8c6,0,4,0,0,0,4
8792,1702,2022-11-01 04:51:00,d64e7f3a290db9c355b65cd29b047c25,0,5,0,0,0,5
8793,1702,2022-11-01 04:57:00,c75c8c640434e21de851745ff59f1068,0,2,0,1,1,4
8794,1702,2022-11-01 05:02:00,540790e03c86bd11a8d973207c2cb1a7,0,1,0,0,1,2
8795,1702,2022-11-01 05:07:00,5bedb6966f2b06ef9aa2fe8b7be0edad,0,7,0,0,0,7
8796,1702,2022-11-01 05:11:00,9f416324a6b18484831250c4bdae544d,0,3,0,0,0,3
8797,1702,2022-11-01 05:16:00,96bc0493abf25ca0737e1152135f6740,0,4,0,0,0,4
8798,1702,2022-11-01 05:22:00,3a66010ce7f90c9feef7b26b0626898b,0,2,0,0,0,2
8799,1702,2022-11-01 05:26:00,0aa9ecbb47c6c989f319ef6a1549d301,0,5,0,2,2,9
8800,1702,2022-11-01 05:32:00,2e44d9ce10f7bbf7b7fea174281940bd,0,0,0,0,1,1
8801,1702,2022-11-01 05:37:00,ac0633ba2579f05d9968bf77481a4c0c,0,1,1,0,0,2
8802,1702,2022-11-01 05:42:00,86478ca04c8f84769aeacafbc11d81da,0,6,1,0,3,10
8803,1702,2022-11-01 05:47:00,3049526f2f801615e43c858d439d213f,0,6,0,1,1,8
8804,1702,2022-11-01 05:52:00,451373f7c3e9ea9d9b6b87b271bc9ff3,0,4,0,1,0,5
8805,1702,2022-11-01 05:56:00,e5bd2d498c42698729c398df2862544a,0,5,0,0,1,6
8806,1702,2022-11-01 06:02:00,bd3ebdff186690965461e2cfe7e611a9,0,7,0,0,0,7
8807,1702,2022-11-01 06:07:00,33079461624771110b0e43a77aacc121,0,2,1,0,0,3
8808,1702,2022-11-01 06:11:00,746db9d705fe1d1e50697a8e3180d3ac,0,7,1,0,0,8
8809,1702,2022-11-01 06:18:00,331de5fdfd183335a9d364b02e10e7b8,0,6,0,0,0,6
8810,1702,2022-11-01 06:22:00,48f786428618e8547cc733ef0b561e25,0,5,1,2,1,9
8811,1702,2022-11-01 06:27:00,42f29344d6f928a80391a948fed49a26,0,8,2,0,0,10
8812,1702,2022-11-01 06:32:00,1ea81fd3f53f416c488e598a6f272905,0,2,0,1,0,3
8813,1702,2022-11-01 06:38:00,9431a12778f2e4cc901a4051e0fa4928,0,11,0,0,1,12
8814,1702,2022-11-01 06:41:00,9c5030da1e943b0b6d772fafdae944a1,1,7,2,0,1,11
8815,1702,2022-11-01 06:52:00,f094a65c162371f6448f2e30d1b89116,0,17,0,0,1,18
8816,1702,2022-11-01 06:57:00,645c18d8e301951da13a614cef727467,0,9,0,2,2,13
8817,1702,2022-11-01 07:02:00,71144b43c63e609a030bcf5d30820769,0,19,0,2,7,28
8818,1702,2022-11-01 07:07:00,195603936e670035be0aff50255347ba,0,21,0,0,8,29
8819,1702,2022-11-01 07:12:00,88688b31d4a3fe7ccdbfc3a8b2e8534f,0,16,0,0,7,23
8820,1702,2022-11-01 07:17:00,f4d85c8110c2e242d89aa23101535c57,0,18,1,1,8,28
8821,1702,2022-11-01 07:22:00,05eb6e550e69fed20548a4994ff6f461,0,15,0,1,8,24
8822,1702,2022-11-01 07:27:00,7837fd736c72ec85b2e7dace2512871f,1,14,0,3,7,25
8823,1702,2022-11-01 07:32:00,9971250f4c3ff0873e1ea8ddbe4f089f,0,18,2,0,10,30
8824,1702,2022-11-01 07:37:00,ef865371ab391630f1aad2b54eb7acda,0,15,0,1,8,24
8825,1702,2022-11-01 07:41:00,3c53981ea64232bad37a748b68d50044,0,13,0,3,10,26
8826,1702,2022-11-01 07:47:00,52bc27542b0b3ffc6317cef4c3504c1e,0,13,0,3,10,26
8827,1702,2022-11-01 07:52:00,0c9b2b657c9e6134e4639cda27de0194,0,15,0,0,9,24
8828,1702,2022-11-01 07:57:00,cc95d64c5c94ac9715778915d86d9fc1,1,12,0,1,12,26
8829,1702,2022-11-01 08:02:00,28d37f5de6ccf45fd6432c78df3e9047,0,21,1,1,7,30
8830,1702,2022-11-01 08:07:00,3ea5e081f67200e00fec5d1af5e0c650,0,14,0,1,7,22
8831,1702,2022-11-01 08:12:00,41a5802202d8d43e5d1cb23e1786c415,0,16,0,10,7,33
8832,1702,2022-11-01 08:17:00,9268b7b87e1527b860f43d552837931c,0,21,0,4,10,35
8833,1702,2022-11-01 08:20:00,782e52fdcc0421640eabe08ad32b6cc7,0,20,0,0,6,26
8834,1702,2022-11-01 08:27:00,cb5049894d58d903feaf25bac2e47fcb,0,22,0,2,7,31
8835,1702,2022-11-01 08:32:00,c0e5833d73acc810f8eca377cc53531b,0,17,0,3,18,38
8836,1702,2022-11-01 08:37:00,c67ced3ebee37af6a23be501f512def9,0,18,0,0,14,32
8837,1702,2022-11-01 08:42:00,a087094d0f076e5de4229fae367802cc,2,16,0,0,14,32
8838,1702,2022-11-01 08:47:00,48f8f63895af6b57de79d66f269ce9c2,0,17,0,4,8,29
8839,1702,2022-11-01 08:52:00,691aa29f633894b77b7ff417f8b15882,0,20,0,3,7,30
8840,1702,2022-11-01 08:58:00,f34b76456f88ace0dcd5741622dcefed,5,15,0,1,15,36
8841,1702,2022-11-01 09:02:00,0f01cf5d1380406a85b2782ef3e14d63,0,11,0,3,11,25
8842,1702,2022-11-01 09:07:00,0d9546eb4d749768ffbd008bfb78c6cf,0,18,0,2,9,29
8843,1702,2022-11-01 09:12:00,64fa868c05c2e0337fc63e89696f91ab,0,16,2,0,10,28
8844,1702,2022-11-01 09:18:00,60b7b9d57da14e4b2239f437dff52433,0,17,0,7,9,33
8845,1702,2022-11-01 09:22:00,0f9747e9d52dcb033a5762982d1835ad,0,12,0,4,8,24
8846,1702,2022-11-01 09:28:00,01f8043d0ad6ea3e1c60d34191137c2c,0,11,2,4,3,20
8847,1702,2022-11-01 09:32:00,a6c69f76ef935f72b720c4db8f129331,0,15,0,1,6,22
8848,1702,2022-11-01 09:36:00,23412d289a83507d497bbded84d4a2df,3,12,0,2,10,27
8849,1702,2022-11-01 09:42:00,95415b341fb3afb9386b942dc353647c,0,11,2,0,7,20
8850,1702,2022-11-01 09:47:00,07adc7c3706d869a8657bc6ab0c0aab8,0,7,0,1,9,17
8851,1702,2022-11-01 09:52:00,d5f441e96f37b47917b568a0182e05d3,0,16,1,3,5,25
8852,1702,2022-11-01 09:57:00,d1fccc1d2bff25886aefd3e99a2aa4bd,1,16,1,3,4,25
8853,1702,2022-11-01 10:03:00,bb9d2d1824c5faee01518a3a51408a46,2,15,0,3,6,26
8854,1702,2022-11-01 10:07:00,2a458ae40532da905423110a3b14ff49,1,12,0,5,8,26
8855,1702,2022-11-01 10:12:00,95bae0df0309fe6a830caf8e210dde21,1,12,0,1,8,22
8856,1702,2022-11-01 10:18:00,d786142bd1c32474b5d566f9f23c3e78,0,14,0,0,10,24
8857,1702,2022-11-01 10:23:00,65947febe76abd0d088d0851344acbba,1,14,0,3,6,24
8858,1702,2022-11-01 10:27:00,34cd9e6852986553f51a1f4fa61ea7ff,0,12,0,5,8,25
8859,1702,2022-11-01 10:32:00,22feb0c063fc1a23abca794713dc44dd,0,19,0,3,8,30
8860,1702,2022-11-01 10:37:00,1ce7a5e79184d1d9f81295def173d6dc,2,13,1,6,5,27
8861,1702,2022-11-01 10:42:00,27a2d73e5ea42d1ccb531a4d9ed7a871,0,14,0,2,7,23
8862,1702,2022-11-01 10:46:00,987713b6496a06c8514022449dc08296,0,16,0,1,10,27
8863,1702,2022-11-01 10:52:00,4a5ba475799be539ff668052e51bcf01,0,14,0,3,8,25
8864,1702,2022-11-01 10:57:00,208c29cf07ebe918c3dc5b27f08305f7,0,9,0,4,11,24
8865,1702,2022-11-01 11:02:00,04a911c8a1dadb8b69c8b1181073213b,0,12,0,2,12,26
8866,1702,2022-11-01 11:07:00,5d4c5393a2d3598cf4a1a172fee8653f,0,16,0,1,7,24
8867,1702,2022-11-01 11:11:00,90155de1a565e51d3769c826741b3b20,1,12,2,2,8,25
8868,1702,2022-11-01 11:17:00,a6562116bc18597a8b0b0c039d3a5259,0,9,0,2,8,19
8869,1702,2022-11-01 11:22:00,7741f4b20bcdd1f2848382743008bba6,0,20,0,5,0,25
8870,1702,2022-11-01 11:27:00,29488e43eedd47110a52179648e42ed7,0,14,2,3,11,30
8871,1702,2022-11-01 11:32:00,cbf5ffb9808ad8428372a3ef81ef393f,0,12,0,3,13,28
8872,1702,2022-11-01 11:37:00,6525803afe47ef27e3d7d9e34aed049e,0,9,0,1,13,23
8873,1702,2022-11-01 11:42:00,72a1f0cfbc1e025d2abdc177479565d4,0,16,0,1,14,31
8874,1702,2022-11-01 11:47:00,0cb924019a2dd436a6431d029a3ee6e8,0,8,0,0,12,20
8875,1702,2022-11-01 11:51:00,7293b38864c84342673b24e6e6719f59,0,12,0,3,14,29
8876,1702,2022-11-01 11:56:00,5502839987e0b8226a51292bdfc856ef,2,16,0,1,7,26
8877,1702,2022-11-01 12:02:00,31feb6a2a824b64caa552a7c234e1198,0,14,0,2,9,25
8878,1702,2022-11-01 12:07:00,6dfe71ffcda16b6f12a9cb7796ccd98d,0,14,0,1,13,28
8879,1702,2022-11-01 12:12:00,77c8d3190adea420d3d9797f2dbd0ddd,0,12,0,2,11,25
8880,1702,2022-11-01 12:17:00,5ccdf09c69fa5802769f50cdd407664c,0,18,0,0,8,26
8881,1702,2022-11-01 12:22:00,d52bb3f44ef2de1eee3667ec0aa5dadf,1,10,2,2,13,28
8882,1702,2022-11-01 12:27:00,392ce5814bc4332621b2e648e23855b0,0,14,0,1,9,24
8883,1702,2022-11-01 12:32:00,abd9766c9ec0b6d9ef76f4e1474ac313,0,23,0,1,5,29
8884,1702,2022-11-01 12:37:00,761ffadf11db5039982182496e4cbcdf,0,18,0,2,7,27
8885,1702,2022-11-01 12:42:00,4fa9f0cbffa45e53c53c5686eaabcbb6,0,14,1,1,9,25
8886,1702,2022-11-01 12:47:00,b81d5d2c77414aa6d5f92f61e8e030a1,4,11,0,2,6,23
8887,1702,2022-11-01 12:52:00,8a015fdee51d2490a8faca9df7c4e650,0,14,0,3,13,30
8888,1702,2022-11-01 12:56:00,6061dec772769e30ef2b94e786b587d0,0,14,0,1,11,26
8889,1702,2022-11-01 13:02:00,117cab699cd81f80793ff2fbbc29b5ac,0,11,0,1,9,21
8890,1702,2022-11-01 13:07:00,bc99e5282599736567fdd55e3ebeddaf,0,10,0,0,18,28
8891,1702,2022-11-01 13:11:00,0e76f9b56ebb1f79fa138682e05a3325,0,18,0,2,12,32
8892,1702,2022-11-01 13:17:00,e0f4f529b2ae2c2db1c1f569204d9e57,0,15,0,2,5,22
8893,1702,2022-11-01 13:22:00,83ff3bf53f5b5f5dbbf17776d2006384,0,11,0,7,9,27
8894,1702,2022-11-01 13:26:00,36260d32d103757693cea75b8a30b90f,0,14,0,4,9,27
8895,1702,2022-11-01 13:32:00,31edb46d7bd7ec8b50ce73e987066894,2,15,0,2,7,26
8896,1702,2022-11-01 13:37:00,3ececaf067361dfefe895f5babb0dafb,2,14,0,6,7,29
8897,1702,2022-11-01 13:42:00,05c2814945106dd0702ed8c27e338fa9,0,15,0,4,8,27
8898,1702,2022-11-01 13:47:00,3a91db1a559c37ce9e540fe4d1b5c6cf,0,18,0,5,11,34
8899,1702,2022-11-01 13:52:00,85bf7cf3e54ede706b99385c389ce741,0,13,1,5,9,28
8900,1702,2022-11-01 13:56:00,c2999f4cf19b1ca9e2fd38d2f7a3d218,0,12,0,1,15,28
8901,1702,2022-11-01 14:02:00,41b2bdeb1f5aa6041b2d4a63b6786925,0,11,2,4,10,27
8902,1702,2022-11-01 14:07:00,eba41ee7ca1ef0a229de4cbb789d8309,0,14,1,0,13,28
8903,1702,2022-11-01 14:12:00,2e4eca6a6595c0207e8c5093ab8b67ba,0,8,0,1,16,25
8904,1702,2022-11-01 14:17:00,2244a60030ea9ce9f70c52d0de85b1c0,0,9,0,3,8,20
8905,1702,2022-11-01 14:22:00,f85b3d8c361553bb4a40f152534f8587,0,14,0,7,10,31
8906,1702,2022-11-01 14:27:00,ece9ed57181a0418f5d78433a7f07f15,0,20,0,4,10,34
8907,1702,2022-11-01 14:31:00,b43e369712a11d85f10f38f73ae4bc9e,0,13,0,1,8,22
8908,1702,2022-11-01 14:37:00,c430a43b30473bdc7438c42880203a97,1,18,0,1,8,28
8909,1702,2022-11-01 14:41:00,875dbd6da554763a1427a22e4c4abc4a,0,20,0,5,8,33
8910,1702,2022-11-01 14:47:00,f75ee4a932faaa9551170716609e6595,1,12,2,1,14,30
8911,1702,2022-11-01 14:52:00,8012cc364cb0259551193c474028b8c2,0,12,0,3,14,29
8912,1702,2022-11-01 14:58:00,41c6d58698737962dabb399b1d1dce9b,0,8,0,4,7,19
8913,1702,2022-11-01 15:02:00,6d081904bd675a9a2a97674610e868f6,0,16,0,3,8,27
8914,1702,2022-11-01 15:07:00,46fbc01051cb321b56e8b5efccf114cf,1,14,1,3,11,30
8915,1702,2022-11-01 15:12:00,e272035324a25cd9f3ed76787eceec69,0,16,0,4,9,29
8916,1702,2022-11-01 15:17:00,a196a5dd5fb9efaa1bb5eeda9678ab8b,0,11,0,1,14,26
8917,1702,2022-11-01 15:22:00,4d3623f1b33540807e34679ccf8a7255,0,15,1,4,9,29
8918,1702,2022-11-01 15:27:00,8a27376dec5750ccdfa41e68a11db7d9,0,11,0,5,8,24
8919,1702,2022-11-01 15:32:00,5600444acd562ad22d0ad2ed62595f57,0,13,1,2,13,29
8920,1702,2022-11-01 15:38:00,04110aebc907d63d99fa7ba4d0247699,0,18,0,1,7,26
8921,1702,2022-11-01 15:41:00,2ff43a126cae75bb683276ca55e4f08b,2,10,0,3,13,28
8922,1702,2022-11-01 15:47:00,f5679319206fa73957a20cfb8344441e,0,20,1,0,10,31
8923,1702,2022-11-01 15:52:00,73527c50dd50629fc6ad9d710b6185b4,0,12,0,2,5,19
8924,1702,2022-11-01 15:57:00,200baa15fef9fb0ab500bc904c7654dc,0,16,0,1,6,23
8925,1702,2022-11-01 16:02:00,43c5fb37fe3c97da0a8a82ee5e2e1fa2,0,16,0,1,10,27
8926,1702,2022-11-01 16:08:00,1a93d2ad62b87f3eb62a3d0b670598a1,1,20,1,3,8,33
8927,1702,2022-11-01 16:12:00,beac731576fb24a1568b8a0df6fbd6aa,0,12,1,0,12,25
8928,1702,2022-11-01 16:16:00,44aeee1e96b9b1751007935c23345564,2,16,0,4,8,30
8929,1702,2022-11-01 16:22:00,ae47f537357521f8d89e2d04d5385684,1,13,0,0,12,26
8930,1702,2022-11-01 16:27:00,e938a882052a2f3b7554a19fc280a3d8,0,14,0,3,12,29
8931,1702,2022-11-01 16:31:00,bd25e5d73e7e4053f4a21264c3e6af3d,0,15,1,0,10,26
8932,1702,2022-11-01 16:38:00,e6b634af28f76ac6d8e1c87cd69ba2d7,0,16,1,2,10,29
8933,1702,2022-11-01 16:42:00,df37be6df56798278ed79476c55a5469,0,16,0,5,7,28
8934,1702,2022-11-01 16:47:00,06464740bd5346c02620d27c0f71211e,0,16,0,2,8,26
8935,1702,2022-11-01 16:52:00,3bd93733022a35bc9118989d117244d0,0,14,0,6,11,31
8936,1702,2022-11-01 16:57:00,c93e0be75d59356df21d33d743bbec2b,0,15,0,3,12,30
8937,1702,2022-11-01 17:02:00,d83784b65cd16a6c2fe12109f2721ce9,0,15,0,2,4,21
8938,1702,2022-11-01 17:08:00,4c9f627c00be348b75e7b2048f1f5baa,1,14,0,0,8,23
8939,1702,2022-11-01 17:12:00,3a2e9e9f1c27a449c9700bb67c13da3e,0,14,2,1,7,24
8940,1702,2022-11-01 17:17:00,f1dc5ef439dbaac4ad4cdeff9fa26df7,0,17,0,1,13,31
8941,1702,2022-11-01 17:22:00,464692693ab80d72f31dc0fbe1324f8a,0,16,0,6,9,31
8942,1702,2022-11-01 17:27:00,2b85924eefd94489d7c5e9cb7f3251f9,2,17,2,9,13,43
8943,1702,2022-11-01 17:32:00,1d30e2d713b8edf5422bdfb52137e768,1,15,0,0,11,27
8944,1702,2022-11-01 17:38:00,b3d1af407f44db3b93fca2419a4199b1,0,16,1,5,12,34
8945,1702,2022-11-01 17:41:00,8c9b8e81eb7576be1eb4756828ec3b3c,0,18,0,0,7,25
8946,1702,2022-11-01 17:47:00,57e83a825fa6f321efab66be8b61b4eb,0,20,0,3,7,30
8947,1702,2022-11-01 17:53:00,717f5ebc9d0565d46c652e2d4122a5d6,0,20,0,6,8,34
8948,1702,2022-11-01 17:56:00,8331e0264c85753b779a58ede470e2cc,0,18,0,5,9,32
8949,1702,2022-11-01 18:02:00,33c275b364660620eb883f1afe021ec1,0,18,0,0,16,34
8950,1702,2022-11-01 18:07:00,8554a68e8b3e98ee9e4305b006208f6e,0,24,0,5,7,36
8951,1702,2022-11-01 18:12:00,c0ec8e548e78db498e11748aefe9764d,0,21,1,5,5,32
8952,1702,2022-11-01 18:17:00,3d1e362d0dbc2fc669e23e601fe4de3d,0,18,3,11,8,40
8953,1702,2022-11-01 18:22:00,19296efcca44542e8922fac9dbfffd05,0,20,0,2,10,32
8954,1702,2022-11-01 18:26:00,583821227252a1718c13039cb3e83ed4,0,20,1,1,8,30
8955,1702,2022-11-01 18:32:00,440655c149a2b8d0ec851bfc5b6daa07,0,25,1,1,9,36
8956,1702,2022-11-01 18:38:00,435b86b9bc5e0e9df1c7416695c2291e,1,20,2,3,4,30
8957,1702,2022-11-01 18:42:00,358018fd58fd2599c45a26b477338cbf,0,21,0,0,10,31
8958,1702,2022-11-01 18:48:00,fa7216f3061a52ddf58f8e839c405874,0,19,0,2,6,27
8959,1702,2022-11-01 18:51:00,23b4035f6b656a1c41e40aff62042aff,0,25,0,2,7,34
8960,1702,2022-11-01 18:56:00,66635a0e426ae390ef68606f7c1301f1,0,19,0,1,8,28
8961,1702,2022-11-01 19:01:00,9d56509600730aa3d223886234d94d4d,0,37,1,1,1,40
8962,1702,2022-11-01 19:07:00,235fdc0f4605e1d98c144a95a6f25c96,0,31,2,2,0,35
8963,1702,2022-11-01 19:11:00,bd4ddf82d599c7bbab78faf0a55ce513,0,37,0,2,0,39
8964,1702,2022-11-01 19:17:00,d8a7d59ab185ee4e7b423f0aae7529fc,0,26,1,1,0,28
8965,1702,2022-11-01 19:22:00,6dae556cf169de21afc985a09733e013,0,20,0,1,0,21
8966,1702,2022-11-01 19:27:00,5b1223d0cabd13996571c2499cd28347,0,23,2,0,2,27
8967,1702,2022-11-01 19:32:00,85df3e8fc5a84c0bb03ec7986b7c8aec,0,21,0,0,1,22
8968,1702,2022-11-01 19:36:00,01eb9d94727adf4b485ccf1e45302d4c,0,22,0,1,0,23
8969,1702,2022-11-01 19:42:00,c66f7afa0807a4304d3225cd62432260,0,22,2,1,3,28
8970,1702,2022-11-01 19:46:00,6c38fef6c290b882d907f37a2d44498d,0,27,0,1,1,29
8971,1702,2022-11-01 19:52:00,cb71f3abfd8b783f55cf62198a7d3d3f,0,21,0,1,0,22
8972,1702,2022-11-01 19:57:00,8740cf0b96c6260a156ae40683737232,0,23,2,2,1,28
8973,1702,2022-11-01 20:01:00,2b09e0ee9f7d3ddce85d8e0ad7eb2926,0,23,0,2,1,26
8974,1702,2022-11-01 20:07:00,abaf3437425e6c54f4664b8013bf8a33,0,20,1,0,2,23
8975,1702,2022-11-01 20:11:00,945cb0bf3872a10a49de67c520813af4,0,18,4,0,1,23
8976,1702,2022-11-01 20:17:00,20d4c98c8809abbacda9ceb09fe3ad96,1,20,0,0,2,23
8977,1702,2022-11-01 20:21:00,4f26d83c9e4d1e9adf2b2768925ddcf4,0,19,0,0,1,20
8978,1702,2022-11-01 20:26:00,bfb9ca5d12c8d37e790bae576312c343,0,15,2,1,3,21
8979,1702,2022-11-01 20:32:00,2e199d5185f7e1833769a52c62c3abb4,0,16,1,0,1,18
8980,1702,2022-11-01 20:37:00,6b3be7fd2679a0861ce205b0700791d1,0,10,0,0,0,10
8981,1702,2022-11-01 20:41:00,bdc948b96e49a08c050a3c8d0722aa17,0,17,1,1,0,19
8982,1702,2022-11-01 20:46:00,68f2ddf4c943c41d719e2999720d026a,0,13,1,1,1,16
8983,1702,2022-11-01 20:52:00,0cd5f58627b742310d43cc68a6487bd1,0,15,1,1,1,18
8984,1702,2022-11-01 20:56:00,4477ee1e9b8b1e62adb72b4961c86ea7,0,22,2,0,1,25
8985,1702,2022-11-01 21:02:00,70855a55dcad68ef1d9b1ee7f3cdc1b9,1,15,3,1,2,22
8986,1702,2022-11-01 21:06:00,24c4740f5bc04b725cc354e0d98d0418,0,17,0,0,1,18
8987,1702,2022-11-01 21:11:00,995dc728dda674a98289a3fcdb9089b6,0,12,0,0,0,12
8988,1702,2022-11-01 21:16:00,82472d28d2771fb23b8d1ecd3f433b02,0,11,2,2,0,15
8989,1702,2022-11-01 21:22:00,362b57e28e47ae0e18762a4d21c6c212,0,13,2,0,1,16
8990,1702,2022-11-01 21:27:00,cbf30bd187cdc380e3bd774f03074ab3,0,23,1,0,1,25
8991,1702,2022-11-01 21:32:00,aedad40d3bf854fd24f44f88e53fc6e9,0,21,0,1,1,23
8992,1702,2022-11-01 21:36:00,5f7b26fd27daeeeffd5f10e439b21947,1,10,4,0,0,15
8993,1702,2022-11-01 21:42:00,1e67a48a9754d459fd2d6658786eb6b1,0,13,0,0,0,13
8994,1702,2022-11-01 21:47:00,f4839f32c0bdbe836ea565d4a2be1f7e,0,21,0,1,1,23
8995,1702,2022-11-01 21:51:00,19a235f163a0b8ebeb5c24b0ffa9211f,0,19,1,0,0,20
8996,1702,2022-11-01 21:56:00,ae991569bf9e8a8bb5da30ff5991e9cc,0,16,0,0,1,17
8997,1702,2022-11-01 22:02:00,38acad4160e85675340ddea79b30c463,0,8,4,0,0,12
8998,1702,2022-11-01 22:07:00,dc3c0ab6802b761ffb5deda3a366370f,0,21,0,0,0,21
8999,1702,2022-11-01 22:11:00,650631701ba74d4a8894c3595e2ca0ca,0,9,0,0,1,10
9000,1702,2022-11-01 22:17:00,32b5df0623ae68b6889bc5969d11b028,0,9,1,0,0,10
9001,1702,2022-11-01 22:22:00,bf6d27a945ef339f13e83dcdaa9b38ed,0,16,0,1,2,19
9002,1702,2022-11-01 22:26:00,a245bbebb342467108181f45973deb0a,0,28,1,0,0,29
9003,1702,2022-11-01 22:31:00,a2c831016c8981533935503c27375be3,0,14,0,0,0,14
9004,1702,2022-11-01 22:36:00,bd74b6b77048f9cd6975473a206bea67,0,20,3,1,0,24
9005,1702,2022-11-01 22:41:00,1e6ef144036cd13e805442502f0b2710,0,23,0,1,1,25
9006,1702,2022-11-01 22:47:00,e90ddd2c3eae0c88b84b1c08cc3f40ef,0,15,0,0,0,15
9007,1702,2022-11-01 22:52:00,86b42c1d2d0aca1ad6d1e5cd73b225e0,0,21,0,0,2,23
9008,1702,2022-11-01 22:57:00,693d5d070bec58efc7377c9fcad35947,0,22,0,1,0,23
9009,1702,2022-11-01 23:02:00,f0c0062019cf8228a234670ddaf36041,0,12,1,0,1,14
9010,1702,2022-11-01 23:07:00,0a85484384edc4b68bfc02865c27621a,0,15,0,0,0,15
9011,1702,2022-11-01 23:11:00,d22e76290d8350b3688ffb7b0de692f5,0,11,0,1,2,14
9012,1702,2022-11-01 23:17:00,4c7f8006fd1b7fc87cb0009f20e59d1a,0,11,0,0,2,13
9013,1702,2022-11-01 23:21:00,eb9c4844f39034961e87a18b5a441afc,0,10,0,1,0,11
9014,1702,2022-11-01 23:26:00,a3d33e5c5e255a59310666f9b682f9e6,0,6,0,0,0,6
9015,1702,2022-11-01 23:32:00,e3b915b05658a9115d802855beed83ce,0,11,2,0,0,13
9016,1702,2022-11-01 23:37:00,20e243b74df6b602eb9510d9d8582e02,0,14,0,0,0,14
9017,1702,2022-11-01 23:42:00,20801577df5a64545c2d09849481a1ae,0,12,1,0,0,13
9018,1702,2022-11-01 23:46:00,9c6b00d210d807fe86b70b9f9597f0e0,0,18,0,0,0,18
9019,1702,2022-11-01 23:52:00,3e4d51e11a0a558fd6dc8d8515942823,0,10,0,0,0,10
9020,1702,2022-11-01 23:57:00,b5aa7d0a2358120e793077e357fee7d6,0,10,3,0,1,14
9021,1702,2022-11-02 00:03:00,2fc1a95803102177181e8b5eed790041,0,5,1,0,1,7
9022,1702,2022-11-02 00:07:00,af00c0c756da543e55dbbe14ef08da40,0,11,0,0,0,11
9023,1702,2022-11-02 00:12:00,da5a7bc4e8273b474bafe4771fbc4e99,0,15,0,0,1,16
9024,1702,2022-11-02 00:17:00,bc8e92e7191358f1f6e4418498ed3340,0,8,0,0,0,8
9025,1702,2022-11-02 00:22:00,73fed63a23f06147e2570942b7ee2ede,0,10,0,0,0,10
9026,1702,2022-11-02 00:26:00,fa801f7769c0308bc1d566e4e3399aec,0,16,0,0,0,16
9027,1702,2022-11-02 00:33:00,1fc30e5c232011166099b6b17cde8860,0,6,1,0,0,7
9028,1702,2022-11-02 00:37:00,1b845eac5428007f067a17b91ada70d6,0,8,0,0,0,8
9029,1702,2022-11-02 00:42:00,77997e1f0454f763971d19843044ca2c,0,6,0,0,0,6
9030,1702,2022-11-02 00:48:00,dbf2c9ea2437119799132e7e4ee47f4d,0,13,1,0,0,14
9031,1702,2022-11-02 00:52:00,c3fda7d7dd482a2e6bf599ee4260e3de,0,10,0,0,1,11
9032,1702,2022-11-02 00:57:00,5c03ae41d0daa5f17fe7699319c2a70e,0,3,0,0,0,3
9033,1702,2022-11-02 01:03:00,2ddf55561c306a13c851ac5a7fdaa7b3,0,3,0,0,1,4
9034,1702,2022-11-02 01:17:00,d7c4a21e9d5102058e3c9f12e150ef6b,0,3,0,0,0,3
9035,1702,2022-11-02 01:21:00,3a37942cd0acbe0979c087da5271dbce,0,7,0,0,0,7
9036,1702,2022-11-02 01:27:00,7197442de37379560be3f206f644010c,0,5,0,0,1,6
9037,1702,2022-11-02 01:32:00,639b86753c375163369599fe687cb95f,0,4,0,0,0,4
9038,1702,2022-11-02 01:37:00,9f62d8c3944b39a191a7eb05d07a154e,0,3,0,0,0,3
9039,1702,2022-11-02 01:42:00,0c772c21d7e89eaae505fdb36e2882fd,0,3,0,0,0,3
9040,1702,2022-11-02 01:47:00,899570b6e134839efd543231c561fe0d,0,6,0,0,1,7
9041,1702,2022-11-02 01:52:00,da58f559e02e32c645376e90d237c306,0,11,0,0,0,11
9042,1702,2022-11-02 01:57:00,38b59a4f9e322ba999984af632e9cb1f,0,8,2,0,1,11
9043,1702,2022-11-02 02:02:00,a2481ad30be5e451034ec25d6db899e2,0,10,2,0,0,12
9044,1702,2022-11-02 02:07:00,0709d96fc6026bcadb60046b137cec8f,0,7,0,0,0,7
9045,1702,2022-11-02 02:11:00,8be3b9e6ca541fc5afb231499fdb27e5,0,8,0,0,1,9
9046,1702,2022-11-02 02:17:00,7bb8184dfab0bebb58d071da0cea84ac,0,4,1,0,0,5
9047,1702,2022-11-02 02:22:00,e2d393d2e8282d9a1c922bd0b9a33a20,0,7,1,2,1,11
9048,1702,2022-11-02 02:26:00,842fad343aa329c9c4c3c5fef2a4012c,0,5,0,0,0,5
9049,1702,2022-11-02 02:31:00,3101918afe144a4b68501d3cfb365c87,0,5,0,0,1,6
9050,1702,2022-11-02 02:38:00,5fb57a402ee1d7e284efddf2d1351a77,0,4,0,0,0,4
9051,1702,2022-11-02 02:43:00,6a23e65ce59c8d98ea6c224c126f9664,0,5,0,0,0,5
9052,1702,2022-11-02 02:47:00,9fef27d9181ec78e4926b152e66c73b7,0,8,0,0,2,10
9053,1702,2022-11-02 02:52:00,b8571f46ce4535745b81bebf8ab74711,0,5,0,0,0,5
9054,1702,2022-11-02 02:58:00,49061cfd02bb90f00e50add60fec0856,0,10,0,0,0,10
9055,1702,2022-11-02 03:02:00,12166fe715d04135cfcca4d5b62248a1,0,10,3,0,0,13
9056,1702,2022-11-02 03:07:00,e0df5b33d07d0d5fb79bf76d9f457656,0,11,0,0,1,12
9057,1702,2022-11-02 03:11:00,b071527a539e862b7d0604e636514729,0,8,0,0,0,8
9058,1702,2022-11-02 03:17:00,4ffd491af73c7f3315b0f60bf8339bfb,0,4,0,0,0,4
9059,1702,2022-11-02 03:23:00,6014846872e13f75e580b7bbec908230,0,6,0,0,1,7
9060,1702,2022-11-02 03:26:00,227e678972afeec2a6f95979bd749bc4,0,9,0,0,0,9
9061,1702,2022-11-02 03:33:00,0956059667f58ebf54b73245df710e98,0,5,6,0,0,11
9062,1702,2022-11-02 03:37:00,086547eeeba68037035e1777f97ca629,0,4,0,0,0,4
9063,1702,2022-11-02 03:42:00,71276dd38b20566f066f9204d1b4216a,0,8,0,0,1,9
9064,1702,2022-11-02 03:47:00,2fb9b83a7d0e7b893a5d68850f0c198e,0,10,2,0,1,13
9065,1702,2022-11-02 03:52:00,b22e4c312eebc7941d46ad7dee862df3,0,6,0,0,0,6
9066,1702,2022-11-02 03:57:00,17a80e82ed569be03c4446470039ea97,0,4,0,0,0,4
9067,1702,2022-11-02 04:03:00,57aeee3d8e20f1ea5202066613a368e9,0,6,0,0,0,6
9068,1702,2022-11-02 04:06:00,ea430a5abacda8b0e267a338e6faedc9,0,4,0,0,0,4
9069,1702,2022-11-02 04:11:00,d6ff9525707a04afa2aedbc009a75150,0,3,2,0,0,5
9070,1702,2022-11-02 04:17:00,5687597817a866e798b9e66fd824de6d,0,4,0,0,1,5
9071,1702,2022-11-02 04:22:00,2e4edf30634031b39cb93c7d80e6df76,0,9,0,0,0,9
9072,1702,2022-11-02 04:26:00,aacc081a32737347f827d92970da0140,0,6,0,0,1,7
9073,1702,2022-11-02 04:32:00,4d3e16ac0d5c1204a0a633eaae365b12,0,3,0,0,0,3
9074,1702,2022-11-02 04:36:00,3f31eaf8626b5e8c20636c285cd72521,0,5,0,0,1,6
9075,1702,2022-11-02 04:41:00,8223be6fb804db3a6332dae3d975721d,0,7,0,0,0,7
9076,1702,2022-11-02 04:47:00,63a79b96e344f66d9b489004c40acb3c,0,8,0,0,0,8
9077,1702,2022-11-02 04:52:00,e2fe180ad1d6f977794895d8a729100e,0,4,0,0,0,4
9078,1702,2022-11-02 04:57:00,0d2ec75a4c5e1a0c72bb11fad6acbc91,0,4,0,0,0,4
9079,1702,2022-11-02 05:02:00,b454dd4a167f3352531dca547702cdc8,0,2,0,0,0,2
9080,1702,2022-11-02 05:06:00,e4f8433f19cf7111e8cde71cd7c0b027,0,14,1,0,3,18
9081,1702,2022-11-02 05:13:00,10061f0e8a68e8d8a9c54db642e34f5b,0,2,0,0,0,2
9082,1702,2022-11-02 05:17:00,148a51026dff9a556790138f263d51e1,0,4,1,0,2,7
9083,1702,2022-11-02 05:21:00,78e83f6c7d4432beb651e544c2796d98,0,3,0,1,0,4
9084,1702,2022-11-02 05:27:00,e50d9e001e48960edf1f9bd6c646872c,0,5,0,0,2,7
9085,1702,2022-11-02 05:33:00,1bc3c7676ae0188922b42dfeadb6cc7c,0,1,0,1,0,2
9086,1702,2022-11-02 05:36:00,048615b32323a157687c54c3aa5eafb0,0,3,0,0,1,4
9087,1702,2022-11-02 05:42:00,005f99d91c1df5ea16ca48594715961b,0,9,0,0,0,9
9088,1702,2022-11-02 05:47:00,e9620cafcdb87c1e2c9a1d3fa1251de2,0,9,0,0,0,9
9089,1702,2022-11-02 05:52:00,a1b0ba811d4fb288080cc923b74dbc01,0,7,0,0,1,8
9090,1702,2022-11-02 05:56:00,016336943b2618ec634046a1a3fbe942,0,6,0,0,0,6
9091,1702,2022-11-02 06:02:00,61e31891ca0707996e7affde0b8c53ca,0,9,0,1,1,11
9092,1702,2022-11-02 06:07:00,27216911b41022d8d8cdb636aa185558,0,6,0,0,0,6
9093,1702,2022-11-02 06:12:00,adcfcc503d0cedbb9ac15143cd339ee7,0,6,2,0,0,8
9094,1702,2022-11-02 06:17:00,a68adfa14478edf1abc9fc27796f29fa,0,5,0,2,1,8
9095,1702,2022-11-02 06:22:00,2443fbda260dab4e08e21babd3ab8b23,0,3,0,0,1,4
9096,1702,2022-11-02 06:26:00,21bd25755ea23c38994e9076001da930,0,11,1,0,1,13
9097,1702,2022-11-02 06:32:00,c02694956371c53480972cc1b15f47e2,0,8,0,0,0,8
9098,1702,2022-11-02 06:36:00,aa20d57972a699a190a73dfd33d83c4b,0,13,2,0,5,20
9099,1702,2022-11-02 06:42:00,8dd8fb6318feaed7e417725a1b056e09,0,19,0,0,4,23
9100,1702,2022-11-02 06:46:00,ab6b7068a7cc13edf3b18658d735f90c,0,20,1,0,3,24
9101,1702,2022-11-02 06:51:00,9513642f80fbf2f0437534dc8b0c46fa,0,15,2,1,7,25
9102,1702,2022-11-02 06:57:00,187776809717a1e97caabc61cded5ac6,0,14,0,2,8,24
9103,1702,2022-11-02 07:03:00,e2aa5cf56d8799cc4ecfea190be75ffd,0,17,0,0,7,24
9104,1702,2022-11-02 07:07:00,244c9c39ec20551d8ac3aff067245143,0,9,0,3,10,22
9105,1702,2022-11-02 07:13:00,b995b024d446b09d024781176d708686,1,15,0,2,6,24
9106,1702,2022-11-02 07:17:00,94ae93f715c4d4bff7a4304cfbf7b30d,0,11,0,0,10,21
9107,1702,2022-11-02 07:22:00,718865c4bc379db39c2953111981b455,0,19,0,4,3,26
9108,1702,2022-11-02 07:28:00,65d6beb64a6ca41094600b7f46b8910f,0,16,0,0,14,30
9109,1702,2022-11-02 07:37:00,70825940f65abf8825220e1dde6737c7,0,21,0,1,9,31
9110,1702,2022-11-02 07:42:00,5a0e4e37ee5b07f3f2f9e8e1930b04ae,1,14,0,3,9,27
9111,1702,2022-11-02 07:47:00,886f6f8da194c0bda9a252942242b233,1,11,0,1,13,26
9112,1702,2022-11-02 07:53:00,8b16f1a3fe5b03fd29cafa863af9d5c6,0,11,0,5,6,22
9113,1702,2022-11-02 07:58:00,ab1cbacd9a5fd436fd581382ba6bd14f,0,18,0,0,8,26
9114,1702,2022-11-02 08:02:00,b32a777940a646efa2d48246fa8442c3,0,16,0,1,7,24
9115,1702,2022-11-02 08:08:00,0b8482f940356d07054809593cce8fd9,0,15,0,3,6,24
9116,1702,2022-11-02 08:12:00,7b138310a8816db9a97694b38ee41cf0,1,12,0,1,8,22
9117,1702,2022-11-02 08:18:00,f52b247368a78a74c05fe6b1e699eb60,1,16,0,1,3,21
9118,1702,2022-11-02 08:23:00,8879719a470fd6509cb15aadcd1a8535,2,21,0,1,10,34
9119,1702,2022-11-02 08:27:00,8f52e993fec4eb2133cc00f89ec93cf8,1,13,0,4,11,29
9120,1702,2022-11-02 08:33:00,8f78e96d8ad391ca7f625aaf29cef694,0,7,0,3,11,21
9121,1702,2022-11-02 08:37:00,e0d0987cfe87fdaaa8cd9750777b20d5,0,10,0,7,14,31
9122,1702,2022-11-02 08:41:00,c4560f51996bf5c21a3c6702012797fc,3,12,2,0,10,27
9123,1702,2022-11-02 08:48:00,f5f690d8a9e6bade61ebd34ddf056732,0,14,1,2,8,25
9124,1702,2022-11-02 08:53:00,db4f55718102a5c596e250fee323ad70,2,16,0,2,9,29
9125,1702,2022-11-02 08:57:00,5956655e9c15f5302c9c1dac934cf3b1,0,18,0,3,3,24
9126,1702,2022-11-02 09:03:00,24af26c3623b2ac870113e87311d08e6,0,11,0,1,10,22
9127,1702,2022-11-02 09:08:00,e07a7daeaae4351fd7babea6dc7371b6,0,12,0,6,4,22
9128,1702,2022-11-02 09:13:00,541d755e213e831d685ba21fca926856,1,15,0,3,8,27
9129,1702,2022-11-02 09:17:00,9e9a9930800827cf7bf4a1802b38d66a,0,8,0,1,9,18
9130,1702,2022-11-02 09:22:00,ee72d6d9ec54d6bcd7c225a4ca92180c,0,10,0,1,6,17
9131,1702,2022-11-02 09:27:00,8690b2ffbd85c0cc573a7a9ff566bb4d,0,14,0,3,7,24
9132,1702,2022-11-02 09:32:00,d3d793e853e99edf2bcf7456307cf83e,1,12,0,2,6,21
9133,1702,2022-11-02 09:38:00,9216b1a54c598515e30c47ea41f3b509,0,15,0,3,9,27
9134,1702,2022-11-02 09:42:00,c24298ecd3ca6cb59af6eed3da49b5e2,0,10,0,4,10,24
9135,1702,2022-11-02 09:47:00,7e8132c2f3a5dabf207ce6622413f1f7,2,16,0,1,13,32
9136,1702,2022-11-02 09:52:00,e263bb420cd407c1e9b2632ab654033d,1,12,0,0,9,22
9137,1702,2022-11-02 09:57:00,a12a25f6d2949ca998338f1c1c2b2a9b,0,12,0,1,6,19
9138,1702,2022-11-02 10:04:00,0eb507504daa346dd5829ca312b5c318,0,10,0,0,10,20
9139,1702,2022-11-02 10:07:00,b17e88de316405e4cdce798d98a64361,3,20,0,4,7,34
9140,1702,2022-11-02 10:12:00,432fc1b326b14c5f67784a3e9f1f47da,2,11,0,1,10,24
9141,1702,2022-11-02 10:17:00,f82342b79366c224a157dac4f267b603,4,17,0,10,8,39
9142,1702,2022-11-02 10:23:00,19b4cff875f3798722d3cd856970b512,0,9,0,3,14,26
9143,1702,2022-11-02 10:27:00,ad789db06ed52f9359636e0e32c21b08,0,16,0,4,3,23
9144,1702,2022-11-02 10:32:00,54c96c5319850ff0f2fc84399ef6765c,0,17,0,2,9,28
9145,1702,2022-11-02 10:38:00,cf6826eb0295bc5d6108508b6ec2a256,0,14,0,2,9,25
9146,1702,2022-11-02 10:43:00,066b29a939657f1852842e0a289920b2,0,23,0,8,6,37
9147,1702,2022-11-02 10:48:00,9bafb06cd135574dd578ddd76467001e,0,12,1,5,9,27
9148,1702,2022-11-02 10:52:00,91d8769d11478c9b97d56d81f35d94ed,0,11,0,3,8,22
9149,1702,2022-11-02 10:57:00,aabef45c0019681ed42690a1a484330a,0,8,0,3,9,20
9150,1702,2022-11-02 11:03:00,0d847fa0d7e598d76f16dcf3d3248bd6,0,11,1,3,8,23
9151,1702,2022-11-02 11:08:00,66f8c4b0cfbf535f8fa7d7686e70d391,0,13,0,1,7,21
9152,1702,2022-11-02 11:12:00,fa957b2c1bda723f816b39fbb5cbeb66,0,20,0,6,5,31
9153,1702,2022-11-02 11:18:00,4646cebf4f19b5c3005d9e0b37f6fc9b,0,22,1,1,6,30
9154,1702,2022-11-02 11:23:00,73841788cd875df62889b4d4376251cc,0,13,0,5,6,24
9155,1702,2022-11-02 11:27:00,21fcf4f8ab0f606bd02c9a0162e1b2a1,0,11,0,1,11,23
9156,1702,2022-11-02 11:32:00,ceb6f902764eff6370f14ad249e60f2c,0,13,0,0,4,17
9157,1702,2022-11-02 11:39:00,1f54b6962c38b94b3f99bec01d693237,0,16,0,6,5,27
9158,1702,2022-11-02 11:42:00,df1aa256ccc0102551a7d4a9c1327ec5,0,12,0,1,8,21
9159,1702,2022-11-02 11:47:00,cbf23ad7abe36c722d2b4d7c48e61040,0,10,0,2,18,30
9160,1702,2022-11-02 11:53:00,9db9cb5a36dfb84f08f73f21a2d2518c,0,22,0,1,11,34
9161,1702,2022-11-02 11:57:00,d435f5738137c7a554ada2e6f5e66fdf,0,15,2,4,5,26
9162,1702,2022-11-02 12:07:00,50c176bc3970b8d3aef9af3094ffcac8,0,12,0,1,8,21
9163,1702,2022-11-02 12:14:00,25e14b4885665e9a81ba1a1d7591c04b,0,17,0,2,6,25
9164,1702,2022-11-02 12:19:00,8a09d0729c05f7501a33fda2cedab716,0,10,0,1,16,27
9165,1702,2022-11-02 12:23:00,35eb0d41bbac6badbf2fb564f685430d,1,11,0,3,9,24
9166,1702,2022-11-02 12:27:00,481f866ec493a7444fa6581e429343cc,1,17,2,0,4,24
9167,1702,2022-11-02 12:33:00,39524a94e2a7ecdd9ba187b4871e39ec,0,19,0,2,6,27
9168,1702,2022-11-02 12:38:00,a1f76bfa2c91f6661aaf6b9c12471e61,0,12,0,5,5,22
9169,1702,2022-11-02 12:42:00,0f38677f93e402c1a4366ae76f4b62c8,0,14,0,3,6,23
9170,1702,2022-11-02 12:47:00,44f1f89c653fa0397ebe7aa30e01d7be,0,14,0,2,8,24
9171,1702,2022-11-02 12:53:00,a8cef2c1ec3e8986f36973e40b20a118,0,14,0,1,8,23
9172,1702,2022-11-02 12:58:00,20433a36080dda5a76cd84bf07c7e5eb,0,10,0,2,6,18
9173,1702,2022-11-02 13:02:00,e61af1231c90ae9692ece6f6f06241a3,0,18,0,2,7,27
9174,1702,2022-11-02 13:07:00,3a360724d85d8a9327c37470287b7410,1,17,0,3,15,36
9175,1702,2022-11-02 13:13:00,1db6b01d880128d2793c7d8d2f6c5795,0,12,1,2,6,21
9176,1702,2022-11-02 13:17:00,1e389e61274607f5152f5c095501c46d,0,18,0,2,12,32
9177,1702,2022-11-02 13:23:00,84217e736973379dc426de737410d490,0,16,0,1,5,22
9178,1702,2022-11-02 13:27:00,1f2ebfad6105f23f7798d3ba0a5d7ec7,0,15,0,1,9,25
9179,1702,2022-11-02 13:32:00,61bb960754d045d642961cc0abff20b7,0,11,0,2,12,25
9180,1702,2022-11-02 13:37:00,26be6351209c5c5eda463c1029b7e87c,0,11,0,1,9,21
9181,1702,2022-11-02 13:42:00,e16dd2dfe07e7d1b7bf379b0e35bc54e,0,13,0,4,8,25
9182,1702,2022-11-02 13:49:00,3313ac947e6c78433f7d4b83619b59c5,0,20,2,1,8,31
9183,1702,2022-11-02 13:52:00,81f0d8dc0128f785295b8df39c1b669e,0,21,0,3,3,27
9184,1702,2022-11-02 13:57:00,e17dc208adfaab71f0528f869f8c9725,0,13,0,6,7,26
9185,1702,2022-11-02 14:03:00,6b93e4784f182079da1a9657bc30dd04,1,16,0,6,8,31
9186,1702,2022-11-02 14:08:00,0eb41418cbf4a7c768f40a37c661d4d0,0,18,0,3,11,32
9187,1702,2022-11-02 14:12:00,9c717c0a5a88eb0b02ee657550d2c4c3,0,13,0,2,11,26
9188,1702,2022-11-02 14:19:00,4173b7a0702fe090aeb29248941e87ed,0,18,1,9,6,34
9189,1702,2022-11-02 14:23:00,8c42378d201cece18a24b65a14f0675a,1,21,0,6,3,31
9190,1702,2022-11-02 14:27:00,4128ade428d428efc6c57440809cdfcb,1,18,0,5,7,31
9191,1702,2022-11-02 14:33:00,432de03b533ab3ae842c84cff58bf5d6,1,16,1,6,8,32
9192,1702,2022-11-02 14:37:00,4fd15ca1d6f85be0dbfd8db4159a67c3,0,7,0,6,12,25
9193,1702,2022-11-02 14:42:00,b2ef0ba000b56549a567e7c63fdbd717,2,13,0,6,4,25
9194,1702,2022-11-02 14:47:00,82b19eee7abadb60d149934a7399fb9c,0,10,0,2,10,22
9195,1702,2022-11-02 14:52:00,af0b5d61ad49ea42b7270e4d885c36e5,0,13,0,0,12,25
9196,1702,2022-11-02 14:57:00,1bebf9f41df33de940cef957344d3637,0,8,0,2,14,24
9197,1702,2022-11-02 15:02:00,ec9eaeaaf2a2fcbac0bf42789e50a66e,0,19,0,1,7,27
9198,1702,2022-11-02 15:07:00,8fe016d825aa0496edcaecf4f9455aeb,0,18,0,1,8,27
9199,1702,2022-11-02 15:12:00,87a38e7f65a24d36a2f45fa0ae93eff4,1,13,0,4,11,29
9200,1702,2022-11-02 15:18:00,90ccb57bf74d4e9a91519e149f2ecbed,0,9,0,3,10,22
9201,1702,2022-11-02 15:23:00,024117844db800fac372bf3b10a6c003,1,13,0,0,9,23
9202,1702,2022-11-02 15:27:00,f6d5f82f13555565facc64c36b949837,0,14,1,3,5,23
9203,1702,2022-11-02 15:33:00,8b7fe9b5dddcbb89b81ab6d9e4199f9e,0,21,0,1,11,33
9204,1702,2022-11-02 15:37:00,6c54cbf7f8d642a1ba4b0c77c0a930da,0,15,0,3,8,26
9205,1702,2022-11-02 15:43:00,d8299bff1c8b39fa037aa1f63ccb90ed,0,12,0,1,11,24
9206,1702,2022-11-02 15:48:00,dbabde14511a9a486c93e13a587e310e,0,18,0,5,6,29
9207,1702,2022-11-02 15:52:00,7e5a30c6cf4893c5c8efac8cd48b8adf,0,14,2,0,8,24
9208,1702,2022-11-02 15:58:00,85843e7df0332b440213332c7efc9513,0,11,0,4,12,27
9209,1702,2022-11-02 16:03:00,c7cb5d7d2acdc926efe677db67d2070c,0,12,0,2,4,18
9210,1702,2022-11-02 16:08:00,16e54089f66929b4e640eb5cc2b2aba3,0,8,0,1,15,24
9211,1702,2022-11-02 16:12:00,ffd2067957e9720a9be1bc0b85a1b221,0,13,0,0,6,19
9212,1702,2022-11-02 16:17:00,85a495e2af2022347dc117b5fe0cbd7d,1,15,1,2,8,27
9213,1702,2022-11-02 16:21:00,c21d5935cc086624883b0dcbe36e9ea7,1,11,1,3,10,26
9214,1702,2022-11-02 16:28:00,5b381a131dd526ae84fcd79ed1ed5b09,0,18,1,1,5,25
9215,1702,2022-11-02 16:32:00,6d3f5b7973adfbef1384806531b898bf,0,11,0,1,14,26
9216,1702,2022-11-02 16:37:00,9ae6ff92c5a02c76b5f5445b6d33fbe1,1,10,0,1,15,27
9217,1702,2022-11-02 16:43:00,af7965fbfbed0c2708ed8182d0289269,0,19,1,1,4,25
9218,1702,2022-11-02 16:47:00,c51967aa162c07b403ab0819a57270d0,0,9,0,3,12,24
9219,1702,2022-11-02 16:53:00,ca615c610107512d5ff1918df04e27cc,0,9,0,3,12,24
9220,1702,2022-11-02 16:57:00,fd52ca933a8bece6b382d55a3123f1a9,0,18,0,0,12,30
9221,1702,2022-11-02 17:03:00,42360c6f24affbe9418a2cbd0b8f0e78,0,11,0,4,12,27
9222,1702,2022-11-02 17:08:00,f8e3b051b43fb8e493f20ba105798d69,1,23,0,3,8,35
9223,1702,2022-11-02 17:12:00,4a55845596a93630eb19ae04af16ef49,0,21,0,2,5,28
9224,1702,2022-11-02 17:17:00,7b8a820db856de275ffa95fb131484e9,0,18,0,5,7,30
9225,1702,2022-11-02 17:21:00,a79cfb902a7eaeb436de812ef17e0a6c,1,13,0,3,9,26
9226,1702,2022-11-02 17:27:00,a7dfb6c95f1d15a4e804c370687ede52,0,14,0,1,7,22
9227,1702,2022-11-02 17:32:00,c093235ccc467a5b0e2246a23b65ee8c,0,19,0,3,4,26
9228,1702,2022-11-02 17:37:00,9d9398a4e685942be6ab413cf2a99ab2,0,16,0,4,9,29
9229,1702,2022-11-02 17:42:00,9e34baae39fbeed1038adeede9720b4d,0,20,2,3,5,30
9230,1702,2022-11-02 17:47:00,7ae336ce64247d2e067f37f0ddcb81f5,0,19,1,0,11,31
9231,1702,2022-11-02 17:52:00,38804a722ac0b35ed3c06a0776f905ea,0,19,0,4,7,30
9232,1702,2022-11-02 17:56:00,daeb6d8aa6e633a8ab35256ed0fddb9f,0,17,0,5,10,32
9233,1702,2022-11-02 18:02:00,fa663093a1d15510ad43656f5028e905,0,19,2,1,8,30
9234,1702,2022-11-02 18:07:00,c59e83f07975f5d8a8172f6d0f1e484a,1,14,2,10,9,36
9235,1702,2022-11-02 18:11:00,1645577e02fc5243eb9633f28af1a769,0,16,2,4,10,32
9236,1702,2022-11-02 18:17:00,966e2428325bd8f37e815cb1252958bb,0,21,0,3,13,37
9237,1702,2022-11-02 18:23:00,fce8474a3f0e4d70b37a5b5d3651e665,0,16,1,3,17,37
9238,1702,2022-11-02 18:27:00,781f2da8d778f0270459bc4c9f94438b,0,19,0,4,9,32
9239,1702,2022-11-02 18:33:00,1e1c2d99421856c1d16a212845484d8c,0,18,0,2,12,32
9240,1702,2022-11-02 18:38:00,0af8d4e4c78e3c6db234e3c719df14ee,0,17,2,1,9,29
9241,1702,2022-11-02 18:42:00,eeec0312082c728937d1f3719f0df8c9,2,16,1,2,17,38
9242,1702,2022-11-02 18:48:00,03a1a780efa5d22bef1305e604200fdd,0,15,0,2,12,29
9243,1702,2022-11-02 18:53:00,33cedbeedf33bcd3d0f16e14e01031c8,0,17,0,1,8,26
9244,1702,2022-11-02 18:57:00,868863452ae2fd4973f0a9d3eeae2a2f,1,20,2,1,4,28
9245,1702,2022-11-02 19:02:00,1c80b7db1d8746e5a9f0e3a956f1d113,2,30,0,1,2,35
9246,1702,2022-11-02 19:07:00,40a703b459e1f45d0cdde43e2fd5e424,0,19,0,0,2,21
9247,1702,2022-11-02 19:12:00,9862cf0c1e5fb408497f06c9d1320e57,0,15,1,0,0,16
9248,1702,2022-11-02 19:17:00,b108e7cc64d09d10e2ca50b4ebf1b915,0,24,0,0,0,24
9249,1702,2022-11-02 19:22:00,454e45c77789ac71982106e5d420a3f1,0,21,0,1,0,22
9250,1702,2022-11-02 19:27:00,2b719ec89b873de046c2d45395093743,0,17,4,0,0,21
9251,1702,2022-11-02 19:32:00,cd02ceed6aa1637216a2174f15539fd3,0,18,0,2,3,23
9252,1702,2022-11-02 19:37:00,7b08e20978b24c4d331c62ae738bf9ea,0,17,0,0,0,17
9253,1702,2022-11-02 19:42:00,15b3fd43403cf967319e028c7481ce28,0,24,1,2,0,27
9254,1702,2022-11-02 19:47:00,80dab3bb4c4172b0f78e3d44bfc7b52a,0,26,0,0,0,26
9255,1702,2022-11-02 19:52:00,b378ef1a05ffadd8bfe300c9b95e1512,0,18,2,0,2,22
9256,1702,2022-11-02 19:57:00,7991cddcdf4f8bde6ded5d197c0365a1,0,25,1,0,0,26
9257,1702,2022-11-02 20:02:00,b68d4693aa77f359c1bb57f2657f07fd,0,19,0,0,3,22
9258,1702,2022-11-02 20:07:00,397d1c335b8fb8770d3f3b2885f9bd6f,0,24,1,0,0,25
9259,1702,2022-11-02 20:12:00,1f1ee959c69293a7c4ee0f67ed6e3b08,0,15,0,0,1,16
9260,1702,2022-11-02 20:17:00,e344569dadebe8ee305ff4e3fcc526a5,0,18,0,0,1,19
9261,1702,2022-11-02 20:21:00,9311fb706910f00b97bb029ae4a3626c,0,18,0,3,2,23
9262,1702,2022-11-02 20:27:00,c0ba24a37e8c50b24922ff2657fe8d3c,0,20,1,0,0,21
9263,1702,2022-11-02 20:32:00,d3e9743c70bf2cfc921f0b797d415ee9,0,13,1,0,1,15
9264,1702,2022-11-02 20:38:00,4607a0df8b4e45bc4ab0eee821534c94,1,16,0,0,1,18
9265,1702,2022-11-02 20:42:00,c9ca2c605b526adba78cd782d55553c3,0,15,0,0,1,16
9266,1702,2022-11-02 20:47:00,043d17e99a03a1508feb539df844fa0b,0,9,1,0,0,10
9267,1702,2022-11-02 20:52:00,8bf7bffb743fc2eaf3a1a17518030ff0,0,14,1,0,0,15
9268,1702,2022-11-02 20:57:00,ddc243a9026e723fbff43b3572c874db,0,13,0,0,0,13
9269,1702,2022-11-02 21:02:00,7ac40ff4c7f0d8023394d24ed0b2502e,0,19,1,0,1,21
9270,1702,2022-11-02 21:07:00,013d4d048388fd41b395ec11d45ceb0e,0,10,1,1,0,12
9271,1702,2022-11-02 21:12:00,a96fedaf1b199cbf241830044ba7d979,0,12,0,0,0,12
9272,1702,2022-11-02 21:17:00,7143e12e0ba4f14b603bc3b104dcb8a3,0,19,0,0,0,19
9273,1702,2022-11-02 21:21:00,78c9f60917940765583549e252ea39c2,0,13,0,0,1,14
9274,1702,2022-11-02 21:27:00,058280aa037b071f6db09a25e77bfb3c,0,16,0,0,1,17
9275,1702,2022-11-02 21:31:00,2cf5dbcac8a5edf87ac9238fe8280c8e,0,24,0,0,1,25
9276,1702,2022-11-02 21:36:00,4b71ae2c5d0bf726fab6fcfc9682db5f,0,17,2,1,0,20
9277,1702,2022-11-02 21:41:00,58bb7a8c7dc0ecf63f0c8484b5a4e820,0,11,0,0,0,11
9278,1702,2022-11-02 21:46:00,13d2b3f05a90f05a95fd6d96a834a798,0,18,1,0,0,19
9279,1702,2022-11-02 21:52:00,62d0c9cf3e1c63048b5159a50c735d99,0,20,0,0,1,21
9280,1702,2022-11-02 21:57:00,cf618e9d8fde3474e83a24d20bf8695d,0,11,4,0,0,15
9281,1702,2022-11-02 22:02:00,e572aa3118886a788f007dd6aedd449e,0,15,0,0,1,16
9282,1702,2022-11-02 22:07:00,107e127d07963bdd915fbc37cdc5850d,0,16,1,0,0,17
9283,1702,2022-11-02 22:11:00,2fd26ef168422185a4377863ab32dc98,0,13,1,0,3,17
9284,1702,2022-11-02 22:17:00,f4273c30e6679249179dc85d89a72bbd,0,26,2,0,0,28
9285,1702,2022-11-02 22:22:00,ec7572c5095aaab654d8b29e7c93d8a4,0,15,1,0,0,16
9286,1702,2022-11-02 22:26:00,c65852f3e598035a1936d3a56e9d135e,0,13,0,0,0,13
9287,1702,2022-11-02 22:32:00,48e9c5027bdfbd69b8aaf03613b60a7a,0,10,1,0,0,11
9288,1702,2022-11-02 22:37:00,84d83b970cac3090dd4708f905d89f12,0,17,0,0,0,17
9289,1702,2022-11-02 22:42:00,d7798523354c498378d27edea229bc66,0,13,0,1,0,14
9290,1702,2022-11-02 22:48:00,8073ee24ea292b9969e88d09c4f6ae8c,0,8,1,0,1,10
9291,1702,2022-11-02 22:53:00,839bb83c8408cab3a8d5acf523debc96,0,7,0,0,0,7
9292,1702,2022-11-02 22:57:00,a00ffcdf9789fb64d16da42160589c49,0,13,0,0,0,13
9293,1702,2022-11-02 23:02:00,c65a9b9fd0c716825a0567d77f6b0585,0,13,3,0,1,17
9294,1702,2022-11-02 23:06:00,9e63f83d3a91bfb898bcf0ae18c56b98,0,9,0,0,0,9
9295,1702,2022-11-02 23:12:00,787ac5e3fcdead1b7aa45f1c8a789c1b,0,7,1,0,0,8
9296,1702,2022-11-02 23:18:00,2a259f387c91a643125985f25f1908f2,0,9,1,0,0,10
9297,1702,2022-11-02 23:22:00,f9a93d0fe18650c7c9693cdacf05f448,0,15,0,0,0,15
9298,1702,2022-11-02 23:27:00,ec9f1a7b28fa1b89ce678ce219fa9507,0,12,0,0,0,12
9299,1702,2022-11-02 23:31:00,acfbf987ccfab5aff49103018fcbf176,0,11,0,0,2,13
9300,1702,2022-11-02 23:37:00,cd36288f6038ae9c8b851ec8bc9ac644,0,8,0,0,1,9
9301,1702,2022-11-02 23:42:00,6a0c70a7b373b0426a1f4b42276a3a95,0,12,1,0,0,13
9302,1702,2022-11-02 23:46:00,e2727c865373533d375b22c5a4f0dbb7,0,4,0,0,1,5
9303,1702,2022-11-02 23:52:00,23e914bfa043f7861f56cce088c910fd,0,6,1,0,1,8
9304,1702,2022-11-02 23:56:00,8dcc6da1a3670b47e01481a58ff201ab,0,4,0,1,0,5
9305,1702,2022-11-03 00:01:00,0a3fbca3cdb74d5658c893c43e78d127,0,6,1,0,1,8
9306,1702,2022-11-03 00:07:00,34104b51b0c45ca494e82b0d53455d40,0,7,0,0,0,7
9307,1702,2022-11-03 00:11:00,a021715dae295306f6765ca3d7c6dc45,0,14,0,0,0,14
9308,1702,2022-11-03 00:16:00,fcba3f751a46fad34dbb54b3aadfc7cb,0,11,1,0,1,13
9309,1702,2022-11-03 00:21:00,1eb1a5cf2814a201b140badc04a79227,0,7,0,0,0,7
9310,1702,2022-11-03 00:27:00,66cdefc78fce7769376c8fb921faf799,0,3,2,0,0,5
9311,1702,2022-11-03 00:32:00,57c32a67b371369687347a441bb7d917,0,3,0,0,0,3
9312,1702,2022-11-03 00:37:00,0dbe36f6877da891c99983782ac65cfc,0,2,0,0,0,2
9313,1702,2022-11-03 00:41:00,15342b905accc70fd39a3b85695f9bed,0,5,0,0,0,5
9314,1702,2022-11-03 00:46:00,df441b39000de32ed7456814b3264640,0,5,0,0,0,5
9315,1702,2022-11-03 00:51:00,790718edbe24bf715111efa59a468281,0,5,1,0,0,6
9316,1702,2022-11-03 00:57:00,0008c5d6a1af0ab96cad8392d7dd9e92,0,4,0,0,0,4
9317,1702,2022-11-03 01:01:00,c345420f97e8137a4ee06e30c1fc540a,0,8,0,0,0,8
9318,1702,2022-11-03 01:16:00,8c0b95264a2ae8687d0a9000c925af57,0,0,1,0,0,1
9319,1702,2022-11-03 01:21:00,b2f218b3843516ec523ea31bd6b5b6e7,0,6,0,0,0,6
9320,1702,2022-11-03 01:26:00,25c5d26d9e8690da3cbe1c140468cb18,0,1,0,0,0,1
9321,1702,2022-11-03 01:31:00,5508d2b347d589e08bda0a739243abef,0,11,0,0,2,13
9322,1702,2022-11-03 01:37:00,2dbdc01f1768f8f0d1f0b7abc6484dea,0,2,0,0,1,3
9323,1702,2022-11-03 01:41:00,3015307726c17d9005054bab7433a57a,0,4,0,0,1,5
9324,1702,2022-11-03 01:47:00,137cbfbc7113022fa4e65c0514882f12,0,5,1,0,2,8
9325,1702,2022-11-03 01:52:00,82842c051ad3653e278a340772cfc711,0,1,2,0,1,4
9326,1702,2022-11-03 01:57:00,29cf01c2af81ef8f6a640879bce53aed,0,7,2,0,0,9
9327,1702,2022-11-03 02:03:00,61ba7d76e57439d2ea6d460eca4ed7e3,0,0,0,0,0,0
9328,1702,2022-11-03 02:07:00,e43d515c0cbf377f98a1cb9f7ef4428b,0,0,0,0,0,0
9329,1702,2022-11-03 02:11:00,d5912f0383c63beda12b2549729dae08,0,1,0,0,1,2
9330,1702,2022-11-03 02:17:00,0cfab535dabb2804aac25515e2474600,0,0,0,0,0,0
9331,1702,2022-11-03 02:21:00,ea2d97e04a9f9ab98afae60985b6f754,0,10,0,0,1,11
9332,1702,2022-11-03 02:27:00,7f670f3ed867f8f968d087ec7197309a,0,4,1,0,0,5
9333,1702,2022-11-03 02:31:00,99e67b4c6f640a564b3d181a84166bb7,0,3,0,0,0,3
9334,1702,2022-11-03 02:37:00,5c63605854e9e9c6e8fdec29e57f5e75,0,4,0,1,0,5
9335,1702,2022-11-03 02:42:00,55b053613627544d264abbcfb3c7d34e,0,3,0,0,1,4
9336,1702,2022-11-03 02:47:00,dba71dcce4059ecabb5f83c5446d4bf6,0,3,0,0,0,3
9337,1702,2022-11-03 02:51:00,6897c2890c63399f05b58b924efe3d7a,0,5,0,0,1,6
9338,1702,2022-11-03 02:56:00,6a2e4af3915ecadb3577f353bcad6be6,0,6,1,0,0,7
9339,1702,2022-11-03 03:02:00,d2ed60a62915806655445098bf5b16ec,0,1,0,0,0,1
9340,1702,2022-11-03 03:07:00,980c800f916d5609a3a1980d341ecb1c,0,4,1,0,0,5
9341,1702,2022-11-03 03:11:00,26fe6b3764920ee1efa2e0ac620c74f7,0,1,0,0,0,1
9342,1702,2022-11-03 03:18:00,1d62bc676b2a92cec05a4a41abea0792,0,7,1,0,0,8
9343,1702,2022-11-03 03:21:00,33de1fab3878d4a611c7db29e99f0ad0,0,9,0,0,0,9
9344,1702,2022-11-03 03:26:00,0869ff0f57ea4f1ffaef2642150f976e,0,0,0,0,0,0
9345,1702,2022-11-03 03:32:00,dd3b8d2efda03977b937a0ae1409e60c,0,9,0,1,0,10
9346,1702,2022-11-03 03:36:00,014341f4701a2698fcaf5728d55ef5dc,0,2,0,0,0,2
9347,1702,2022-11-03 03:41:00,511cff8a12bf9f148a18bc1972987d26,0,4,0,0,0,4
9348,1702,2022-11-03 03:47:00,b6c4f3a2f2b0b85695d274b871ea3d08,0,3,0,0,0,3
9349,1702,2022-11-03 03:51:00,d75407f1ed162856863967876cd23ae7,0,5,0,0,0,5
9350,1702,2022-11-03 03:57:00,bc46a5d9c08f122e359990abf13201cf,0,7,0,0,0,7
9351,1702,2022-11-03 04:01:00,3ad3f358763c96abba729a3aeffa5412,0,3,0,0,0,3
9352,1702,2022-11-03 04:07:00,ccf176a3371514193db249c91255dde6,0,2,0,0,0,2
9353,1702,2022-11-03 04:11:00,cb12823b39e20335fce10985c50965e3,0,3,0,0,0,3
9354,1702,2022-11-03 04:16:00,a77058e36c3fced31f901bfacfa19786,0,5,0,0,0,5
9355,1702,2022-11-03 04:21:00,9d2b6ae3668d4477beee8ce4d8ae8544,0,5,1,0,0,6
9356,1702,2022-11-03 04:26:00,d5a84effef4d8afc9150a7e5bb2a387d,0,1,0,1,0,2
9357,1702,2022-11-03 04:32:00,5def3b89156ad6423b499cbd974ddeae,0,2,0,0,0,2
9358,1702,2022-11-03 04:36:00,fc8e36700d77d8f99c3438cba3a07130,0,2,1,0,0,3
9359,1702,2022-11-03 04:41:00,ee734e9406d11d6af5122b951b6f5e88,0,2,0,0,1,3
9360,1702,2022-11-03 04:47:00,fd15e0703207a00c968eb3273d5b92ee,0,1,0,0,0,1
9361,1702,2022-11-03 04:51:00,3cfa9ee5a3b97f52cc235c07c89c3e38,0,3,2,0,0,5
9362,1702,2022-11-03 04:56:00,1d6cdad54c45452b84454a979cd83f07,0,2,0,0,0,2
9363,1702,2022-11-03 05:02:00,e3e7d185ab44a507affcaa6ea72ba681,0,1,0,0,0,1
9364,1702,2022-11-03 05:07:00,8c3525d08398e607563c63ec1eab6ca2,0,6,0,0,0,6
9365,1702,2022-11-03 05:12:00,31887bfee09892c09f3aec6fcfd0525d,0,3,0,0,0,3
9366,1702,2022-11-03 05:17:00,7738a99ee05d63d71dce7aeaf0a35b9c,0,3,0,0,1,4
9367,1702,2022-11-03 05:21:00,c4611085d3b1ab5bc17adf4e4911d003,0,1,0,0,0,1
9368,1702,2022-11-03 05:27:00,896758feee333cc2542bc984e69fbc6b,0,1,0,0,0,1
9369,1702,2022-11-03 05:32:00,2f0cd2c9f6797012db83317ac3b5a089,0,2,1,0,1,4
9370,1702,2022-11-03 05:37:00,1e23014282a7cfb767c431524d94f350,0,4,0,0,0,4
9371,1702,2022-11-03 05:41:00,e12acd20a2bc0ef8c531de0ea93e83b1,0,5,0,0,0,5
9372,1702,2022-11-03 05:47:00,be7590461467512825508ccc60f69ca1,0,3,1,0,0,4
9373,1702,2022-11-03 05:52:00,4b232f3366a9cd485c0bad65e1cc454a,0,2,1,0,0,3
9374,1702,2022-11-03 05:57:00,2959f5a851f1f49dc6546e17a933c9c9,0,4,0,0,0,4
9375,1702,2022-11-03 06:02:00,fe6f939f14b7b5961cad4e62f95ab0f2,0,6,1,0,0,7
9376,1702,2022-11-03 06:07:00,3e2132702fec6ccf13a49ad53bd0b4ca,0,5,0,0,1,6
9377,1702,2022-11-03 06:11:00,b49a7d03199e5ccd749829d13bd053fa,0,15,0,1,0,16
9378,1702,2022-11-03 06:17:00,7124de230f425a6c6cc2580f6202d210,0,10,0,2,1,13
9379,1702,2022-11-03 06:22:00,5f5d493e72a1ae40a48e9888ba7cc6af,0,7,0,0,0,7
9380,1702,2022-11-03 06:26:00,1a948bc15e2a2d4c0b313a8831b290a2,0,3,1,0,1,5
9381,1702,2022-11-03 06:32:00,7642aa32e3eacebbe84ad3ab7efdc108,0,10,1,1,2,14
9382,1702,2022-11-03 06:36:00,54b18996205dafccb89b8415b3778bc4,0,12,0,1,2,15
9383,1702,2022-11-03 06:42:00,5dbcc7efb84dc1803f47d8663e94506b,0,14,5,0,4,23
9384,1702,2022-11-03 06:47:00,0f80cf34de59bdea127543b652f6a0c5,0,17,0,0,4,21
9385,1702,2022-11-03 06:52:00,f46359dd7489e699fe19e37272d40cc5,0,20,0,1,1,22
9386,1702,2022-11-03 06:56:00,2443ba96ef5412cb9d77beb3ffd6a2bf,0,16,0,0,6,22
9387,1702,2022-11-03 07:02:00,fc6cf231b1524908f9e05c67872525c6,0,14,1,2,4,21
9388,1702,2022-11-03 07:07:00,94443df51b877a14696e90bb15a01eb5,0,19,1,0,4,24
9389,1702,2022-11-03 07:12:00,be342f6858b7af182810791fd71bf16d,0,18,0,2,4,24
9390,1702,2022-11-03 07:17:00,92ff41da444d9720c85f3b64f10098a1,1,15,0,0,5,21
9391,1702,2022-11-03 07:23:00,6a02d6ff55163a25c888b3c8029404f1,0,14,0,1,6,21
9392,1702,2022-11-03 07:27:00,d8dc97b6bd33226ad46fc48906f8c10f,0,15,1,1,11,28
9393,1702,2022-11-03 07:31:00,d7e8b5bc643e49b2da9e0ceb7bead4b2,0,14,0,3,15,32
9394,1702,2022-11-03 07:38:00,35dc634289c250fcd80bb374c2212c54,0,18,2,1,9,30
9395,1702,2022-11-03 07:42:00,92d8d0300b6f7b46f284a26d50c22a15,3,15,0,0,9,27
9396,1702,2022-11-03 07:47:00,cca5b2d0171a798a60ec7e037871ac8b,1,16,0,1,12,30
9397,1702,2022-11-03 07:52:00,74a777252749d86d8c2138c70103ae09,0,11,0,1,9,21
9398,1702,2022-11-03 07:56:00,49b1a58830aa52a8b109d227c8d356e0,0,18,0,3,10,31
9399,1702,2022-11-03 08:02:00,59ff32546d4d117cf6c133c3878fc2e1,0,15,0,2,12,29
9400,1702,2022-11-03 08:07:00,cd0a8c823ee57e37d81b4198b0c94da2,2,10,0,2,14,28
9401,1702,2022-11-03 08:12:00,3785fef91286d95f83549067e0abb1d0,1,18,1,0,10,30
9402,1702,2022-11-03 08:17:00,2ec57b08b4a7d914f1ca541fe49cb493,0,14,0,0,8,22
9403,1702,2022-11-03 08:22:00,5ec98e7bfa1851e02c1d2d2fa1433980,2,18,0,2,6,28
9404,1702,2022-11-03 08:27:00,54f4eacf5e924c83b8359961e8435032,0,20,0,2,6,28
9405,1702,2022-11-03 08:31:00,861ad4609c5fe01c6c39692aace5467a,2,16,0,3,12,33
9406,1702,2022-11-03 08:38:00,bd4b27ab30ed6ceac3c1649a8239a95a,1,17,0,2,8,28
9407,1702,2022-11-03 08:42:00,6bc596e72b28d11b56e36345cf4a3869,0,24,0,6,7,37
9408,1702,2022-11-03 08:46:00,9d08a3692eb155e38da437b82f5f9f42,0,25,0,4,7,36
9409,1702,2022-11-03 08:53:00,424c4c2610e8e37b66add1f2a52602b7,1,22,0,6,9,38
9410,1702,2022-11-03 08:57:00,dfb84a9d19cff782f73fc673464740b7,0,18,0,4,17,39
9411,1702,2022-11-03 09:03:00,747862f41e0939e5f9e37604c0f39e16,1,19,0,7,2,29
9412,1702,2022-11-03 09:08:00,963aaf780d407d77f65c70cb61865dec,0,25,0,1,1,27
9413,1702,2022-11-03 09:12:00,e1670e09d5e95c176be84f6ef29fab34,0,14,0,4,1,19
9414,1702,2022-11-03 09:17:00,e1127ece9b76f6c21369a0720d343d73,0,14,0,4,10,28
9415,1702,2022-11-03 09:22:00,f6df27d58aa32124bf0cf32a87f649d8,1,12,0,0,12,25
9416,1702,2022-11-03 09:27:00,5385b3f4069358ca032867f193e94a3f,0,21,0,0,2,23
9417,1702,2022-11-03 09:32:00,f73c0091d661c9366f06cdc2fc4fead6,0,15,0,0,10,25
9418,1702,2022-11-03 09:37:00,c225ff3caf7db852e3e7bdf74c0830f3,2,15,0,3,3,23
9419,1702,2022-11-03 09:42:00,5825c0d7e02bf068f5216ea1166f9327,0,16,0,0,9,25
9420,1702,2022-11-03 09:48:00,c53715a69e18ac866910574086e9e385,2,21,0,0,5,28
9421,1702,2022-11-03 09:53:00,01ddc8a6e860309400d4ca78dcc0eb89,1,17,1,1,8,28
9422,1702,2022-11-03 09:56:00,7412080d0bd7cce99a9b4c4581a5b006,0,13,0,2,7,22
9423,1702,2022-11-03 10:02:00,d11fc76dac37573f527566f372d0f0f1,0,10,0,1,7,18
9424,1702,2022-11-03 10:06:00,053df42ead546638a2d2d2ecf2a10f2d,0,14,1,4,11,30
9425,1702,2022-11-03 10:12:00,e536c647f68497e9266c76c95d2aebe7,0,11,0,4,12,27
9426,1702,2022-11-03 10:17:00,ce12aa303f2f56210e0e0960f61405f2,0,15,0,1,8,24
9427,1702,2022-11-03 10:22:00,d5f53f84017879f428cced0dadd59066,1,10,0,7,10,28
9428,1702,2022-11-03 10:27:00,7736a3a491dba9bf70cf592d0db2dfb7,0,13,0,4,6,23
9429,1702,2022-11-03 10:31:00,722af3beb622813496c338c895126ba6,0,13,0,1,11,25
9430,1702,2022-11-03 10:37:00,6290dd0dc74ccdca1ad590791052db01,0,17,0,1,9,27
9431,1702,2022-11-03 10:42:00,5942a72a6e347de34c7485f3e5f393ed,1,13,0,1,11,26
9432,1702,2022-11-03 10:47:00,debb6d732770761904f3601a8b0c6a33,0,16,0,3,9,28
9433,1702,2022-11-03 10:52:00,39ae5ef1262ad9594acf3bed6ad3f1f6,0,11,0,1,13,25
9434,1702,2022-11-03 10:57:00,425422c24d512c6b356390ae76f46e66,0,12,0,5,9,26
9435,1702,2022-11-03 11:02:00,7feaa4ce51c5e3f62afbe3739938193c,1,17,3,0,10,31
9436,1702,2022-11-03 11:08:00,98c68007acd292174670ca89d673e1e3,0,10,0,1,15,26
9437,1702,2022-11-03 11:12:00,9e30d4a8b17ba53da83f9d4219e98992,0,9,0,1,14,24
9438,1702,2022-11-03 11:18:00,aae73fa43fa6223d08b36ec0e55f2ddb,0,17,0,2,10,29
9439,1702,2022-11-03 11:22:00,d762a047096559f423e312313a1050f5,1,16,0,2,13,32
9440,1702,2022-11-03 11:27:00,b373994c61383715dd00122c63991416,0,12,0,2,12,26
9441,1702,2022-11-03 11:33:00,6bfe5f0e8cbc6debe821caccb2355db5,0,12,0,3,12,27
9442,1702,2022-11-03 11:38:00,fad7d78c11acfebe8cef2c2d12b2f7d0,0,11,1,2,7,21
9443,1702,2022-11-03 11:42:00,9808cedb16e355264b214c34a8f53991,0,15,0,2,10,27
9444,1702,2022-11-03 11:47:00,caeedc5352743094680a7bbf8dc8f661,0,12,0,1,12,25
9445,1702,2022-11-03 11:52:00,ea5f88a38a1ca41604708edc2bcfe7c5,1,21,0,0,8,30
9446,1702,2022-11-03 11:57:00,f6a403752853dbc52994b4dd9a990b2b,0,14,0,1,12,27
9447,1702,2022-11-03 12:03:00,8fa7b1e127a0099fb2bd44b235c10eaf,0,10,0,4,7,21
9448,1702,2022-11-03 12:07:00,44fc68a4b88dfa9dcbae6f6e9bae5641,1,13,0,1,12,27
9449,1702,2022-11-03 12:12:00,da1d7942689480403dbcb86e296dcfd3,1,12,0,0,8,21
9450,1702,2022-11-03 12:17:00,93387c7698fea1862228f0cee706044f,0,10,0,1,7,18
9451,1702,2022-11-03 12:22:00,7f8248fac59a026c30e903bead6daca5,0,15,1,1,8,25
9452,1702,2022-11-03 12:27:00,d922027a57c79d702c435b07db317e9b,0,14,0,4,10,28
9453,1702,2022-11-03 12:33:00,3aea0dc4eb7dd9b6be5415f5d1730597,0,15,0,0,12,27
9454,1702,2022-11-03 12:37:00,8598a9ce0e00e56ed93c1e1ea72059d9,0,19,0,3,7,29
9455,1702,2022-11-03 12:47:00,444c6b2f6c2d01cb781e32702eed0cbc,0,13,0,0,14,27
9456,1702,2022-11-03 12:52:00,fd477d66ce8d4deafd13e553c6055415,1,10,0,2,6,19
9457,1702,2022-11-03 12:57:00,07320ca6d1205f1e6a638e256c7a05a7,0,9,0,2,7,18
9458,1702,2022-11-03 13:03:00,bf17e0105ca946a23a49ae017dc96b09,1,12,0,1,13,27
9459,1702,2022-11-03 13:07:00,589a127dedfd8c62c25d729f8f53f9ee,0,14,0,4,9,27
9460,1702,2022-11-03 13:11:00,70b0ced48a2d399ca5ffb08031090365,0,16,1,2,7,26
9461,1702,2022-11-03 13:18:00,a359b4e4c47ba8876164cb3f0ca7b211,0,7,0,4,9,20
9462,1702,2022-11-03 13:22:00,02f77262c8b88ac2a6c1c47e61abb0ca,0,15,0,1,8,24
9463,1702,2022-11-03 13:27:00,dbd11b9a2a1d70b3336714bfbc6b0e68,3,8,0,0,13,24
9464,1702,2022-11-03 13:32:00,71f2a4c58a89178ab77f40ca60b9dc58,0,7,0,7,12,26
9465,1702,2022-11-03 13:38:00,777871d5d72959524129e3f1d9aff881,0,11,0,3,10,24
9466,1702,2022-11-03 13:42:00,5400d9adcbafebc9f23b7508c97c77fe,0,11,0,2,13,26
9467,1702,2022-11-03 13:48:00,2dbd195de0810e01c1c3632b1b0efaeb,1,16,0,3,14,34
9468,1702,2022-11-03 13:53:00,cf3dac5bc4609a1593732c46e521d78e,0,12,1,1,9,23
9469,1702,2022-11-03 13:58:00,a0220135a6aeb18458c1f9c1a64c7426,1,13,0,2,11,27
9470,1702,2022-11-03 14:03:00,d231e5cf82d3ae44cd97ca31df0d733c,0,13,0,2,12,27
9471,1702,2022-11-03 14:07:00,5539a62400f3f457bd567f7dd6a3ae48,1,12,0,4,14,31
9472,1702,2022-11-03 14:12:00,92b9c80c8dd89083e305fee3f56c1f1c,0,20,0,6,3,29
9473,1702,2022-11-03 14:17:00,4f5076fdd03d63df0e614c3e66b398a1,0,10,1,9,6,26
9474,1702,2022-11-03 14:22:00,255b44277d5fb2f2ca5512080e85fca4,0,18,0,4,6,28
9475,1702,2022-11-03 14:27:00,b9d0d3741966771717e60f68a127bd04,0,11,0,2,11,24
9476,1702,2022-11-03 14:32:00,43126aede89e6d236eb7afbce21a2285,0,10,0,0,11,21
9477,1702,2022-11-03 14:38:00,8c0ca2750fbce1ad2509346548f00db5,0,12,0,2,13,27
9478,1702,2022-11-03 14:42:00,cb3598f45a5a17336847a2cd84698c8a,0,14,0,5,6,25
9479,1702,2022-11-03 14:47:00,78080a7a2dd2cdd78fdd712cee22fc86,0,11,0,3,8,22
9480,1702,2022-11-03 14:52:00,110a7ab22d2f49bde116c32140ae5f75,0,20,0,2,5,27
9481,1702,2022-11-03 14:57:00,a8cc3920f51924d44a24d4175aa65b0e,0,14,0,2,8,24
9482,1702,2022-11-03 15:03:00,6590947ac50edc00b738bed47bb45b32,0,15,0,5,8,28
9483,1702,2022-11-03 15:08:00,bd297cf72416931097bb5601015be937,0,22,1,2,4,29
9484,1702,2022-11-03 15:13:00,f291388e9445e0c248828a158f233406,0,5,0,2,12,19
9485,1702,2022-11-03 15:17:00,c0d6acab1696ef6d017631e7c7081cbb,0,18,3,0,12,33
9486,1702,2022-11-03 15:23:00,d200d8d574c976d20069d327683faa4b,0,12,0,2,7,21
9487,1702,2022-11-03 15:28:00,e6e488da5682344a90dac6cf0b08b578,0,14,0,2,10,26
9488,1702,2022-11-03 15:33:00,9de94b385a4f46be39e0cea14f3f9dd0,0,17,1,6,8,32
9489,1702,2022-11-03 15:38:00,92d03e11a0b95aade3d2baa45dee8a5e,0,9,0,5,11,25
9490,1702,2022-11-03 15:42:00,917468a196e0ed79d6e5070971420b11,0,13,0,2,8,23
9491,1702,2022-11-03 15:47:00,8b0b845bf3eb7add8cf9dabdd49d5a60,0,14,0,3,9,26
9492,1702,2022-11-03 15:52:00,0b2c1d3fc674f2fe3e72668748646f5b,0,6,0,5,7,18
9493,1702,2022-11-03 15:57:00,c2d3c5a0385ca9101d0051880c49a184,0,17,0,3,6,26
9494,1702,2022-11-03 16:03:00,0c8dbbdda9773cf63680d5325adcbf61,0,16,0,1,6,23
9495,1702,2022-11-03 16:07:00,cc4c7f52f1b6fb602f38650c42d26552,0,9,0,3,8,20
9496,1702,2022-11-03 16:12:00,33b2b32b15c70cffb267ed16be5c6ff6,2,11,0,2,12,27
9497,1702,2022-11-03 16:16:00,35508a55319fd9afc3df63981abfc0fb,0,6,0,1,6,13
9498,1702,2022-11-03 16:22:00,52e3fa990710e0c8f483dff75bf680ea,2,12,0,1,6,21
9499,1702,2022-11-03 16:27:00,7260c9b15208781a1d360e3a82b9c0fe,0,13,0,5,13,31
9500,1702,2022-11-03 16:32:00,248d61b81579203c7cdd09c1e9be6552,0,14,0,2,13,29
9501,1702,2022-11-03 16:38:00,fe6d54d7a18a95e81bda8be67fca78a4,0,24,0,0,10,34
9502,1702,2022-11-03 16:42:00,6351a83a89ff4701ccc416d87de580e0,1,13,0,4,7,25
9503,1702,2022-11-03 16:47:00,3a57e641ca8aa595d0d4f4a158d4274c,1,12,0,3,8,24
9504,1702,2022-11-03 16:52:00,82b65c7942fd499fc5e5c9f09083657b,1,11,0,0,11,23
9505,1702,2022-11-03 16:57:00,de7b54fbf8b98e216d283f7b14ee0a59,0,19,0,2,11,32
9506,1702,2022-11-03 17:03:00,a0b00acf0621ed50df53fdc9cd0e6cd7,0,20,2,5,10,37
9507,1702,2022-11-03 17:08:00,9491aa2f109d494efb092a5295b000f7,0,17,0,2,8,27
9508,1702,2022-11-03 17:13:00,c80517a30c56e95829a5372d44338c43,0,16,0,1,7,24
9509,1702,2022-11-03 17:17:00,84c1159fc1041f552f0ecbc29a69533e,1,19,0,5,6,31
9510,1702,2022-11-03 17:23:00,95e72f53df24f34e496bdb12ada7b156,0,16,0,5,7,28
9511,1702,2022-11-03 17:27:00,7b90876323a67f7dbc26e0b3abef5b80,0,19,0,12,8,39
9512,1702,2022-11-03 17:33:00,0d8ca26c586dd77bf282f9375768dbb4,0,19,1,2,16,38
9513,1702,2022-11-03 17:37:00,f03683951221647ec2422bd35ac4a8a5,3,16,0,2,13,34
9514,1702,2022-11-03 17:42:00,ee308a87d5667ebbfe3a9c791d10e6cb,0,12,0,4,11,27
9515,1702,2022-11-03 17:48:00,5619e54f889d344aa1c0e5066b60e3b2,0,22,0,1,10,33
9516,1702,2022-11-03 17:52:00,35a9a5ac81062779f2c1c0d2e0cdaa0b,1,24,0,1,8,34
9517,1702,2022-11-03 17:57:00,12159e91b323440b276883ed13bbb614,0,19,0,3,10,32
9518,1702,2022-11-03 18:02:00,e2fb0ebb2435290a1f9e1b501fb9a252,0,18,0,3,11,32
9519,1702,2022-11-03 18:07:00,0a7cff50bafcfbab922178f10a9131cd,0,18,1,1,12,32
9520,1702,2022-11-03 18:11:00,6bfc2eadb86542788b761edddd0bbd1b,2,21,1,1,12,37
9521,1702,2022-11-03 18:18:00,24404d1db290fba02828d9a1adf33857,0,18,1,2,9,30
9522,1702,2022-11-03 18:22:00,eb0e60b827e1d63296f6593f1f9477d3,1,21,0,5,7,34
9523,1702,2022-11-03 18:26:00,3db87b6b254daeab63160b7f5c8414b8,3,17,0,0,9,29
9524,1702,2022-11-03 18:32:00,5038fc0756a4f33db4add42551a3de69,0,16,0,1,8,25
9525,1702,2022-11-03 18:37:00,f0fb0327179cb8f25138bd5ce297490e,1,27,1,1,5,35
9526,1702,2022-11-03 18:41:00,f910c65ef64d73614c1e65a3f00f9a75,2,19,0,1,7,29
9527,1702,2022-11-03 18:47:00,845af596eb7579a7e1c9c2b0ed22c2c4,0,18,0,4,6,28
9528,1702,2022-11-03 18:52:00,387649079925c6afa0ac366405d0b5de,0,18,2,0,3,23
9529,1702,2022-11-03 18:56:00,4cf5238fe7f974be5378d151424feeb7,0,23,2,3,3,31
9530,1702,2022-11-03 19:02:00,69e95fa6a857ce9f7304519475fdd701,0,18,0,0,3,21
9531,1702,2022-11-03 19:07:00,31e2e220ae890809e2945e713db73001,0,15,4,0,2,21
9532,1702,2022-11-03 19:12:00,e0c95532f8a510b43ddb59fe5e863359,0,23,3,0,1,27
9533,1702,2022-11-03 19:16:00,31fe9be1cdc986920a121e109df1bb81,0,16,0,1,1,18
9534,1702,2022-11-03 19:21:00,e5ef6c0017614b62a1578021e0d2f406,0,19,1,0,1,21
9535,1702,2022-11-03 19:26:00,03be13d8a0c7fcfa6d1d96665e4b730c,0,21,0,0,4,25
9536,1702,2022-11-03 19:31:00,a0faceb66683878aa62f19f0fe6dd47c,0,21,0,0,0,21
9537,1702,2022-11-03 19:36:00,523817483824d1d4e9c98fcc1c841849,0,32,0,0,0,32
9538,1702,2022-11-03 19:42:00,64ee86c58b413c749f9917999d68a4bd,0,19,0,0,0,19
9539,1702,2022-11-03 19:46:00,c44bef766f4f0372e254eedeb565c67f,0,14,2,0,2,18
9540,1702,2022-11-03 19:51:00,dd9c349966344b068aa1eca1d11a7adf,0,23,0,1,2,26
9541,1702,2022-11-03 19:56:00,92d4f95da863956ef7a63b3599986911,0,15,0,0,0,15
9542,1702,2022-11-03 20:02:00,ea56b87c726b1526ccb44485eb857629,0,29,1,0,0,30
9543,1702,2022-11-03 20:06:00,dc44ca841f41aa3bd9648efcc303d98a,0,24,0,1,1,26
9544,1702,2022-11-03 20:12:00,945a3077674604badb2109912a0d7d92,0,31,3,0,0,34
9545,1702,2022-11-03 20:16:00,75f38e81b2951e9087e232fdc93adc6f,0,27,0,0,1,28
9546,1702,2022-11-03 20:22:00,4c970d28e73def42bc67bcad0c633e73,0,18,0,0,1,19
9547,1702,2022-11-03 20:27:00,81fbed45136daf400cfb29b698f0df19,0,19,0,1,1,21
9548,1702,2022-11-03 20:32:00,9364b925a74c2348a4507a0846f981b5,0,19,1,0,0,20
9549,1702,2022-11-03 20:37:00,4562d3e41eebb0cdca0a2bff0858d8f4,0,21,0,1,1,23
9550,1702,2022-11-03 20:42:00,b71c30ff50f18199186d662af5e027a3,0,10,1,0,2,13
9551,1702,2022-11-03 20:47:00,8d981f0e8fbca090775e7b0df259dc0b,0,22,2,1,0,25
9552,1702,2022-11-03 20:52:00,53d885643314009ddc5a970b1203c0f9,0,21,2,0,0,23
9553,1702,2022-11-03 20:57:00,8fe507b62740bc72a1a44267e6333908,0,20,2,0,2,24
9554,1702,2022-11-03 21:02:00,d61a667dd55ad23f1bd80e194a321465,0,10,1,1,1,13
9555,1702,2022-11-03 21:06:00,42936469473c8bc1318312da79d2eaa4,1,23,1,0,0,25
9556,1702,2022-11-03 21:12:00,71d0dcf06d5f4749263aaa0a33135a18,0,11,1,0,0,12
9557,1702,2022-11-03 21:17:00,8f223ee7eaffac00b642fc46aa0a6f25,0,21,0,0,0,21
9558,1702,2022-11-03 21:22:00,b209523525ccc60e6639d3b440b5c4c3,0,20,3,1,1,25
9559,1702,2022-11-03 21:26:00,1346c4a31a2033e82c7de5b1677b2e43,0,8,2,0,0,10
9560,1702,2022-11-03 21:32:00,e41ac88ee9eca5a15918b1fff92fbe7d,0,12,2,0,0,14
9561,1702,2022-11-03 21:37:00,3443e373cb7bc51305424e8c259d8e8e,0,17,1,0,1,19
9562,1702,2022-11-03 21:41:00,a72c74765583e70f59f723a3962c029a,0,13,1,0,2,16
9563,1702,2022-11-03 21:46:00,53f0cc5674edc1f34a4a1fa229355c6c,0,14,0,0,2,16
9564,1702,2022-11-03 21:52:00,7f9c139ff3160a310ebcca6e99b44461,0,21,2,0,0,23
9565,1702,2022-11-03 21:56:00,5a6eec27af2a85b014a0554baef3ed36,0,20,2,0,0,22
9566,1702,2022-11-03 22:02:00,4c8856ec6cf56fe4f72b998e645b6131,0,16,0,1,0,17
9567,1702,2022-11-03 22:06:00,00a8936afc79cf22ea43a209969b6ba1,0,18,0,0,0,18
9568,1702,2022-11-03 22:12:00,724c9d72f71c951e90b2052f06f7fada,0,23,0,0,0,23
9569,1702,2022-11-03 22:17:00,7aaa99aac2110b46560ffdc04e41e983,0,18,1,0,1,20
9570,1702,2022-11-03 22:22:00,403749608cff6ee04c88581e845740c6,0,19,0,0,1,20
9571,1702,2022-11-03 22:27:00,9b0b2cc95fb5f01baf2d4738da73aa52,0,13,0,0,1,14
9572,1702,2022-11-03 22:32:00,6880569351bfcc3e15f69704605d4a1c,0,15,0,0,1,16
9573,1702,2022-11-03 22:37:00,72ba680a2d105b1a10c8c605137f72b6,0,14,2,0,3,19
9574,1702,2022-11-03 22:41:00,10e33a7ccfed20469d3ce4432254e74f,0,15,2,0,1,18
9575,1702,2022-11-03 22:47:00,0f1946ee936acd2662fca85ea7794603,0,19,1,0,0,20
9576,1702,2022-11-03 22:51:00,1312fa62a7718f33d37b33ebd65b08d4,0,14,4,0,0,18
9577,1702,2022-11-03 22:56:00,df504f4551fbbd974bf3f7d1da52bedf,0,13,0,0,1,14
9578,1702,2022-11-03 23:02:00,ac6f1a1c59dcf08f681d36902300a3ba,0,16,1,0,1,18
9579,1702,2022-11-03 23:06:00,0e18e06921a554f36582cb163b0341a5,0,14,0,0,0,14
9580,1702,2022-11-03 23:12:00,e4c6d220e6dd223b81f0aa3ae0e13fbb,0,11,0,0,2,13
9581,1702,2022-11-03 23:17:00,3e1279be275d6d55612aaf9fc28e2e1f,0,4,0,0,0,4
9582,1702,2022-11-03 23:22:00,52707bb64f34c4ce77437a33d11183f6,0,15,0,0,0,15
9583,1702,2022-11-03 23:26:00,795de6f900ff344b4d7da83216d7e122,0,9,0,0,0,9
9584,1702,2022-11-03 23:32:00,eda8453396542f5a191d963ae7bf14bb,0,7,0,0,2,9
9585,1702,2022-11-03 23:37:00,3c6600d61fd28b054fb0ff6f3874e390,0,7,0,1,0,8
9586,1702,2022-11-03 23:42:00,19b158fdee156078f727a473f7c2507b,0,10,0,0,2,12
9587,1702,2022-11-03 23:47:00,7f5e8d643a7fdc9e8806763b7afc58ba,1,13,0,0,0,14
9588,1702,2022-11-03 23:52:00,e96108f81a669c7c9e1ed2220e1f718d,0,6,1,0,0,7
9589,1702,2022-11-03 23:56:00,2780111945f7f2c786dc93f335ceaf6e,0,9,2,0,0,11
9590,1702,2022-11-04 00:01:00,06365f552e8cc17156e94d86a83abb7a,0,6,0,0,1,7
9591,1702,2022-11-04 00:07:00,ce77df4f02e43e11a667b174b6446f8f,0,7,0,0,0,7
9592,1702,2022-11-04 00:12:00,2123ebe2c33a4107725cabe26dc6a8db,1,4,0,1,0,6
9593,1702,2022-11-04 00:17:00,7db68b89d535529f75c762f7ead31e27,0,10,1,1,0,12
9594,1702,2022-11-04 00:21:00,b04257a31bf8632f16539270724badb5,0,11,1,0,0,12
9595,1702,2022-11-04 00:26:00,fb47ed3ac3acd69c0ecdd5803bb30015,0,6,0,0,0,6
9596,1702,2022-11-04 00:32:00,ccc517433b16a129a8fabaac38098a85,0,11,1,0,0,12
9597,1702,2022-11-04 00:38:00,131a64c97e994638e031c40939f8a1d3,0,5,0,0,0,5
9598,1702,2022-11-04 00:41:00,5e33987bdc621e265d71b8b39a0ba09f,0,10,1,0,2,13
9599,1702,2022-11-04 00:46:00,2b715613c204f7117096b5951b18a24d,0,11,0,0,0,11
9600,1702,2022-11-04 00:52:00,900c3a57735ac40f9b45bf98e22ad1a9,0,6,0,0,0,6
9601,1702,2022-11-04 00:57:00,e342757657ebbab7761d809ba9530f95,0,11,2,0,0,13
9602,1702,2022-11-04 01:02:00,c36b4ab244f65f4a607b8740e7a24927,0,4,1,0,0,5
9603,1702,2022-11-04 01:11:00,9a2c945f7d25b82aa66095256ce42c8a,0,4,0,0,1,5
9604,1702,2022-11-04 01:16:00,ce2ea7c7872721f78bbacc078a3e641a,0,9,1,0,1,11
9605,1702,2022-11-04 01:22:00,23de3cfc451f4f58a8a44ea43b6e9af8,0,4,0,0,0,4
9606,1702,2022-11-04 01:27:00,6e3c0f3dd68c9bfbf017a29c0b8a3ec2,0,6,0,0,0,6
9607,1702,2022-11-04 01:31:00,4484a69500ffaf634989d70b8ba18a52,0,6,0,1,1,8
9608,1702,2022-11-04 01:37:00,2e2aa33f4bfd8dbfe9458ec83b316fe1,0,8,0,0,0,8
9609,1702,2022-11-04 01:41:00,8b723d78209712678ffe94164b6afdcf,0,13,0,0,0,13
9610,1702,2022-11-04 01:46:00,3224e049b3907b17f0e465e8a505a6b3,0,7,0,0,1,8
9611,1702,2022-11-04 01:52:00,0793a8e19c4cdba389e534672e770378,0,3,1,0,0,4
9612,1702,2022-11-04 01:56:00,5c75037ef864c9157fe5794b54348ec2,0,6,0,0,0,6
9613,1702,2022-11-04 02:01:00,0d173cb7d7b3953651b6a3ba6815b7ff,0,4,0,0,0,4
9614,1702,2022-11-04 02:07:00,80d9c2a1ca8ec767cc47219d1de36608,0,7,0,0,0,7
9615,1702,2022-11-04 02:11:00,8a8867cbf5650dd33c33c513dc0b20a0,0,9,0,0,0,9
9616,1702,2022-11-04 02:16:00,706d223824830aa5d2cd73499efbd5df,0,2,0,0,2,4
9617,1702,2022-11-04 02:21:00,d298a546dbe4ef6130570f0f5a32d55d,0,3,0,0,0,3
9618,1702,2022-11-04 02:26:00,6fefab7e3961ae84d4e093043b5de31f,0,6,0,0,0,6
9619,1702,2022-11-04 02:31:00,4326e1330897d900739f26b4b0825737,0,8,0,0,2,10
9620,1702,2022-11-04 02:36:00,df91f4d502d0e6a4e6fb95d69cdc611e,0,0,0,0,0,0
9621,1702,2022-11-04 02:41:00,08c999aad0d680e8ea7c1bb56d5b1e79,0,4,0,0,0,4
9622,1702,2022-11-04 02:46:00,1c3ab79562e065787cb780cb3b4271af,0,0,0,0,0,0
9623,1702,2022-11-04 02:51:00,40b54fef672831876683dc64c4c5ca2d,0,6,1,0,0,7
9624,1702,2022-11-04 02:56:00,c76213220165fe6554e30f728319d17a,0,2,0,0,0,2
9625,1702,2022-11-04 03:01:00,a7036f815ca323f9c00f1feac704590c,0,3,0,0,1,4
9626,1702,2022-11-04 03:07:00,a841484b233e00c9463ec7f49887c4fa,0,5,0,0,1,6
9627,1702,2022-11-04 03:11:00,c5e87d2b95d1cd4c73528186dabaec82,0,4,0,0,0,4
9628,1702,2022-11-04 03:17:00,e0cf1b01ad19fda7954824f6906a7664,0,13,0,0,0,13
9629,1702,2022-11-04 03:22:00,6a068ebf578d825c4b7af9824e60f27c,0,4,0,0,1,5
9630,1702,2022-11-04 03:27:00,50d3dad0258308f5c0e8518fc178cbe5,0,6,3,0,0,9
9631,1702,2022-11-04 03:32:00,a546c0d4c25c3a3df4c1560eace34d5b,0,2,0,0,1,3
9632,1702,2022-11-04 03:37:00,6e7487b1a094fa2bf6fce7e38e8a5369,0,3,0,0,0,3
9633,1702,2022-11-04 03:41:00,6554d552a9f3cba8c604c9d57996654d,0,1,0,0,0,1
9634,1702,2022-11-04 03:47:00,f612e98e3611c84d7e94f54690308fb7,0,5,0,0,0,5
9635,1702,2022-11-04 03:52:00,006d3df202da6028a18e597596ed9419,0,4,1,0,0,5
9636,1702,2022-11-04 03:56:00,51c44fbecc23cd570afd44e98fa6b5bb,0,0,0,0,0,0
9637,1702,2022-11-04 04:02:00,d3f959e9d1ee25c0218caf0c86721acd,0,1,0,0,0,1
9638,1702,2022-11-04 04:07:00,223534fe91863dbf2f04292209054b42,0,5,0,0,0,5
9639,1702,2022-11-04 04:11:00,6893bd9cef106c0d97b7e6807f19a9e9,0,3,0,0,0,3
9640,1702,2022-11-04 04:17:00,ef8fa0ff1f48d4d2431159b5d53a2a34,0,1,0,0,0,1
9641,1702,2022-11-04 04:22:00,894dbaf71c43c9e555cc6e27b3c7a46f,0,4,0,0,0,4
9642,1702,2022-11-04 04:26:00,acf8c94caec9356960d1eecd068bebc0,0,3,0,0,0,3
9643,1702,2022-11-04 04:32:00,a18b306ec1a2064ae7f1f524b39d375a,0,5,0,1,0,6
9644,1702,2022-11-04 04:37:00,27c8ce9f6d79d9ef042d83e1d43411fd,0,1,0,0,0,1
9645,1702,2022-11-04 04:43:00,768d7f237a69ca613f8caf856206411c,0,6,0,0,0,6
9646,1702,2022-11-04 04:47:00,ad9091e21ef76b07207d9a80f713ca8a,0,3,1,0,1,5
9647,1702,2022-11-04 04:52:00,2aa9996a80d10df9b6ba597bf5b5b773,0,1,0,0,1,2
9648,1702,2022-11-04 04:56:00,f1682248964ed361dafb8c90db7ae25d,0,5,0,0,0,5
9649,1702,2022-11-04 05:03:00,8334b0dff3548f12ea165b1a6830eff5,0,6,0,0,1,7
9650,1702,2022-11-04 05:08:00,78470cbf5ccee84f304e2e03ec612948,0,0,0,0,0,0
9651,1702,2022-11-04 05:12:00,c4806fefad3c86990aea1f36ef8cf317,0,3,1,0,0,4
9652,1702,2022-11-04 05:17:00,9bcf52d5306f361d70786bd9d9919f2f,0,1,0,0,0,1
9653,1702,2022-11-04 05:22:00,0ea728865f2468c3094df8850c76976e,0,3,0,0,0,3
9654,1702,2022-11-04 05:27:00,3dc42a5264ba324469b1a89c621fba9d,0,4,0,1,1,6
9655,1702,2022-11-04 05:32:00,62facf962b5f7cb2332d0b7ae1b717b2,0,7,0,1,1,9
9656,1702,2022-11-04 05:36:00,9d7946a9dee0f54ab4368b1154e4a0b7,0,2,0,1,1,4
9657,1702,2022-11-04 05:43:00,816b50c6deceb35d70a3a1a00bbb7fee,0,10,0,0,0,10
9658,1702,2022-11-04 05:48:00,1322cd9285f7f8f855d187013b5b5e3d,0,3,0,1,0,4
9659,1702,2022-11-04 05:52:00,fb03ff21e3f4fe2733180f8a8bb12121,0,8,0,1,0,9
9660,1702,2022-11-04 05:57:00,69b7ba68b12bddae023e7d305287f5d6,0,8,0,2,1,11
9661,1702,2022-11-04 06:03:00,87cb15b48ccb8d6c5b3023b04259d7ad,0,6,0,4,2,12
9662,1702,2022-11-04 06:07:00,416a661feea708eb0c6194ed8f377122,0,3,0,1,0,4
9663,1702,2022-11-04 06:12:00,7fac26713ccb77856eea8c15f80bf89b,0,3,0,1,1,5
9664,1702,2022-11-04 06:17:00,b331c4f6bbc78a1e16526dfe5d3eda9b,0,1,0,0,0,1
9665,1702,2022-11-04 06:22:00,c5a0f32395a3cb66a10179833dda5519,0,1,0,0,0,1
9666,1702,2022-11-04 06:26:00,99d28c4288f3cf890764ad57ff80db31,0,2,0,0,0,2
9667,1702,2022-11-04 06:32:00,d2a6aee3b065fee2469c00a8750970ad,0,2,0,0,0,2
9668,1702,2022-11-04 06:37:00,a6c63559b32e6008ef4cd7387c720241,0,10,0,0,0,10
9669,1702,2022-11-04 06:42:00,51bfb9e5aeb1ec29f600491e4825b7d9,0,7,0,0,0,7
9670,1702,2022-11-04 06:48:00,562aee29ab0c978852d3618cc1da3f98,0,5,0,2,0,7
9671,1702,2022-11-04 06:53:00,2b2779d53057f90ad2e3811070861d23,0,19,0,0,4,23
9672,1702,2022-11-04 06:56:00,6feeac55ac0e49e87c649437c0bb6ecb,0,16,0,2,7,25
9673,1702,2022-11-04 07:03:00,d28f31a1621798545fff81348a16312e,0,21,0,2,4,27
9674,1702,2022-11-04 07:08:00,691495263c019869f6b8c616cdbc8049,0,14,0,1,11,26
9675,1702,2022-11-04 07:12:00,f46acb3718e95c68597a0c7352575d84,0,13,1,1,11,26
9676,1702,2022-11-04 07:18:00,f7d8d221571449c717938136623525e2,0,12,1,1,9,23
9677,1702,2022-11-04 07:22:00,042dc44833a401619abaeddcd75519a8,0,13,0,1,10,24
9678,1702,2022-11-04 07:27:00,eb22ebff8971278eff2113c23c697c14,0,12,0,0,12,24
9679,1702,2022-11-04 07:33:00,69cb718775bfd59fd13f3f2f170a75af,0,17,0,4,5,26
9680,1702,2022-11-04 07:39:00,f38533dc5ac84d96132d17c54be8c6fa,0,13,0,2,10,25
9681,1702,2022-11-04 07:43:00,cbe8df7109dd4074f06bd69ad9317f80,0,21,0,4,9,34
9682,1702,2022-11-04 07:48:00,ae3a82b345e7dc9c31f0a71197a31920,0,19,0,0,7,26
9683,1702,2022-11-04 07:53:00,3bde16d03954eabc90d36ab44854e1cc,0,16,0,0,11,27
9684,1702,2022-11-04 07:56:00,717876010ebe9bd57ed709e19ff76e93,1,20,0,3,7,31
9685,1702,2022-11-04 08:08:00,86ca1d1dc91569690ccfe62be93ccd63,0,12,0,2,14,28
9686,1702,2022-11-04 08:13:00,b44bdb9d07674a3b272c7e6266a650b8,0,16,0,5,8,29
9687,1702,2022-11-04 08:18:00,de5452e52595b117b4050059f2269a4d,0,13,0,1,11,25
9688,1702,2022-11-04 08:22:00,66e8199478cadea815152b31c66c5bb4,0,12,0,3,11,26
9689,1702,2022-11-04 08:27:00,51a1600ba9062e945a54fb38acdd25f1,1,10,0,3,14,28
9690,1702,2022-11-04 08:32:00,3f3ef35ac7983f5c3d9aa8b4bd07c303,1,18,0,1,7,27
9691,1702,2022-11-04 08:38:00,d2383881b6ad91dce8583bc4458018ad,0,11,0,1,9,21
9692,1702,2022-11-04 08:42:00,86975b9a7ae51e9c4056c61f8e9f6fbe,1,18,0,1,6,26
9693,1702,2022-11-04 08:48:00,311bf4e71648f1bb9e9caf19f5a06e71,0,16,0,1,6,23
9694,1702,2022-11-04 08:54:00,9db6710a81da112386227843f521825f,0,11,2,3,10,26
9695,1702,2022-11-04 08:57:00,73b6f8120f13ffe8a4c2cb06c9447196,0,15,0,1,7,23
9696,1702,2022-11-04 09:03:00,d0db26b1ffa2c1b287d641003248e9e9,0,11,0,2,12,25
9697,1702,2022-11-04 09:08:00,73cff7411568af6ca9d50d985b0816d4,0,14,0,4,8,26
9698,1702,2022-11-04 09:13:00,636dacbf530daf8771f9ebc22ee9f618,0,13,0,6,10,29
9699,1702,2022-11-04 09:18:00,21e197e4c4c2c5e74e60a8ce4b81bf50,0,10,0,3,7,20
9700,1702,2022-11-04 09:23:00,8f51b75a3aa57066c335b1261dbb846f,0,19,0,1,7,27
9701,1702,2022-11-04 09:27:00,4e040c803dffbd74f7e4256d691cb2b3,0,15,0,0,6,21
9702,1702,2022-11-04 09:33:00,32389d1821963000b87dc88faba45a7e,0,18,0,3,3,24
9703,1702,2022-11-04 09:38:00,906ac621afe2f9c6d6879a5ade7fbf30,0,16,0,1,8,25
9704,1702,2022-11-04 09:43:00,4554286981652bb66f206d10f056e367,0,15,0,1,7,23
9705,1702,2022-11-04 09:49:00,b87c13e49e63d3c25ed473cba3984911,0,14,1,2,10,27
9706,1702,2022-11-04 09:53:00,f6bba33a9c1d11ea91395d06a7e60f13,0,14,0,2,8,24
9707,1702,2022-11-04 09:57:00,fa91532e18f7f30f9032f08288bb447a,0,19,1,2,6,28
9708,1702,2022-11-04 10:02:00,fbee3592c3483ea33e2636db85ba87d2,0,10,0,0,10,20
9709,1702,2022-11-04 10:08:00,aae4b9a0fee75c9fb7f62975ea63fb04,0,12,0,3,8,23
9710,1702,2022-11-04 10:13:00,a40193e6b71aa00f66c050f1ca11bf9b,1,19,1,3,5,29
9711,1702,2022-11-04 10:18:00,3b8232a9284d3c86640bd6c484c7532c,0,11,0,7,6,24
9712,1702,2022-11-04 10:22:00,f20d3d5cdeee8dc15c7b603b489bd0d0,0,11,0,1,10,22
9713,1702,2022-11-04 10:28:00,1dee9a96ebb762d648618f6b6d72d03e,0,13,0,1,11,25
9714,1702,2022-11-04 10:33:00,34ccba2e556495d0b4d4484a74475642,0,14,2,0,9,25
9715,1702,2022-11-04 10:39:00,c5fcdedca5356851e6e276fa6f9cd494,0,15,0,3,7,25
9716,1702,2022-11-04 10:42:00,94e18658d4cce6af461be7e344226418,1,16,0,5,3,25
9717,1702,2022-11-04 10:48:00,0d0fff83d7ddcdd0f56293fa24e6cf68,1,16,0,4,8,29
9718,1702,2022-11-04 10:53:00,117a9333d445763292bb327d106038e2,0,14,1,9,11,35
9719,1702,2022-11-04 10:58:00,465cf4950b0e4e6a7375ca62653629ee,0,16,0,4,5,25
9720,1702,2022-11-04 11:04:00,cb0f63c5d7eadfcc24e2fb057564853c,0,11,0,3,8,22
9721,1702,2022-11-04 11:08:00,b230b476bbe52996b4f17ea51522db02,0,17,0,2,5,24
9722,1702,2022-11-04 11:13:00,c5acd4fa3b458af6a01cd192201e8f15,0,15,1,6,10,32
9723,1702,2022-11-04 11:18:00,1b2641ef413112a28d929ffa3018f570,0,10,0,9,8,27
9724,1702,2022-11-04 11:23:00,ab41820714ec08103a57ed61549f9f55,0,16,0,2,10,28
9725,1702,2022-11-04 11:27:00,ae0e721ca96be9f2038440a567873a9f,1,12,0,3,10,26
9726,1702,2022-11-04 11:32:00,056574d36049ea2ce761d6de4c200b53,0,16,0,2,10,28
9727,1702,2022-11-04 11:37:00,ec5e140203b226f7b194a66e9c35597c,0,12,0,2,10,24
9728,1702,2022-11-04 11:42:00,496059bfa4115e0dcf841ac20a786da3,0,14,0,6,9,29
9729,1702,2022-11-04 11:47:00,f23bfbd0a743de8c3f4af263e8b0fac6,0,14,0,0,13,27
9730,1702,2022-11-04 11:58:00,5c5e799f2ad2c22533f971e9eb9450ca,0,16,0,1,10,27
9731,1702,2022-11-04 12:02:00,f87bec5534bc2e5190010ce79eafc924,0,11,1,2,15,29
9732,1702,2022-11-04 12:08:00,334982165963433ad6b532a8da809160,0,21,0,6,3,30
9733,1702,2022-11-04 12:12:00,db4cb93370cc49ed691b32599842be10,0,17,0,1,9,27
9734,1702,2022-11-04 12:17:00,a9365e76e85d90278bbccd5be97182c5,1,15,0,3,10,29
9735,1702,2022-11-04 12:23:00,488413b00a286eff0182f6f04f42a532,0,13,1,2,10,26
9736,1702,2022-11-04 12:27:00,6935455030a8393b7548bfaf5d5b1746,0,14,0,3,9,26
9737,1702,2022-11-04 12:33:00,bb5594bd91a2d61db6c6f628a7ed3010,0,15,0,5,12,32
9738,1702,2022-11-04 12:41:00,180d828060afb1029198277ba76a3dd3,0,13,0,7,9,29
9739,1702,2022-11-04 12:48:00,56035585aa0be7a546a551c937c32831,0,18,1,3,3,25
9740,1702,2022-11-04 12:52:00,024e53d2df1bd5677f519f72eb5df9c4,0,23,0,8,2,33
9741,1702,2022-11-04 12:57:00,70e82f3ea2a1ce7212aaa27bce1068c4,0,12,1,4,5,22
9742,1702,2022-11-04 13:02:00,5d9d6a87dd9206a005c8f99005064a05,0,15,1,3,7,26
9743,1702,2022-11-04 13:08:00,feac7bffb4b045c84ddaa27e918a49ca,0,15,1,2,6,24
9744,1702,2022-11-04 13:12:00,8ded5f208c9ce74ad74ed678825a0999,0,16,0,3,8,27
9745,1702,2022-11-04 13:17:00,b5b4d8d0b3e3c56715a5fe6a2a771428,3,20,0,2,1,26
9746,1702,2022-11-04 13:22:00,0339b249b39361156b1468721cae5709,0,15,0,4,11,30
9747,1702,2022-11-04 13:28:00,0d8aacaf1707139700c92fc2cdebb23a,0,16,0,4,3,23
9748,1702,2022-11-04 13:32:00,fd6539abe585490b5e80b4d15999ea1f,0,15,0,2,3,20
9749,1702,2022-11-04 13:38:00,f7fc4d4234f87a3d9ad096f7994852f4,0,17,0,4,7,28
9750,1702,2022-11-04 13:43:00,9bed615c6ed115493876a8deb7c356eb,0,16,1,4,7,28
9751,1702,2022-11-04 13:48:00,c15517b359731f933c37ad1ebf4f5e58,0,9,0,0,12,21
9752,1702,2022-11-04 13:53:00,3aec30856c2f845be29811b77f245f4f,0,16,0,4,8,28
9753,1702,2022-11-04 13:58:00,126895bd2ed93233d5ffddb787a6374d,0,11,0,6,11,28
9754,1702,2022-11-04 14:02:00,dc3b48ba41e553457cd4c8e4fc29eafc,0,14,1,1,8,24
9755,1702,2022-11-04 14:09:00,ee78d284891a75bb4728e7cddfc754a1,0,16,0,8,4,28
9756,1702,2022-11-04 14:12:00,e94e92f8c6f0af575bf0a606e52cb91a,0,12,0,6,7,25
9757,1702,2022-11-04 14:18:00,e5729552256ac706febbf111b99be217,0,11,0,4,8,23
9758,1702,2022-11-04 14:23:00,f8d15168f54d199e568b68e030508703,0,14,0,4,11,29
9759,1702,2022-11-04 14:27:00,fa57b35280c3da180e9a5b26733f79b1,3,17,0,2,6,28
9760,1702,2022-11-04 14:33:00,6bf4eb7b75e996380149ce0f1b2429fa,0,14,0,4,10,28
9761,1702,2022-11-04 14:37:00,b1cd721e601cace11334186d93d333c7,0,19,0,3,9,31
9762,1702,2022-11-04 14:41:00,648e9b2b0b472c7728a18efcaa50534a,0,13,0,2,13,28
9763,1702,2022-11-04 14:47:00,052567078a3f98a6374b0f5183dc5c69,0,19,0,5,2,26
9764,1702,2022-11-04 14:53:00,4c53e4877b7dffefdfbefa617256ac44,0,10,0,2,16,28
9765,1702,2022-11-04 14:56:00,4c3ef51cf0315efbec55f3066112a847,0,11,0,3,13,27
9766,1702,2022-11-04 15:04:00,0ff2ac1181c5f50e7781fd1df52ebc47,0,14,0,3,13,30
9767,1702,2022-11-04 15:08:00,89839b8d888585549900ccc2111587a8,0,19,1,0,8,28
9768,1702,2022-11-04 15:12:00,f1120f3a1263b93ab7c4d4ec0e341c5e,0,20,0,0,8,28
9769,1702,2022-11-04 15:19:00,12106f4c2201baf74cd28f020fa0181c,0,11,0,4,12,27
9770,1702,2022-11-04 15:23:00,0f14ee2492ca1ef59d3c1e2aeb40c306,0,18,0,3,7,28
9771,1702,2022-11-04 15:28:00,4346b448c2b168b000d8b637dbbc56ca,1,12,0,4,10,27
9772,1702,2022-11-04 15:32:00,fc53e4e4fc192887d0ebbd696f99157f,0,10,0,5,6,21
9773,1702,2022-11-04 15:39:00,10f4de189f610eddf1430f9014034bee,0,9,0,7,14,30
9774,1702,2022-11-04 15:42:00,d173161e2d6dcbcd8f5b14604b4a4318,0,9,0,2,12,23
9775,1702,2022-11-04 15:47:00,168a9fae1d674fb374befb081f204c20,0,12,1,3,11,27
9776,1702,2022-11-04 15:53:00,9581127eb6afac3cc4c38f3d22480adc,0,13,0,0,10,23
9777,1702,2022-11-04 15:58:00,4a8b9d5c2892a366d5f51f80ade0ac0a,0,17,0,1,8,26
9778,1702,2022-11-04 16:03:00,f06d6fa07933fa1093502e7589e6b7a3,1,12,0,3,15,31
9779,1702,2022-11-04 16:08:00,3f1bcbbd0d281d0c905dad9108b15679,0,8,0,2,8,18
9780,1702,2022-11-04 16:12:00,6945e6d08bea66dd46cfbd5bea672865,0,14,2,0,9,25
9781,1702,2022-11-04 16:18:00,0d63938d71c43818d03f6a511f04bd5c,0,10,0,2,5,17
9782,1702,2022-11-04 16:23:00,0c3fb6ae0cba63670c2c678a68ba81d7,0,10,0,0,7,17
9783,1702,2022-11-04 16:28:00,30d35b22bb2bc56418f647390e1d30c2,0,12,0,4,10,26
9784,1702,2022-11-04 16:32:00,e0e668b89867aa44fc4bc4490b5d0e4a,0,12,0,3,14,29
9785,1702,2022-11-04 16:38:00,cfc2c9f498e938d37a03897dec608348,0,12,0,0,10,22
9786,1702,2022-11-04 16:42:00,dd8b1f25cc08e1b12f3807f4ba2c7818,1,17,1,3,6,28
9787,1702,2022-11-04 16:47:00,10d5793196396c5af98b9213376435c4,0,14,0,0,9,23
9788,1702,2022-11-04 16:52:00,03b56df207a3bba5228ca860c791fabf,1,20,1,2,9,33
9789,1702,2022-11-04 16:58:00,8a7fe98709e22eb1e16ecea47f8ac965,0,17,0,0,6,23
9790,1702,2022-11-04 17:03:00,db2909d65b834e43bd8d670c9bbe992f,0,12,0,5,8,25
9791,1702,2022-11-04 17:07:00,ef1b23527690012bc35ed93ad2d75671,1,19,0,3,14,37
9792,1702,2022-11-04 17:12:00,06ce4c755c66d8a91dc4e923afad152d,0,18,0,1,8,27
9793,1702,2022-11-04 17:19:00,66d7d9fe087a4e9314a47b9b813ff5f8,0,21,0,6,11,38
9794,1702,2022-11-04 17:22:00,944e6fc497aa7abe737311e9db0f0fe4,0,23,1,3,9,36
9795,1702,2022-11-04 17:27:00,c447b63089e8700dfe01bbabf571f9ff,0,20,1,6,11,38
9796,1702,2022-11-04 17:33:00,50646259f07585dcedfe401900dbefa4,0,18,0,4,6,28
9797,1702,2022-11-04 17:38:00,83989ab2233297bae2bc9bd700512c4f,2,13,0,4,11,30
9798,1702,2022-11-04 17:43:00,b4fbbd58485107c6282b00a342f805bc,1,12,0,2,16,31
9799,1702,2022-11-04 17:48:00,c270364b1b29efbae761b434d6191a76,0,13,1,4,11,29
9800,1702,2022-11-04 17:53:00,3a4982d6d2ff54570d3e9dcf3ce12844,1,14,0,4,7,26
9801,1702,2022-11-04 17:58:00,5d2172b76f6eda0c0281748b2cf82356,1,22,0,5,6,34
9802,1702,2022-11-04 18:02:00,6eeb6f45ef343c6286f60bde1de25a75,0,18,0,1,14,33
9803,1702,2022-11-04 18:07:00,f28d8eca7c650db3d9a65952628a8321,0,11,0,5,12,28
9804,1702,2022-11-04 18:12:00,98e01458c950febbc7624da7dd288c22,0,15,1,5,10,31
9805,1702,2022-11-04 18:18:00,d7b29c515a1d70da87fd6ab70e094dea,0,16,0,0,13,29
9806,1702,2022-11-04 18:22:00,21b90d9f7960f974a4ef51d782675077,0,15,0,4,10,29
9807,1702,2022-11-04 18:26:00,523ce8f430a295b0a611ddeff5bea82d,0,27,1,1,4,33
9808,1702,2022-11-04 18:33:00,e415a3b4792a662f57284f7c0ff6e06b,1,18,0,1,8,28
9809,1702,2022-11-04 18:38:00,4fdd582c15bada3074d4ebe449d58cf3,0,14,0,4,11,29
9810,1702,2022-11-04 18:42:00,6fc1e9cd2564b534239f8eeee88bf1d2,0,8,0,1,13,22
9811,1702,2022-11-04 18:48:00,43c3998dd23fde74b395ef6531d3aa3e,0,13,0,4,11,28
9812,1702,2022-11-04 18:52:00,4e314603198352bdfc0c59628f76cb42,0,18,1,2,9,30
9813,1702,2022-11-04 18:57:00,ad4526f4b77ec16dde6140bf8ae4c2d8,0,27,2,3,1,33
9814,1702,2022-11-04 19:02:00,bcc554944ab0e470d7eb813c7546720d,0,25,0,0,4,29
9815,1702,2022-11-04 19:07:00,ac164c03345866fdb2a68a7cd04cc377,0,26,2,0,2,30
9816,1702,2022-11-04 19:12:00,1311ed594849aa9a71b8c7146903f52d,0,28,2,1,1,32
9817,1702,2022-11-04 19:17:00,0c9d385319666e4c9b76ef2805d3e729,0,24,3,2,5,34
9818,1702,2022-11-04 19:23:00,d6d2ae585a9ade3cf7a9264246a809c1,0,27,1,2,2,32
9819,1702,2022-11-04 19:27:00,f57022bd663998395cea441bb99ef67f,0,32,2,2,0,36
9820,1702,2022-11-04 19:32:00,60e101cd6869c433ce2590c08328ad83,0,17,0,5,1,23
9821,1702,2022-11-04 19:37:00,991221f30eb77cfb59c7b850a16ab202,0,22,0,1,1,24
9822,1702,2022-11-04 19:41:00,2f2a89dc66efdd6ce941831e1b57dfd2,0,10,0,2,2,14
9823,1702,2022-11-04 19:47:00,80c5788f360b9ffa846d7a7950b66df8,0,22,0,1,0,23
9824,1702,2022-11-04 19:52:00,a983fdf9c5d32dee72bc108ac27e522f,0,14,0,4,0,18
9825,1702,2022-11-04 19:57:00,ae896af5ebe15cac03e4690bc7a6f8e0,0,12,3,0,1,16
9826,1702,2022-11-04 20:02:00,6e90c90f5fe8cf57f837e88a6d3967d5,0,15,3,3,0,21
9827,1702,2022-11-04 20:08:00,7bd2985d24b0b81da3feeb5142037372,0,20,1,0,0,21
9828,1702,2022-11-04 20:11:00,82e81e3d1a5e46aea09c9d0c423744c1,0,17,0,0,0,17
9829,1702,2022-11-04 20:17:00,50a1d6cbc432b1db7f93063bfb8b71f5,0,26,0,1,1,28
9830,1702,2022-11-04 20:21:00,ac67503aeec45a512b9bd87cd939f5de,0,12,5,1,0,18
9831,1702,2022-11-04 20:27:00,90f366a740a10cddb4cf8b83bf13c55b,0,20,2,0,3,25
9832,1702,2022-11-04 20:32:00,484cc71ace0b5f6453bd46254678c5e6,0,18,2,0,0,20
9833,1702,2022-11-04 20:37:00,a6a982e0b5a06d2c6e92320c66eb594c,0,16,2,0,0,18
9834,1702,2022-11-04 20:42:00,1490e8a02ae3ad0ea9e938d29f88f156,0,17,2,1,1,21
9835,1702,2022-11-04 20:48:00,2741e847df639bd4748604e123c6f221,0,21,2,1,0,24
9836,1702,2022-11-04 20:53:00,bdeb7b388439c381a89fe0043a0545f4,1,23,1,0,0,25
9837,1702,2022-11-04 20:57:00,2d66af8cd98381add29ceccdf59ccc0b,0,27,0,0,0,27
9838,1702,2022-11-04 21:03:00,2ab254acd45590b281c76a5b875f0d7c,1,22,0,1,0,24
9839,1702,2022-11-04 21:08:00,cdab125be758ed527f626e4a223263eb,0,26,0,1,2,29
9840,1702,2022-11-04 21:12:00,3487bf05ecd27b0bce871924251b570d,0,22,2,2,0,26
9841,1702,2022-11-04 21:17:00,fc2033e590aa0ccd2c28ce1ed57fa35a,0,23,0,1,1,25
9842,1702,2022-11-04 21:21:00,4da70a4957121b93ac79893e6ec7ba11,1,22,0,0,0,23
9843,1702,2022-11-04 21:27:00,1f3d16bf0d581adadde7a9d7490edc55,0,29,2,0,0,31
9844,1702,2022-11-04 21:31:00,14e687ef0faf8c253b4c3eb58abe1b72,0,26,0,1,1,28
9845,1702,2022-11-04 21:37:00,8d26183958957aa71fa9a970c16bf56d,0,24,0,0,1,25
9846,1702,2022-11-04 21:42:00,21e1a8d8732a9d011424deac88ef5656,0,24,1,0,1,26
9847,1702,2022-11-04 21:47:00,2135548aab142af9d98704f339a8d3c7,0,27,1,0,0,28
9848,1702,2022-11-04 21:51:00,dc70891c4500959a94bfd209374cbe77,0,23,0,0,1,24
9849,1702,2022-11-04 21:57:00,1327cbadcc2b10794989d008fc550b76,0,23,1,0,2,26
9850,1702,2022-11-04 22:02:00,9f42b75ff74d867f06fadec7cab74c95,0,24,1,1,2,28
9851,1702,2022-11-04 22:07:00,0558ad37ce6ca461fb7ab11e03cdc8e2,0,20,0,1,1,22
9852,1702,2022-11-04 22:12:00,246a8ec202ff6a9c8a028e0331d174a0,0,16,0,0,0,16
9853,1702,2022-11-04 22:17:00,dfdfad9966fdf517b20e94071721a912,0,16,1,0,0,17
9854,1702,2022-11-04 22:22:00,ad861d6ba5b1d9d4b3a93c2be28bd49d,0,16,3,0,0,19
9855,1702,2022-11-04 22:27:00,74b1ab03e34f56080fd834c79e67f384,0,16,0,0,1,17
9856,1702,2022-11-04 22:32:00,926f0fbf7f6e497240b2a031977db3ae,0,12,0,0,1,13
9857,1702,2022-11-04 22:37:00,2bd5f1f373e0b37e30d50df53f28a0fc,0,17,2,1,2,22
9858,1702,2022-11-04 22:41:00,0100ffa203fcc7fb77718dcacf3d09fd,0,19,0,0,1,20
9859,1702,2022-11-04 22:47:00,ae36373c540b64956525877e72e17af7,0,21,0,0,0,21
9860,1702,2022-11-04 22:52:00,b09e76408ef333e9260be7894d87edfd,0,17,0,0,1,18
9861,1702,2022-11-04 22:57:00,c3ccb712604b858a028eba3578e78fb2,0,11,0,1,0,12
9862,1702,2022-11-04 23:02:00,d31d81dd6d5b28e89b900bfee5de259a,0,8,1,1,1,11
9863,1702,2022-11-04 23:06:00,b508db72a8300c321d827345562eebab,0,8,0,0,1,9
9864,1702,2022-11-04 23:11:00,8054a914e947d9eec2ae1518766d8e3b,0,15,0,1,0,16
9865,1702,2022-11-04 23:17:00,668044e6ce77475630d9de13a61285b6,0,23,1,1,0,25
9866,1702,2022-11-04 23:22:00,52566e8f0cce21d8ebff7fa0d364abdc,1,20,1,0,2,24
9867,1702,2022-11-04 23:27:00,1844db08b8dda993e373da36b9bb3e49,0,15,0,2,0,17
9868,1702,2022-11-04 23:32:00,5bbf5230f2d02b09f5a8c2294d94fdbb,0,21,0,1,0,22
9869,1702,2022-11-04 23:37:00,ea646a662d5b706496147f4a9ac01fc9,0,12,1,0,0,13
9870,1702,2022-11-04 23:42:00,b507b1ed7a9c61db89e533a01e80e9ed,0,12,0,1,0,13
9871,1702,2022-11-04 23:48:00,6c3fa44cd980be7b8b8fd423db490a08,0,13,0,0,0,13
9872,1702,2022-11-04 23:51:00,47478f4c6eec75de5b3317a7f66a362b,0,16,1,0,0,17
9873,1702,2022-11-04 23:56:00,4e63d0a042a1d7bba9be5728c362e5f4,0,16,0,0,0,16
9874,1702,2022-11-05 00:02:00,90335d87a93c63776f1d717860174188,0,4,0,0,0,4
9875,1702,2022-11-05 00:11:00,acc2a684438e07bcf91896a5d45f91cb,0,1,0,0,1,2
9876,1702,2022-11-05 00:17:00,20d92d62adf8e1d6b4ae29429b181501,0,7,0,1,0,8
9877,1702,2022-11-05 00:22:00,43efa7863ccdc2dd90ac022766543dfd,0,7,0,0,0,7
9878,1702,2022-11-05 00:27:00,4fe96c564c5c766147542c9c6678cf74,0,16,0,0,0,16
9879,1702,2022-11-05 00:33:00,99bfa76a1a5f92b1f41296ab0b1565fe,0,5,0,0,0,5
9880,1702,2022-11-05 00:36:00,fd2952d3c5a25eab21a7b8f2adeb37a0,0,4,0,0,1,5
9881,1702,2022-11-05 00:41:00,f46936d4c881fee59c5529f7fdab7eb0,0,6,0,0,0,6
9882,1702,2022-11-05 00:48:00,d29cc9a83a9bc7537f8e7206c263bbe6,0,13,0,0,0,13
9883,1702,2022-11-05 00:52:00,57da566861f2a8be85d766e3cf3d84bf,0,12,0,0,0,12
9884,1702,2022-11-05 00:57:00,409ae6a5654b57ccbd257eff8ebbde87,0,9,0,0,0,9
9885,1702,2022-11-05 01:02:00,6da195e73cd3ceb093e030a9e8ac531c,0,15,0,0,0,15
9886,1702,2022-11-05 01:07:00,1aff267fdfcd58cae6d7b5440e527bbd,0,0,0,0,0,0
9887,1702,2022-11-05 01:12:00,5d90a548f85675e648edebdbfdee12f2,0,14,0,0,0,14
9888,1702,2022-11-05 01:18:00,59c316def21c29ccc10077e1bc70cb20,0,8,0,0,0,8
9889,1702,2022-11-05 01:22:00,b7c7a6b6c4e188a18bb8792b5aa2c67e,0,11,0,1,0,12
9890,1702,2022-11-05 01:27:00,e23d89227517d6780b066d82698be364,0,7,0,0,0,7
9891,1702,2022-11-05 01:32:00,81cfdf3fa05b4ae45615cf62fefa65f1,0,12,1,0,0,13
9892,1702,2022-11-05 01:37:00,a82e975b714ad8203d8d9a6dce62444d,0,9,0,0,1,10
9893,1702,2022-11-05 01:41:00,0d31b183d4e2afad3a4a4e867027a7e5,0,4,2,0,0,6
9894,1702,2022-11-05 01:47:00,719288dd0d1ef43d21a5286d5102c444,0,4,1,0,1,6
9895,1702,2022-11-05 01:51:00,baad81f3962aa61ed3676be96e508f37,0,6,1,2,0,9
9896,1702,2022-11-05 01:56:00,4775cac4fba2c20a268d4b4a0f9578bd,0,10,0,0,2,12
9897,1702,2022-11-05 02:02:00,d6e91613438bb538af36a4f6752d7a6d,0,3,0,0,1,4
9898,1702,2022-11-05 02:06:00,835fba3faa17a1abb106973cea5afc05,0,10,0,0,0,10
9899,1702,2022-11-05 02:12:00,f735263dae335e4ad66a9a3d7d40d70d,0,3,0,0,1,4
9900,1702,2022-11-05 02:16:00,18a0da46a23e17e146c4cb7f48b7f42b,0,13,0,0,0,13
9901,1702,2022-11-05 02:22:00,fad6cf307d8ec08ef84233ff6779f823,0,9,0,0,2,11
9902,1702,2022-11-05 02:27:00,9cb89f3d314d8964a3f6f3b1660b7037,0,8,1,0,1,10
9903,1702,2022-11-05 02:32:00,6e39f80648afb4d478ed3302a5c10817,0,12,1,0,0,13
9904,1702,2022-11-05 02:37:00,cc72da2d9c6c2c0e7b779b8d72e7d1ef,0,6,0,0,0,6
9905,1702,2022-11-05 02:42:00,6893c816a1193de369117bd5c0f79265,0,7,1,0,0,8
9906,1702,2022-11-05 02:47:00,1d476560db609a188ff98ec8d17a2455,0,5,0,0,1,6
9907,1702,2022-11-05 02:52:00,f266309e937aeb38dfda7daf2f7260b5,0,1,0,1,0,2
9908,1702,2022-11-05 02:57:00,4bd958479efd6bcf2dcaf266ce312eea,0,6,0,0,0,6
9909,1702,2022-11-05 03:01:00,37d9ed4b1cbf8d53fcad7487dc7d89cb,0,13,0,0,0,13
9910,1702,2022-11-05 03:07:00,f5bef61adf16c2b087f4397d5ec21102,0,8,0,0,0,8
9911,1702,2022-11-05 03:11:00,86622ae250cccc6d943da836145828a3,0,5,1,0,0,6
9912,1702,2022-11-05 03:17:00,9b9ceee49237c15f08f4fcf35c4ed7e8,0,8,0,0,1,9
9913,1702,2022-11-05 03:22:00,d7ee7601967cd7c57c168c39abedda9b,0,8,0,0,1,9
9914,1702,2022-11-05 03:26:00,dc67e41784c4115a0d9e2f6cded20996,0,6,0,0,0,6
9915,1702,2022-11-05 03:32:00,85fbf5d7e1c72c76c131dce2742101ab,0,6,1,1,0,8
9916,1702,2022-11-05 03:39:00,f4e9aa15a7617b746288a09bfbc467ca,0,8,0,0,0,8
9917,1702,2022-11-05 03:42:00,2675f296a1c58f23c84891bcdde60b5e,0,12,0,0,0,12
9918,1702,2022-11-05 03:47:00,08cd0be8cc498e464c93cefef60e8835,0,4,0,0,0,4
9919,1702,2022-11-05 03:51:00,442126aa6588e929811b24af965841c1,0,6,0,0,2,8
9920,1702,2022-11-05 03:56:00,ca090b23d9000997a64f3fcd003457d9,0,12,0,1,0,13
9921,1702,2022-11-05 04:02:00,96ff11ff9f945c08fa38c7d359e6a987,0,9,1,0,0,10
9922,1702,2022-11-05 04:08:00,39d2811da5bb872193874581b77a8570,0,5,0,0,0,5
9923,1702,2022-11-05 04:11:00,ad57b13995935fb9f6b3dc2c8bca33e0,0,6,0,0,0,6
9924,1702,2022-11-05 04:17:00,16562a9782dcbcf6bd9452b296d0b044,0,11,0,0,2,13
9925,1702,2022-11-05 04:22:00,0936646c0d9ab7986d21a19b129f1735,0,5,1,0,0,6
9926,1702,2022-11-05 04:27:00,b3394ff39d899f3c0932500475e8f4ab,0,4,0,0,0,4
9927,1702,2022-11-05 04:32:00,e12fe6d1c7ad63dfb81bf1831312d4e1,0,2,0,0,2,4
9928,1702,2022-11-05 04:37:00,f13b8861d430c2bbdea2357622e8f7f9,0,4,0,1,0,5
9929,1702,2022-11-05 04:41:00,8df56452e188361def2bb3561582a56a,0,1,0,0,0,1
9930,1702,2022-11-05 04:47:00,eee5768e4b77471106f45fad0b2fcf4b,0,0,0,0,0,0
9931,1702,2022-11-05 04:51:00,17cc5ef4bc06e7220a8990905d26b956,0,0,0,0,0,0
9932,1702,2022-11-05 04:56:00,26e05addc3d99791fcb814826ffa383c,0,0,0,0,0,0
9933,1702,2022-11-05 05:01:00,660fc89b2312d9054787c708a9ae2b9b,0,2,0,1,0,3
9934,1702,2022-11-05 05:06:00,8af5f7a768b28b442b0101c766386363,0,4,0,0,0,4
9935,1702,2022-11-05 05:11:00,efa14901ddcb2304a6ebaafcc6f2bc1d,0,0,0,0,0,0
9936,1702,2022-11-05 05:16:00,d6e774838d63476dc09441148354d8bb,0,0,0,0,0,0
9937,1702,2022-11-05 05:21:00,3682b019d56c4c14c36cd2f4da28ae6f,0,0,0,0,0,0
9938,1702,2022-11-05 05:26:00,4cb0d2532b1034a6ad7bd7cab256a8bc,0,0,0,0,0,0
9939,1702,2022-11-05 05:31:00,15085228c501f5571ad15a0619c9b9d8,0,3,0,0,0,3
9940,1702,2022-11-05 05:37:00,8f0721947bfc1368a1df019322da6243,0,1,0,0,0,1
9941,1702,2022-11-05 05:42:00,f09c1fb77a763e1a6b638da3fcf632ed,0,0,0,0,0,0
9942,1702,2022-11-05 05:47:00,165d4ec657617013d3c4e1b9c9e88713,0,0,0,0,0,0
9943,1702,2022-11-05 05:52:00,0f986a7ffdb192ce2396eae06f071b79,0,0,0,0,0,0
9944,1702,2022-11-05 05:56:00,d24180ec612ec07f8418897182d75ee0,0,3,0,0,0,3
9945,1702,2022-11-05 06:01:00,21334a259909bff40c0762ade452663d,0,1,0,0,0,1
9946,1702,2022-11-05 06:07:00,8361a18a20ebedfd28aada0e7cbf1221,0,0,0,0,0,0
9947,1702,2022-11-05 06:11:00,bda724262445571d1024ba4a302882ff,0,1,1,0,0,2
9948,1702,2022-11-05 06:17:00,b128d9efe6538146d04052cecc1c07a5,0,3,0,0,0,3
9949,1702,2022-11-05 06:21:00,c7ac4f12ee909d42badf23fbe47faaf5,0,2,0,0,0,2
9950,1702,2022-11-05 06:27:00,6f7b05ae5d0908244a179b09d1a83884,0,0,0,0,0,0
9951,1702,2022-11-05 06:32:00,bb8720bb0fa4d07e57627a3bb27ad18d,0,0,0,0,1,1
9952,1702,2022-11-05 06:37:00,303de07cbd379727a7e9a08ca784cb58,0,2,0,0,0,2
9953,1702,2022-11-05 06:41:00,2a6884258a6c2f795f3a3ec5a8391db7,0,2,0,0,0,2
9954,1702,2022-11-05 06:47:00,448e69900593270f08d5d7fdcc84445b,0,5,0,0,0,5
9955,1702,2022-11-05 06:51:00,b704b73a80b2ef059f9d9ee2bcd81da6,0,1,0,0,0,1
9956,1702,2022-11-05 06:56:00,6a15f34f9ac9614ef543fab2a881aa5e,0,6,0,1,0,7
9957,1702,2022-11-05 07:02:00,cf51bc1bcd10d6a9ac6fc53a0e66051c,0,1,0,1,0,2
9958,1702,2022-11-05 07:06:00,292157ac6642b26ba4ba1b341dee8db4,0,7,0,1,3,11
9959,1702,2022-11-05 07:11:00,2f743aa6827f47e39d689d43abe1e013,0,6,0,0,0,6
9960,1702,2022-11-05 07:17:00,fae732aa720dd9f16bdb08fc4f930fca,1,9,0,1,2,13
9961,1702,2022-11-05 07:21:00,40d4d8cdc40cbb7e5e0037a28c094296,0,6,0,1,2,9
9962,1702,2022-11-05 07:27:00,d184cc0594bfc9f4d994753d9ab4122f,0,6,0,0,6,12
9963,1702,2022-11-05 07:32:00,5155ab693ecfcb95894435bd57f59ca2,0,7,0,1,5,13
9964,1702,2022-11-05 07:37:00,58384c60278de8800410b13d4f07c3a3,0,14,0,0,1,15
9965,1702,2022-11-05 07:42:00,40dd1164802793c80909c85654ebbe8e,0,9,0,0,7,16
9966,1702,2022-11-05 07:47:00,5c5050ee18c9054409cfd74221b38e90,0,12,1,3,4,20
9967,1702,2022-11-05 07:51:00,57b23afc6d3ce6698a4f6bfcc041309c,0,11,0,1,5,17
9968,1702,2022-11-05 07:56:00,c4c746c94e77a74f5380a161cdb49b3f,0,18,0,1,3,22
9969,1702,2022-11-05 08:02:00,978c5543ccecc9048fd57b0772cc23e1,0,12,0,1,5,18
9970,1702,2022-11-05 08:07:00,63d5d92a092e83004e7df6c23bfb77b0,2,17,0,3,3,25
9971,1702,2022-11-05 08:12:00,a02895ecae1c22085cc05241a990786f,0,10,0,1,8,19
9972,1702,2022-11-05 08:17:00,cc3f549b0d93324232b5277da43f473d,0,14,1,0,8,23
9973,1702,2022-11-05 08:22:00,ea72908dab5ac76252b8617f201ce3db,1,19,0,1,5,26
9974,1702,2022-11-05 08:27:00,178b411d4d03ac93767788cb8971f293,0,13,0,1,7,21
9975,1702,2022-11-05 08:32:00,099f80127428c76a0372868421f8214d,0,19,1,0,5,25
9976,1702,2022-11-05 08:37:00,171594c756858bd9ccbf3f0082bfdc22,0,14,0,1,12,27
9977,1702,2022-11-05 08:42:00,a260aba4e50c1da83a01f4e4e9951800,0,15,0,5,6,26
9978,1702,2022-11-05 08:48:00,a8d4e4a5cf4d8b188fd278b657c5445b,0,19,1,4,8,32
9979,1702,2022-11-05 08:52:00,7d8e3832e7ede00d250a1e300c3ac42b,1,17,0,1,12,31
9980,1702,2022-11-05 08:57:00,6a73ae2649b06e7101eba13f52887c1b,1,19,0,1,6,27
9981,1702,2022-11-05 09:03:00,1763f9a1b4deb3720e9315cba8c04cf2,0,12,0,4,7,23
9982,1702,2022-11-05 09:07:00,44bbfc7ae1bf244d0b3898d69d20b7a7,0,10,1,2,11,24
9983,1702,2022-11-05 09:12:00,a12d15995bc7747e6ef75c222b611142,0,13,0,1,14,28
9984,1702,2022-11-05 09:17:00,f4ee5ddfeb56166eff4b21bef494322c,3,17,0,0,16,36
9985,1702,2022-11-05 09:22:00,e1533b3377757c0b8519d0b915fa70c7,0,19,0,4,5,28
9986,1702,2022-11-05 09:27:00,459900abe74fbdfd31af18e52d8f42ed,0,17,1,0,8,26
9987,1702,2022-11-05 09:33:00,492b66bd8ff0fecebc2d501ad8dc0ead,0,14,0,1,14,29
9988,1702,2022-11-05 09:38:00,b4f0289675d9a5904dfe0e6acd2b688d,0,19,0,4,8,31
9989,1702,2022-11-05 09:41:00,fce099c1ae824ba0e15dad15ccbfe49b,0,15,0,0,7,22
9990,1702,2022-11-05 09:47:00,fb06a75b9d9c57ffde4076652ea22e2d,0,9,0,3,11,23
9991,1702,2022-11-05 09:52:00,e187fba61af90c0db5ee439fe0be38e8,1,14,0,5,10,30
9992,1702,2022-11-05 09:57:00,9e5254e842d33339984f02d833fcc0c6,0,13,0,0,13,26
9993,1702,2022-11-05 10:02:00,a22482e91d7c6bf3372f0e034a6a1b59,0,20,1,1,7,29
9994,1702,2022-11-05 10:07:00,d03aa3fb8a951e8ca61b4b559a0dab6f,0,20,1,0,6,27
9995,1702,2022-11-05 10:12:00,a8bfc3907413d7fe269749f5c563ad71,0,12,0,2,16,30
9996,1702,2022-11-05 10:17:00,9cd82c9e885091d160960ddde8155d96,0,15,0,0,10,25
9997,1702,2022-11-05 10:22:00,2f2abbec788149adced1df3238b98e6f,0,17,1,1,9,28
9998,1702,2022-11-05 10:27:00,8fd466392911466906fcf14fee9e578e,0,16,0,4,11,31
9999,1702,2022-11-05 10:33:00,c484230e5ac65d09b066a4caa2fdc646,0,16,0,1,9,26
10000,1702,2022-11-05 10:37:00,75fbdd708f9cf86cde45e9d295ac4074,0,19,0,2,9,30
10001,1702,2022-11-05 10:42:00,4108eae5b4b4c93c34add59d29625ff2,0,15,1,1,10,27
10002,1702,2022-11-05 10:47:00,f87cc28c2e39eac08f7f52700856ecd8,1,16,0,1,7,25
10003,1702,2022-11-05 10:52:00,f8e5381af27583e8a7fbf42eb2edbe46,0,16,0,1,8,25
10004,1702,2022-11-05 10:57:00,284deae14d53c7fcd6ced706b9c938c0,1,20,0,0,12,33
10005,1702,2022-11-05 11:02:00,0015972f2e7151db679dcf46057b9c15,0,16,0,5,9,30
10006,1702,2022-11-05 11:07:00,6aa2732cfe944c9679e583d998c0715e,0,13,0,2,13,28
10007,1702,2022-11-05 11:12:00,57525de55a7c03f268b7dc7817a84578,0,16,0,3,8,27
10008,1702,2022-11-05 11:17:00,e1300ce3522893349e85d0b8bf8afc80,0,21,0,1,5,27
10009,1702,2022-11-05 11:22:00,ef15dbed884a6d820e004863e394b72d,0,14,0,1,8,23
10010,1702,2022-11-05 11:27:00,0d6eb9b7684f65613b790519027b3d4a,1,13,0,2,6,22
10011,1702,2022-11-05 11:32:00,6f1cdee58279d9d5a625d32cf70aa77f,1,16,0,2,11,30
10012,1702,2022-11-05 11:38:00,95ff7af3c675084fcd9129903298f781,0,16,0,2,9,27
10013,1702,2022-11-05 11:41:00,8c5c7f762063e9b4aa7e1b97f4340ec1,0,11,0,0,11,22
10014,1702,2022-11-05 11:47:00,be1dd9906eafb0349a76853c7a732912,0,17,0,1,12,30
10015,1702,2022-11-05 11:52:00,2dc4eea376a70368c7ccfa3b3b157545,1,20,0,2,8,31
10016,1702,2022-11-05 11:56:00,212fcfd3e1160ded44f7cbac70c9d2a3,0,13,0,2,12,27
10017,1702,2022-11-05 12:02:00,e579b558cd9f773d6df1d1af7c3d834b,1,18,0,3,10,32
10018,1702,2022-11-05 12:08:00,94b176b31b5bb2482a33f17bf3f1a3f1,0,17,0,0,11,28
10019,1702,2022-11-05 12:12:00,15e8a34824cb1123e76fe0ec7ade5d73,0,14,1,1,12,28
10020,1702,2022-11-05 12:17:00,10116ff8c78b45a9059618c2c526af95,0,21,0,2,7,30
10021,1702,2022-11-05 12:22:00,efa12bec0f4e52dabdb9c7786da1647e,1,13,0,4,12,30
10022,1702,2022-11-05 12:27:00,b3fa4f57a2749460981789b1a363ea27,0,20,0,0,14,34
10023,1702,2022-11-05 12:32:00,756774506de94d50658c30c6f3f41a52,0,23,0,2,7,32
10024,1702,2022-11-05 12:37:00,e2a9c546d954e02e0442e346260e18a3,1,20,0,0,12,33
10025,1702,2022-11-05 12:42:00,58ff8eb4b19fa76dc5ed3cdb4faeeebb,0,18,0,4,10,32
10026,1702,2022-11-05 12:47:00,a0e04b1212a1764fc1ea664a9236ee2f,0,12,0,2,11,25
10027,1702,2022-11-05 12:52:00,d601cda152bee3c4aa504d8118c7ece3,0,10,0,1,17,28
10028,1702,2022-11-05 12:57:00,53a12fa756ef95ccc50b07ff91167b01,0,14,0,2,8,24
10029,1702,2022-11-05 13:03:00,b4f4527249504fbb492913a4fbb08245,0,15,1,4,9,29
10030,1702,2022-11-05 13:07:00,4ebdcfb0c1c7b01280ffcf84f1ab066d,3,11,1,1,6,22
10031,1702,2022-11-05 13:12:00,f4fe05d4e6fb1f1fecab03e2ac378a33,0,16,0,4,13,33
10032,1702,2022-11-05 13:17:00,fc7df8596d1fc0c3058fc80b40bc8bdb,0,15,0,3,11,29
10033,1702,2022-11-05 13:22:00,e5eb930ab301c3d892df3ea95c8b50e7,0,17,1,2,4,24
10034,1702,2022-11-05 13:27:00,b9833b4d2eb0dc00f9a194b0ff6b8f81,0,15,0,2,7,24
10035,1702,2022-11-05 13:32:00,3bff6a4885a70abe64db88082e174546,0,13,0,7,10,30
10036,1702,2022-11-05 13:38:00,bd4e65173858cfbad083b2784f46d9ca,1,17,0,5,11,34
10037,1702,2022-11-05 13:42:00,a4fbdc271e8458ab2d176250acf6754b,0,19,0,3,8,30
10038,1702,2022-11-05 13:48:00,e320a4ad4e5e1dcc6ac2f319aa16ed93,1,17,0,2,8,28
10039,1702,2022-11-05 13:52:00,4b016ef88d603146892d7daab998266f,0,13,0,1,14,28
10040,1702,2022-11-05 13:57:00,959ac528c58d72e5a055cf320a017dca,1,16,0,1,12,30
10041,1702,2022-11-05 14:02:00,67ab8d89b8b01ca32a3f3238270aa231,0,13,1,3,9,26
10042,1702,2022-11-05 14:08:00,98f06f294033399d91383b1d49638f12,0,13,0,4,13,30
10043,1702,2022-11-05 14:12:00,48cf57fc91d1c0706d7ee52b712d525e,0,16,0,1,14,31
10044,1702,2022-11-05 14:17:00,09daef3b2e8a0e4fbf3049115a6c2dd7,0,12,0,0,12,24
10045,1702,2022-11-05 14:22:00,be1dec33fb534a67c3a427f93a73b8bd,0,10,0,2,11,23
10046,1702,2022-11-05 14:27:00,a9a3e1331344a8e7eb6ca631e2cbe1cf,0,18,0,0,11,29
10047,1702,2022-11-05 14:33:00,112167824ec2191f8fdf3b156bf212f3,0,8,1,3,14,26
10048,1702,2022-11-05 14:37:00,255a0165324e67f83381b7522896f469,1,12,1,4,8,26
10049,1702,2022-11-05 14:42:00,bfd3e6050690b4760f38293233d95a3d,1,12,0,8,7,28
10050,1702,2022-11-05 14:47:00,3b10e474a0528396418eeac08b490263,1,16,0,6,5,28
10051,1702,2022-11-05 14:52:00,1ab34f9027e6845d23215b3791ee321c,1,14,0,2,10,27
10052,1702,2022-11-05 14:57:00,9cbf9a81377be97ef8d68da7c5c71b70,0,17,1,0,11,29
10053,1702,2022-11-05 15:03:00,d9fa767c5590b7555e09637dc479a281,0,15,0,0,11,26
10054,1702,2022-11-05 15:08:00,0f6083af877b7d4f34d7293a8995b41a,2,12,0,4,7,25
10055,1702,2022-11-05 15:12:00,51544b02cbc2a366635db8f88bba473e,0,14,0,2,8,24
10056,1702,2022-11-05 15:18:00,60f6bb317035a1e6be1a8a6ddbc9761c,1,12,1,0,11,25
10057,1702,2022-11-05 15:22:00,d48d3c00f0dea09ded07df1cae1118aa,0,13,0,1,11,25
10058,1702,2022-11-05 15:28:00,24890b884f253968d3a6e261ef7fc178,0,13,0,7,8,28
10059,1702,2022-11-05 15:32:00,f7324b65a69f11b994b7b3770f345ad8,0,16,0,4,12,32
10060,1702,2022-11-05 15:37:00,084aaf4b4968ea4e289d6f2ace1359a1,0,15,0,6,10,31
10061,1702,2022-11-05 15:42:00,d0cc695c7a1b871a7b6a16cf95f3d4e9,1,17,1,10,10,39
10062,1702,2022-11-05 15:47:00,0ccfe7054024f910d0c6d103e83cde2b,0,14,1,1,17,33
10063,1702,2022-11-05 15:52:00,8d8ea068c2ea6aa7d9074b14c33a475b,0,18,1,1,5,25
10064,1702,2022-11-05 15:57:00,a58df400863946dfe034b8dfcebc645c,0,10,0,1,16,27
10065,1702,2022-11-05 16:02:00,cf88ce488f1e778dc6f31016ef97aa2c,0,14,1,4,10,29
10066,1702,2022-11-05 16:07:00,f98dd7beb1056533dcfc5454dcfd0aaa,1,15,3,4,6,29
10067,1702,2022-11-05 16:12:00,4a7426768bcfc0cb114d8986bb0136a5,0,16,0,3,6,25
10068,1702,2022-11-05 16:17:00,443830aa8aa1167da093e519d121681b,0,11,0,2,16,29
10069,1702,2022-11-05 16:23:00,974df7a9dbe246dd10af834295115cb9,1,11,0,2,11,25
10070,1702,2022-11-05 16:27:00,e7d13a8fc3622041df728a1c548895a6,0,16,0,1,9,26
10071,1702,2022-11-05 16:32:00,843ab4f821ce31d42238736e231e0905,0,8,0,4,15,27
10072,1702,2022-11-05 16:37:00,cef698c833a6e19e85af32ec5d4256eb,0,9,0,4,14,27
10073,1702,2022-11-05 16:48:00,95aabcc1bbeb60008281c067e02c4b25,0,6,0,2,15,23
10074,1702,2022-11-05 16:52:00,5b092fa0820da8842a345e341ac56aed,0,11,0,4,12,27
10075,1702,2022-11-05 16:57:00,373dbfa8e1f928fb3c3993ccb0150b73,0,14,0,2,9,25
10076,1702,2022-11-05 17:02:00,e022d896df4ff070e2c0bc8a2066ed88,0,10,0,3,14,27
10077,1702,2022-11-05 17:08:00,d31a2a383c34eab5bdb05d3f8198cecf,1,13,0,2,14,30
10078,1702,2022-11-05 17:12:00,746c1c4129b576d86953cc50851bcc78,0,17,0,3,8,28
10079,1702,2022-11-05 17:17:00,28389d6df1fdf300d4b3a0ffb8667c26,0,13,0,3,16,32
10080,1702,2022-11-05 17:22:00,d14892c0515e89374463b017da0009ac,0,20,0,2,10,32
10081,1702,2022-11-05 17:27:00,30b4ea26b73cdd13e7f37f32312abaab,0,13,0,4,11,28
10082,1702,2022-11-05 17:32:00,9728671db45e00db4fda2108f3257777,0,12,0,2,11,25
10083,1702,2022-11-05 17:37:00,fa83e7d46056239a23386d83da532c26,1,15,0,5,10,31
10084,1702,2022-11-05 17:41:00,7c7086dbd51632bade3dc5f3c4970e52,1,20,0,3,9,33
10085,1702,2022-11-05 17:47:00,9c5affc970d056b90658b0b3aa106369,0,13,0,2,14,29
10086,1702,2022-11-05 17:52:00,eda95994b3b96fdbac5b97143462c4d6,1,19,0,3,10,33
10087,1702,2022-11-05 17:57:00,becabb534901bae42572835217a0c92e,2,12,0,2,16,32
10088,1702,2022-11-05 18:02:00,7b74068f196a9472960657e1a005dd51,0,11,0,7,16,34
10089,1702,2022-11-05 18:07:00,859e7dabce04a35aa395152036b6c4e7,0,11,0,1,13,25
10090,1702,2022-11-05 18:12:00,7221aa2033fbb3c370f08f91eb407c0f,1,18,0,4,11,34
10091,1702,2022-11-05 18:17:00,6ad37e3e35ccd087bb22075ed8b60aeb,0,17,0,2,7,26
10092,1702,2022-11-05 18:22:00,2313143fa58f967d6a4851bfc683183d,0,17,1,3,8,29
10093,1702,2022-11-05 18:27:00,ab839ef537b4b6947df853012855a300,0,18,0,0,8,26
10094,1702,2022-11-05 18:33:00,1e8cfa04d3a8d2de51a6f35acfa7cb81,0,12,0,2,12,26
10095,1702,2022-11-05 18:37:00,d2985b6437d6ff4bdb1e152bb148d3ce,0,15,0,5,14,34
10096,1702,2022-11-05 18:41:00,61ea6db590ec34cc285d391e9a6baa92,0,18,1,0,11,30
10097,1702,2022-11-05 18:47:00,56280ad6e0ccb276c9458268096f6bdc,0,16,0,2,16,34
10098,1702,2022-11-05 18:52:00,3b58dea5eadcfc2e90efc1e0dd7a515c,0,21,0,6,6,33
10099,1702,2022-11-05 18:57:00,c388c4b4b3b75a6d0f7ca31955416e74,0,25,0,4,1,30
10100,1702,2022-11-05 19:03:00,fed215d023dae443c27e3882b460d545,0,23,0,0,2,25
10101,1702,2022-11-05 19:07:00,23bd3fa2f236d1a13634b0002ced458f,0,26,1,0,1,28
10102,1702,2022-11-05 19:12:00,38ab02ca5d2a561aa63571f45b04ae8e,0,20,2,2,0,24
10103,1702,2022-11-05 19:18:00,d68142e4504d0ddc9d1e0fe2fcfceeb5,0,17,0,1,2,20
10104,1702,2022-11-05 19:22:00,3cd504bdf5cf4515fb9b3a30f07fb6ce,0,19,0,0,1,20
10105,1702,2022-11-05 19:27:00,9ae21b2062bbd819f9dd38304efb4416,0,22,0,0,1,23
10106,1702,2022-11-05 19:32:00,4b03664f19af4fdca6fc4da62b29350b,0,23,1,1,1,26
10107,1702,2022-11-05 19:37:00,9e795fab9db177565c289466c7cfe694,0,35,4,0,1,40
10108,1702,2022-11-05 19:42:00,3748fffd40fcfa8e8810c63f07966e71,0,18,0,2,0,20
10109,1702,2022-11-05 19:47:00,3326c127365c6c492833315d08d14b04,0,19,0,0,0,19
10110,1702,2022-11-05 19:52:00,bb2fe9ebb878fb4846f22da8e7c8a2f4,0,18,1,1,0,20
10111,1702,2022-11-05 19:56:00,489f2a50d8227a813444cd658030ab55,0,26,0,0,1,27
10112,1702,2022-11-05 20:02:00,2c3b476d79702943a03195d77f0d50ff,0,19,2,0,0,21
10113,1702,2022-11-05 20:08:00,c4410d618dafb2a691d4798e50fb4368,0,19,0,0,2,21
10114,1702,2022-11-05 20:12:00,5a4fd041d90be91427804426ddf40457,0,18,0,2,1,21
10115,1702,2022-11-05 20:17:00,8c6ae2ea608b0e4d47df264c2b5f16ea,0,17,2,0,1,20
10116,1702,2022-11-05 20:22:00,2748f47754412f3e06ad3713fd5e0ba9,0,23,0,0,0,23
10117,1702,2022-11-05 20:27:00,9c1e4109b70d89dbd3b275c5c22fdfa0,0,15,0,0,2,17
10118,1702,2022-11-05 20:33:00,ac690aff05781479d08a9c48e2c2e17c,0,20,2,0,3,25
10119,1702,2022-11-05 20:38:00,a0e68aa5236ffc371de584a834866a87,0,26,1,1,3,31
10120,1702,2022-11-05 20:42:00,83d2cf102860be171aee98eb4e9109f1,0,24,0,1,2,27
10121,1702,2022-11-05 20:47:00,8c155d4e585010ba156cd0f08c320f7f,0,27,1,0,0,28
10122,1702,2022-11-05 20:52:00,35a787b356b622fd6e929e11c4514c13,0,22,0,0,0,22
10123,1702,2022-11-05 20:56:00,e80b11526c61b788ba5f872a29550530,0,19,0,2,1,22
10124,1702,2022-11-05 21:02:00,9b0b5472068734c4f3ccae42d013ef16,0,20,1,0,0,21
10125,1702,2022-11-05 21:07:00,007b2c0f24b03c2eb4c983cf7ad772b8,0,16,1,0,0,17
10126,1702,2022-11-05 21:12:00,97851679922b0fe15e68f73e494873b3,0,16,0,0,1,17
10127,1702,2022-11-05 21:17:00,5424fd3a3bd85b51a34a3efa5de8aa5b,0,11,1,1,0,13
10128,1702,2022-11-05 21:22:00,1e9967687f44197fae2ce8052e53d6ee,0,15,1,0,1,17
10129,1702,2022-11-05 21:27:00,16875f18a05838d7ff509eb29fb1a328,1,21,1,0,0,23
10130,1702,2022-11-05 21:32:00,a411187c7baead4780a370acf64e60d1,0,19,0,0,1,20
10131,1702,2022-11-05 21:38:00,7e09f8426edaa275ec9af415c9f1e597,0,24,1,0,0,25
10132,1702,2022-11-05 21:42:00,1d4c11ce574567b63bd95c2774234ef3,0,23,0,0,0,23
10133,1702,2022-11-05 21:47:00,78c66022395682113cc316c43f83c02c,0,16,0,0,1,17
10134,1702,2022-11-05 21:53:00,5373c1c313dbf3327280e5d09dec7135,0,24,0,0,3,27
10135,1702,2022-11-05 21:56:00,409479a2124cf4b7ebe89a6907df76f3,0,24,0,3,1,28
10136,1702,2022-11-05 22:01:00,0382ca36ca40e0f755ff2396d99dbc6a,0,18,0,0,0,18
10137,1702,2022-11-05 22:06:00,c2db6f08caac63974b4a5d38c4a5da70,0,23,0,2,1,26
10138,1702,2022-11-05 22:12:00,75ed9e06d58d027e8f822bd0eba93b2c,0,19,0,1,0,20
10139,1702,2022-11-05 22:17:00,4ac9e131586228edb7a430ca1caa8ffc,0,16,0,1,1,18
10140,1702,2022-11-05 22:23:00,c2906c23bf099402b5af9f6111209b6d,0,13,1,1,1,16
10141,1702,2022-11-05 22:27:00,aff06e8586ba4c3e9d477f0ae91aba9f,0,20,0,0,0,20
10142,1702,2022-11-05 22:32:00,6b3e6128d0cbcf504e9c466f36683753,0,17,0,0,2,19
10143,1702,2022-11-05 22:37:00,a98f4d409bc87f373daeeb1a28253730,0,16,1,1,0,18
10144,1702,2022-11-05 22:43:00,7a1aa2bed94432ce446ae0cab569386f,0,21,0,0,0,21
10145,1702,2022-11-05 22:47:00,fe51753cb9bef4aeaf093f4847fe93ba,0,14,3,0,0,17
10146,1702,2022-11-05 22:52:00,1c5be27479c40516b7750361c92d735e,0,22,0,0,1,23
10147,1702,2022-11-05 22:56:00,3f70a5772fd034e05b5d1a6f4476f272,0,21,2,1,0,24
10148,1702,2022-11-05 23:02:00,8d8b303dc4a1979c565f47b18c374671,0,16,2,0,0,18
10149,1702,2022-11-05 23:08:00,c33f6a31acdd3c0494d2573550a9b732,0,25,0,1,2,28
10150,1702,2022-11-05 23:12:00,2559306821a41beb1daecb7390f3f51a,0,18,0,0,0,18
10151,1702,2022-11-05 23:17:00,fdd7cebef16ea89acbab331bbedc6b14,0,19,0,0,1,20
10152,1702,2022-11-05 23:23:00,e14d3732d9b275e647a36553ca59c5cc,0,16,0,0,0,16
10153,1702,2022-11-05 23:27:00,00f7fd63bf8fe0897b3079c71357f137,0,28,0,2,0,30
10154,1702,2022-11-05 23:32:00,fb54c03920e3a2c6a74b1f2b7c65a888,0,21,0,0,0,21
10155,1702,2022-11-05 23:37:00,f9bc977e3efeb00084f77056723fa0c5,0,27,0,0,0,27
10156,1702,2022-11-05 23:42:00,9804d7d42c3a553338fe937c62c03004,0,24,0,0,0,24
10157,1702,2022-11-05 23:47:00,dbd56243c6d2f65f666b39c588655a93,0,20,2,0,0,22
10158,1702,2022-11-05 23:52:00,4743ff8c0c7039f881888273113f99f5,0,15,0,0,2,17
10159,1702,2022-11-05 23:56:00,bd4cdb1c4539edd0d5f76232c72de4f9,0,19,0,1,1,21
10160,1702,2022-11-06 00:02:00,039bd2d12f358d252fa988b4b7541dd7,0,14,1,0,1,16
10161,1702,2022-11-06 00:07:00,7c76324cbe3e9c3738abf5a80dffaed9,0,6,0,0,0,6
10162,1702,2022-11-06 00:12:00,daf47089641a64b61158db47ffc3deab,0,17,0,0,1,18
10163,1702,2022-11-06 01:31:00,be5a9e01de86df72fb30aebb0f635634,0,10,0,0,2,12
10164,1702,2022-11-06 01:36:00,06bcfeb88f942330d966140dc54f8e8d,0,8,1,0,0,9
10165,1702,2022-11-06 01:41:00,f35e661ccf069299471ca554d8e98d4d,0,8,0,0,1,9
10166,1702,2022-11-06 01:46:00,c8ca21bd3cbe5960a105134f7a2598fd,0,6,0,0,3,9
10167,1702,2022-11-06 01:51:00,eefa97720007e82378a18d94ff073f2a,0,10,0,0,0,10
10168,1702,2022-11-06 01:56:00,03446df2381e772a6efb0f338ec8289e,0,7,0,0,2,9
10169,1702,2022-11-06 02:02:00,c8a2bc4af91aa5a2670944ee6abfedb8,0,5,0,0,0,5
10170,1702,2022-11-06 02:06:00,f0642968ea3acced84894483ecae48c1,0,4,0,0,0,4
10171,1702,2022-11-06 02:12:00,96b7ca0597a45decab7873d7b6a914e7,0,10,0,0,0,10
10172,1702,2022-11-06 02:16:00,3b597e67783fedbc049702061776cd58,0,4,0,0,0,4
10173,1702,2022-11-06 02:21:00,11d9c99d5e125f87f0e29fdce493f58a,0,7,0,0,0,7
10174,1702,2022-11-06 02:26:00,9a8d9a841d9fdc3f302373992dee8538,0,8,0,0,0,8
10175,1702,2022-11-06 02:31:00,e3c3099ee9a4c9be02fdb3cf7b523448,0,10,0,0,0,10
10176,1702,2022-11-06 02:36:00,e8ff0b2b9105851edb52d5b7a01b2783,0,8,0,0,0,8
10177,1702,2022-11-06 02:41:00,1dabe57ad099cae5bae7bfafb038cf04,0,3,0,0,0,3
10178,1702,2022-11-06 02:46:00,a56ea2c9c78561c86e0cb33290209f8b,0,3,0,0,0,3
10179,1702,2022-11-06 02:51:00,aed44adc31f74c770252cd3914031c4c,0,5,2,0,1,8
10180,1702,2022-11-06 02:56:00,df5d3a0781c3d949efc7c63ea300b6f7,0,5,0,0,1,6
10181,1702,2022-11-06 03:01:00,ca0d02201818394de971549bf38a4c7d,0,7,0,0,0,7
10182,1702,2022-11-06 03:06:00,4ef07a156f3112788d6891fae8b2c3c8,0,2,0,0,0,2
10183,1702,2022-11-06 03:11:00,250a986036fed5bf2e4aaa68ed18e9dc,0,7,0,0,1,8
10184,1702,2022-11-06 03:16:00,12b2dcb5e7c1a45a6a7544ed44108fbd,0,9,0,0,0,9
10185,1702,2022-11-06 03:21:00,d0012f2a790167e9d45e22f92005c718,0,7,0,0,1,8
10186,1702,2022-11-06 03:27:00,be3e713b0a621cf70a65989088af987e,0,11,0,0,1,12
10187,1702,2022-11-06 03:31:00,4b9877cc5dbf5e0f27370a35c0c39720,0,7,1,0,1,9
10188,1702,2022-11-06 03:37:00,856938469f079ea568eaf0c762fd5ae8,0,6,0,1,0,7
10189,1702,2022-11-06 03:41:00,5725d13268a69c18b92cb8b55c940a5c,0,11,0,0,2,13
10190,1702,2022-11-06 03:46:00,fdb977897edcc96cc241256da5490993,0,11,0,1,2,14
10191,1702,2022-11-06 03:53:00,03caa74ebcbb4e16c75e396c72cfb4d4,0,4,0,0,1,5
10192,1702,2022-11-06 03:57:00,3502c4291602aa3a1b8c9844602d5d39,0,4,0,0,0,4
10193,1702,2022-11-06 04:02:00,2ea19d9bf47b4b075dc99762c50bee08,0,3,0,0,0,3
10194,1702,2022-11-06 04:08:00,8bc593b53aa63ada4a83a5239624d91a,0,2,0,0,2,4
10195,1702,2022-11-06 04:11:00,88e627c65dca6bc66b5c1bcdae172581,0,4,0,3,1,8
10196,1702,2022-11-06 04:17:00,c0d57bcabf1cc8ad8619aab203f3545b,0,8,0,0,0,8
10197,1702,2022-11-06 04:22:00,f489bd86b3f1296687dd6fc4c338be40,0,9,0,1,1,11
10198,1702,2022-11-06 04:26:00,bcb77e031e69706e26233899b2e2c8c2,0,4,0,0,1,5
10199,1702,2022-11-06 04:31:00,585fe723c2c3d5ca0984458919f6dcce,0,7,3,0,0,10
10200,1702,2022-11-06 04:37:00,3e3302db508a5072293120d7b42d9d60,0,4,0,0,0,4
10201,1702,2022-11-06 04:42:00,be5d829e03fc6d056ead7f60cde4265d,0,4,0,0,0,4
10202,1702,2022-11-06 04:47:00,e0473f07806d922e7623213c65f87bf6,0,4,0,1,0,5
10203,1702,2022-11-06 04:52:00,49b9962e4bb856b9d510a12f1a9a06ee,0,2,0,0,0,2
10204,1702,2022-11-06 04:56:00,ac7811b46cb372134bd4c1aef367abe1,0,4,0,0,3,7
10205,1702,2022-11-06 05:02:00,a1504fa988916d4844f517594d566bbc,0,5,0,0,0,5
10206,1702,2022-11-06 05:08:00,50aecc3b930d094845132249cc9ec17e,0,1,0,0,0,1
10207,1702,2022-11-06 05:11:00,b77591a231acf8acbf5fc7acbbee973a,0,10,0,0,0,10
10208,1702,2022-11-06 05:17:00,89b9673a1e8a8b0719b8d9f5360f4dc7,0,6,0,0,0,6
10209,1702,2022-11-06 05:22:00,dc3a54d978cf6738afc225bc2dfa55fe,0,2,0,0,0,2
10210,1702,2022-11-06 05:26:00,044fcf8b4910093bf55aa304b05ca960,0,1,0,0,0,1
10211,1702,2022-11-06 05:33:00,d1b145556e8a06d33b9f5eebb0a5bcab,0,8,0,0,1,9
10212,1702,2022-11-06 05:37:00,ae72d18241ab9f61a8288f73a808eb5b,0,1,0,1,0,2
10213,1702,2022-11-06 05:42:00,ae1be3df5baac9ea07106aac71329a63,0,7,3,1,0,11
10214,1702,2022-11-06 05:47:00,56469bd2117644fa6dab452b33df632b,0,5,1,0,0,6
10215,1702,2022-11-06 05:52:00,5f8cc78f851e5e93dfc917eb8a7e70e7,0,0,0,0,0,0
10216,1702,2022-11-06 05:56:00,dcbb42796d5540631a3cb0896bbda20d,0,3,0,2,0,5
10217,1702,2022-11-06 06:02:00,55c2d1f8b844f4abc1883603bfc6f0cd,0,4,0,0,0,4
10218,1702,2022-11-06 06:07:00,9c756e425cc8bb75b0d4a7c860342508,0,0,0,0,0,0
10219,1702,2022-11-06 06:12:00,f706177015266d9b9c2c938c12b8ebd2,0,9,0,0,0,9
10220,1702,2022-11-06 06:17:00,fda4b82bce728cff020030f0c0108c04,0,4,0,0,1,5
10221,1702,2022-11-06 06:22:00,78f8f9122afebabd4b50d0292a4a8161,0,7,0,0,1,8
10222,1702,2022-11-06 06:27:00,f3cf993dc31baf90b8c4f64c22d5dd6e,0,6,0,0,2,8
10223,1702,2022-11-06 06:33:00,ccb56920afad6b78b7e529c1d4ff2482,0,13,0,2,2,17
10224,1702,2022-11-06 06:37:00,354b25cbf9d3b3cb93a3e0769c4fec20,0,14,0,0,1,15
10225,1702,2022-11-06 06:42:00,9124908678ecaabb137512ffbc79442a,0,6,0,0,3,9
10226,1702,2022-11-06 06:47:00,fde419a537743e684e196db4571348db,0,11,0,1,3,15
10227,1702,2022-11-06 06:53:00,8682e14d6790aa74abc2e2a51633d665,0,11,1,0,2,14
10228,1702,2022-11-06 06:57:00,a2dd6a16ee85a24329deb0d2beead891,0,4,0,0,5,9
10229,1702,2022-11-06 07:03:00,c1264f39f26faa24be8d5cd26c8b204d,0,7,0,0,3,10
10230,1702,2022-11-06 07:07:00,933f3ac2eb2610ed8b61fa1fefbf8968,0,5,0,0,6,11
10231,1702,2022-11-06 07:12:00,ccc80c641a44ef70dc8a932bf8bc0d7a,1,6,0,2,3,12
10232,1702,2022-11-06 07:17:00,133503ae09db0f231a47028c08a1abce,0,8,0,0,2,10
10233,1702,2022-11-06 07:23:00,b7d6ef58a664668c35a4cbda581dd27c,2,5,0,1,2,10
10234,1702,2022-11-06 07:28:00,44004a42f8acdee64e0d6e8a4d8f6a91,0,7,0,0,0,7
10235,1702,2022-11-06 07:32:00,bf5f3c7d6c31559831c4a715060304cd,0,12,1,0,2,15
10236,1702,2022-11-06 07:37:00,939b0cfce0f131073ae853413c2784e4,0,10,0,0,0,10
10237,1702,2022-11-06 07:41:00,bf6156d0186404d580d3c489520e4145,0,11,0,0,7,18
10238,1702,2022-11-06 07:47:00,a7b0c1f2211b3781822c7b01d05c4456,1,7,0,1,8,17
10239,1702,2022-11-06 07:53:00,72999d04d5315ca8b606bf25fceb102b,1,11,0,2,3,17
10240,1702,2022-11-06 07:57:00,2442dfdb50a8d6ab36385e7760e73247,0,14,0,0,4,18
10241,1702,2022-11-06 08:03:00,d73a9ed3d6109a8bd420b0fdfc9dec6f,0,14,0,0,1,15
10242,1702,2022-11-06 08:07:00,0234eff57c0ddd32cdf68f65fa60110c,1,13,1,1,5,21
10243,1702,2022-11-06 08:12:00,a7b7a90b36fb2e5b15363ac7583efc8d,0,14,0,0,5,19
10244,1702,2022-11-06 08:18:00,31ec694c35ae96454b396a0fdfd496cf,0,10,0,0,7,17
10245,1702,2022-11-06 08:23:00,b3732bf06ebf772c98133e138f2024a1,0,9,0,2,3,14
10246,1702,2022-11-06 08:27:00,fac6e87d02c0e52a78603889f1bcc2b9,0,4,0,0,7,11
10247,1702,2022-11-06 08:32:00,4b7459ac524d0de6b83480bfd3217595,0,9,0,0,9,18
10248,1702,2022-11-06 08:38:00,77b34474a2e81a873224c63269f5700e,0,5,0,4,3,12
10249,1702,2022-11-06 08:42:00,52a81b9c468f538b73341d71e40881d6,0,14,0,0,4,18
10250,1702,2022-11-06 08:48:00,f11a7dd6761227b53c504bf10163a549,0,17,0,2,5,24
10251,1702,2022-11-06 08:53:00,c3d6216e62082db6368a6e6db24d6a32,0,7,0,3,4,14
10252,1702,2022-11-06 08:57:00,ca77b2cceea7a8b1f95d0fb8a8feb963,0,9,0,0,9,18
10253,1702,2022-11-06 09:04:00,8f93e873a6517c21dd8f7b9d50f315d6,0,10,0,0,3,13
10254,1702,2022-11-06 09:08:00,af45dbfa526845a5f0b86970e2d512a8,0,14,0,1,3,18
10255,1702,2022-11-06 09:12:00,289dc70701ae47779121e8d8f35e7d99,0,9,0,3,8,20
10256,1702,2022-11-06 09:17:00,56677dfaa9abe13a2ced8cd3c28c85ca,0,16,0,0,9,25
10257,1702,2022-11-06 09:22:00,7ca4e3a4f8b6575cc0bb04935bdc48d0,0,14,0,3,3,20
10258,1702,2022-11-06 09:27:00,2ca83e62a69a4bd0c6bf41df9e66ab0f,0,19,1,0,6,26
10259,1702,2022-11-06 09:33:00,26c0976b3369d09408fbe837ea183321,0,10,0,1,8,19
10260,1702,2022-11-06 09:38:00,a68b39450dd4ee4b8ff0a3c4c3c5aa0a,0,11,0,1,7,19
10261,1702,2022-11-06 09:42:00,448a7bdc820a34fb98f57618475312d3,0,16,0,0,3,19
10262,1702,2022-11-06 09:48:00,284912b128239428324d8c7fecd86f5e,0,15,0,1,2,18
10263,1702,2022-11-06 09:52:00,312df5cd66e3becb80e7c48578981c6b,0,20,1,1,6,28
10264,1702,2022-11-06 09:57:00,aa84ca0338ca2b32c1d917e7bf39e5a2,0,14,0,1,4,19
10265,1702,2022-11-06 10:02:00,bcdc1d734fe312ca6119c0333e6a73f5,0,14,1,0,4,19
10266,1702,2022-11-06 10:08:00,75553af90b145c4126c4980086eac990,0,12,0,1,6,19
10267,1702,2022-11-06 10:12:00,ffb03e87f315f5fb7f054d60cfb3b9b5,0,17,0,1,5,23
10268,1702,2022-11-06 10:17:00,614945a8f73aa81ca62f0ae8cb40d48f,0,17,0,1,2,20
10269,1702,2022-11-06 10:22:00,09ac5bc3cba637643ba8e1114614b816,0,16,0,1,6,23
10270,1702,2022-11-06 10:27:00,00e1a3b0b8ef37f3a2b02cd1f7acbfbd,2,19,0,1,7,29
10271,1702,2022-11-06 10:32:00,a3c705e1e337e71f44b540e7ff4e1e54,0,10,0,1,6,17
10272,1702,2022-11-06 10:38:00,93dbfeed3a91d8405adcb2035cf77bc4,1,11,0,0,9,21
10273,1702,2022-11-06 10:42:00,9c358c9fa8eb8d79448d447dd15ea198,0,20,0,0,2,22
10274,1702,2022-11-06 10:47:00,3be84eb37e79cbf157564e1ecad06178,1,15,0,1,4,21
10275,1702,2022-11-06 10:52:00,5f56fefb25acf675df0c0eb35395e282,0,16,1,0,9,26
10276,1702,2022-11-06 10:57:00,d19933f911660185f33240020ce6fdc4,0,17,0,1,5,23
10277,1702,2022-11-06 11:02:00,78b87c23f7ae2c2976bfa45e92058b67,0,11,0,4,7,22
10278,1702,2022-11-06 11:07:00,42ad3242678f56fc5115c479425914c7,0,15,0,2,5,22
10279,1702,2022-11-06 11:12:00,a900aa79c5d05800fd256191e2a0650a,1,18,0,0,8,27
10280,1702,2022-11-06 11:17:00,78e34621558ff0d473d0b63334f78848,1,19,1,2,5,28
10281,1702,2022-11-06 11:24:00,0bd5aedfc58ab9cf723e7414866b5d18,0,11,0,0,9,20
10282,1702,2022-11-06 11:27:00,ed087a3d9123f0dc6c06c27a8dcd9f6e,0,24,1,0,5,30
10283,1702,2022-11-06 11:33:00,53aa179563f4412367b6fde8ebaf1f05,0,21,0,2,1,24
10284,1702,2022-11-06 11:38:00,b038cc7b939c86cd38ba87d3813a3cc6,2,15,1,2,7,27
10285,1702,2022-11-06 11:42:00,dc8d9feb69f06ebaeb732af982b0cc59,0,17,0,2,6,25
10286,1702,2022-11-06 11:47:00,ce449d410e623d91a32e845b4f244816,2,22,0,3,3,30
10287,1702,2022-11-06 11:52:00,2be1340013a9363543b4dda02025c72e,1,17,0,2,7,27
10288,1702,2022-11-06 11:58:00,2d7a66eb70696bddfe7e2daeaefea065,0,24,0,3,3,30
10289,1702,2022-11-06 12:03:00,aedd5e2d0d3c438493b337cd9f116c62,0,20,0,2,2,24
10290,1702,2022-11-06 12:09:00,3fc8f05910ee5e398657698adcb9790b,0,25,0,0,2,27
10291,1702,2022-11-06 12:13:00,667dd84c9c76a2e3edf9abf4e35cc4ba,0,13,0,0,8,21
10292,1702,2022-11-06 12:18:00,3ac261efb5bb719e13509e80597eceaa,0,11,0,1,13,25
10293,1702,2022-11-06 12:23:00,14c6ab55e24c26e0dd0779647ff38deb,1,15,0,2,10,28
10294,1702,2022-11-06 12:28:00,720d94f3f93b7a8157d5f0e2925299f0,0,18,0,1,4,23
10295,1702,2022-11-06 12:32:00,281654e498eb9b20b3476c19625ef37d,0,17,0,2,3,22
10296,1702,2022-11-06 12:38:00,7cbf056da4b67e5a7988c1fcf17d979f,0,16,0,3,1,20
10297,1702,2022-11-06 12:42:00,a3bdfd7b5fbf0e59514f087ad115f53b,0,16,0,1,3,20
10298,1702,2022-11-06 12:47:00,83c9191613fab1861c9f48634b539982,0,22,0,4,1,27
10299,1702,2022-11-06 12:52:00,8ba46503609c3ba474a6def01ecaa5a3,0,17,0,1,2,20
10300,1702,2022-11-06 12:57:00,7854543e7dc551b027091b39fc168b43,0,13,0,1,4,18
10301,1702,2022-11-06 13:02:00,55e38ae77ba8a0534e84392d5bdf87ee,0,19,0,4,2,25
10302,1702,2022-11-06 13:07:00,107c43adc678f46ea09939bee4a84f85,0,20,1,2,2,25
10303,1702,2022-11-06 13:12:00,4fe1e3cf723f37dbc895fe13cd86943c,0,15,0,1,4,20
10304,1702,2022-11-06 13:18:00,6a4313fc25de9b7b19bb638767dc9ef0,0,20,0,1,9,30
10305,1702,2022-11-06 13:22:00,115483faafe9b7c370a981a9a28cb51a,0,21,0,0,4,25
10306,1702,2022-11-06 13:27:00,20fe1c5c28f8f10b37c24c7d8a09159d,0,11,0,2,6,19
10307,1702,2022-11-06 13:34:00,1e2628e83f8870937a7ec07dd6f39d8e,0,17,0,3,3,23
10308,1702,2022-11-06 13:36:00,d6ccd0aedbfc1d086c563a174ce4a581,0,14,0,2,3,19
10309,1702,2022-11-06 13:42:00,e4d81c88ede5a89c861f5389a63edd10,0,17,0,2,5,24
10310,1702,2022-11-06 13:47:00,898fd1694d6895b6985e4b47a996c1dd,0,15,0,1,5,21
10311,1702,2022-11-06 13:53:00,74c89605dfabce7384b9294c4da97ef3,0,16,0,2,8,26
10312,1702,2022-11-06 13:57:00,74d477c3260be1aed3702833e1f011c0,0,11,0,6,11,28
10313,1702,2022-11-06 14:03:00,bd03a2e3c2a1e0dcfe6d9b7ad6966392,1,14,3,1,10,29
10314,1702,2022-11-06 14:07:00,779f31657e20fc3f86356a4a4fb91809,0,16,1,6,7,30
10315,1702,2022-11-06 14:12:00,1ebcc820f3cacf9171d4e961fdcb8dc7,0,13,0,2,5,20
10316,1702,2022-11-06 14:18:00,ce713275b121847719e4206d3c5f3600,0,22,0,3,6,31
10317,1702,2022-11-06 14:23:00,65d9d111842bed313f63d00232befb84,1,12,0,1,14,28
10318,1702,2022-11-06 14:27:00,b27a89bef099d6a0cf5698cfa481197e,0,10,0,1,7,18
10319,1702,2022-11-06 14:32:00,e9eb90c63040ecdeb24490efd87c44c2,0,14,0,2,10,26
10320,1702,2022-11-06 14:38:00,87a00f24528b9e39f221914843411bdc,0,22,0,0,12,34
10321,1702,2022-11-06 14:42:00,7dbc307d643885b1e89803e7ae167bbc,0,28,2,1,6,37
10322,1702,2022-11-06 14:47:00,19c7feb6026883c5447851e05fff413c,0,16,0,4,6,26
10323,1702,2022-11-06 14:52:00,9eb53fa3896ed9657fdf58d29b272866,0,15,0,3,9,27
10324,1702,2022-11-06 14:58:00,d03e93620db945f65ab001228640a7e9,1,17,0,0,9,27
10325,1702,2022-11-06 15:03:00,59268ddd22bfb1337dd815795cd1d101,0,11,0,0,13,24
10326,1702,2022-11-06 15:07:00,02bada86677de2ed52ecfc31d8f5a648,0,18,1,0,9,28
10327,1702,2022-11-06 15:12:00,b8a020aeedaf435e864580c8d3dde3e8,0,20,0,0,9,29
10328,1702,2022-11-06 15:18:00,89ec7d961e66b4d58c3c24c5781f9d3d,0,12,0,0,10,22
10329,1702,2022-11-06 15:24:00,91f8b0aed68b80badc8538a6480de729,0,16,0,0,11,27
10330,1702,2022-11-06 15:28:00,33f57c4cefb4a6839dc3c5284753a009,0,13,1,1,11,26
10331,1702,2022-11-06 15:33:00,3f1a20a5cfbb2d1df04fe48fb7064768,0,14,1,0,9,24
10332,1702,2022-11-06 15:38:00,f17472a344050c433a0078b27e930903,0,15,0,1,14,30
10333,1702,2022-11-06 15:42:00,dc0cff4dbc276fee4c29365ae7542663,1,8,0,2,11,22
10334,1702,2022-11-06 15:47:00,8b261c6dc0fb3e8f2de26a5036024acb,0,14,0,3,7,24
10335,1702,2022-11-06 15:52:00,7a9ef4c8f00e8ffa5c762115c781d609,0,18,0,2,6,26
10336,1702,2022-11-06 15:57:00,3fbd769882bbc7596a0ed610309f1ac9,0,11,0,1,13,25
10337,1702,2022-11-06 16:03:00,201d6bf067f5e6c6e65ac5df083ab5da,0,10,0,1,12,23
10338,1702,2022-11-06 16:08:00,d6aa4115e3f3f4daa38eab3fb91ae4cf,0,16,0,1,14,31
10339,1702,2022-11-06 16:11:00,37f39268a8dca86d43f8c0412ecb9b51,0,24,0,1,6,31
10340,1702,2022-11-06 16:18:00,5191fed9c6475346a851853d60d915ac,0,16,0,3,5,24
10341,1702,2022-11-06 16:23:00,a0626a1608037c37ac0c9f8a72101b9a,0,15,0,0,12,27
10342,1702,2022-11-06 16:28:00,f41a003c0af135a5bdf99585ceb2dbb6,0,18,1,2,11,32
10343,1702,2022-11-06 16:33:00,d6f5770a24c58f1045b1c5559e3b54e1,0,15,0,0,7,22
10344,1702,2022-11-06 16:37:00,21ca83ebdd1c9995dd65c37a1888c1c0,0,18,0,3,5,26
10345,1702,2022-11-06 16:42:00,6ffd52c8604d302637f27fa5b4857858,0,11,0,0,11,22
10346,1702,2022-11-06 16:48:00,1cf2c520bf312dd2b7c948d1e54f1567,0,17,0,3,5,25
10347,1702,2022-11-06 16:53:00,253d3bed3eb84d20aa722dba76d9bf81,0,19,0,2,7,28
10348,1702,2022-11-06 16:57:00,c6f24b642a6c0a891ded19208940770f,1,15,0,1,8,25
10349,1702,2022-11-06 17:02:00,b13896ff519ff21129b8043a3177bcc4,1,13,1,4,8,27
10350,1702,2022-11-06 17:08:00,fbf542e06bf31f7d28a2ff2aa44c3460,0,15,0,1,13,29
10351,1702,2022-11-06 17:13:00,a1d62a3f21b2132ff9ac60b3b926ff33,0,22,1,1,1,25
10352,1702,2022-11-06 17:17:00,986953eb4011b18e3a155b0a0b4772f0,0,19,0,0,9,28
10353,1702,2022-11-06 17:23:00,4fc0eb92937da4fef8e8b66bb939529b,0,17,2,2,8,29
10354,1702,2022-11-06 17:27:00,91c15f7a7d119740001ecead3cfa5cfd,0,13,0,0,11,24
10355,1702,2022-11-06 17:32:00,29954c31d4b3560a91b61ba72d7a5e52,0,14,1,5,8,28
10356,1702,2022-11-06 17:37:00,ccf8dc4591a3f5832e401ef9890b5950,0,11,1,4,6,22
10357,1702,2022-11-06 17:42:00,e9cfaf51fb19adf1b93d685dd431861a,0,12,0,2,10,24
10358,1702,2022-11-06 17:48:00,a42b54d895e72f9ee70404fd1260fcc3,0,18,0,0,6,24
10359,1702,2022-11-06 17:53:00,ed7ac7ee637045d1764c2dd923b2357f,0,14,0,3,8,25
10360,1702,2022-11-06 17:57:00,7cf62c8de269882dab121500a04c6edf,0,20,0,1,4,25
10361,1702,2022-11-06 18:02:00,fe931f57090969efe507b6f33fcd17cc,0,20,0,1,2,23
10362,1702,2022-11-06 18:07:00,468fafb0c0c69a98f9079bc00f9b789b,0,19,0,1,10,30
10363,1702,2022-11-06 18:11:00,1fb5fea55ee1f30f2d093b1ea22c46ee,0,14,0,1,11,26
10364,1702,2022-11-06 18:17:00,91846314851718306bc7a5225bcc1c17,0,19,1,0,6,26
10365,1702,2022-11-06 18:23:00,16e27cd3b81bbe52e153a482a68f6460,3,17,0,8,6,34
10366,1702,2022-11-06 18:27:00,95b736c8a68ae02d0fff6b4f6b0a2ab0,0,12,0,1,8,21
10367,1702,2022-11-06 18:32:00,14b5d9e35f0264557abf22c4994703b4,0,19,0,1,7,27
10368,1702,2022-11-06 18:39:00,06c0fc2ecd276e657ce583a8db76cec8,0,15,0,0,5,20
10369,1702,2022-11-06 18:41:00,88e420c22f86adf912414b20e91122d7,0,13,0,4,9,26
10370,1702,2022-11-06 18:47:00,69bd7d6cb02a85350f8f0267b3c6f1f5,1,18,1,1,4,25
10371,1702,2022-11-06 18:52:00,081330727076ff708e7e7c7a173a0917,0,19,0,0,3,22
10372,1702,2022-11-06 18:57:00,0eb099eec925dc8cc5aed59d35837d5c,0,18,0,2,3,23
10373,1702,2022-11-06 19:03:00,cc6cba29fb45ddc6921018754b3c8f88,0,20,2,2,2,26
10374,1702,2022-11-06 19:07:00,52d9e87822ee5b9db28d2412c7476638,0,22,0,0,0,22
10375,1702,2022-11-06 19:11:00,4b3eeca9733cccd6c7516180fdfd2f49,0,19,0,0,1,20
10376,1702,2022-11-06 19:17:00,d1057d6a088328df6f28ece361811c73,0,17,1,0,0,18
10377,1702,2022-11-06 19:22:00,6aa7ae8e9e8e61159a31a6495cbb52c7,0,15,0,0,2,17
10378,1702,2022-11-06 19:27:00,05935066ce17352f480f7ce4586866f1,0,16,0,0,0,16
10379,1702,2022-11-06 19:32:00,b50e70baa5e9878eaf626b87cfd9ccf1,0,13,0,0,1,14
10380,1702,2022-11-06 19:37:00,f651b28a13e360e77a8aedf0d0ca7ed6,0,15,1,0,1,17
10381,1702,2022-11-06 19:41:00,b502442f8972dfd421dcd14d49fcd018,0,15,0,0,3,18
10382,1702,2022-11-06 19:47:00,74f1cfc2a6f6af1e87be8adb8d90b4c8,0,12,0,1,0,13
10383,1702,2022-11-06 19:52:00,fa808af56171ce49ab2d620d7a0dbfaa,0,17,0,0,1,18
10384,1702,2022-11-06 19:56:00,b0bc5e86372f415829d7503952b1d504,0,7,1,1,1,10
10385,1702,2022-11-06 20:01:00,592775f5da5115954020610509b67626,0,16,0,0,3,19
10386,1702,2022-11-06 20:06:00,967e8fad4f5e8fb29fe118d3efcb4962,0,14,1,0,0,15
10387,1702,2022-11-06 20:12:00,21bd85504b043d5979cf9ab9cfd329ea,0,10,1,0,0,11
10388,1702,2022-11-06 20:17:00,5e870c88758b73d2be008a7b65f555b0,1,10,1,0,0,12
10389,1702,2022-11-06 20:22:00,823c05a599b6e4467f75b7273439805a,0,20,0,1,1,22
10390,1702,2022-11-06 20:26:00,72e9d126ed9d6e94b81ac788560b95c1,0,17,0,0,1,18
10391,1702,2022-11-06 20:32:00,d7337ecdd58f4a63bcf9d80b2b195c3a,0,17,0,0,0,17
10392,1702,2022-11-06 20:37:00,7b7c237d7d8a384c4a715b765f0e7d14,0,12,0,0,1,13
10393,1702,2022-11-06 20:41:00,70913c517f8f7cb3979c7966f9ca1618,0,12,0,1,0,13
10394,1702,2022-11-06 20:47:00,d5cf053e8e9e73033832b9db3fb12be6,0,15,0,0,0,15
10395,1702,2022-11-06 20:52:00,58972fcfffbec7b006e1a275109e8c25,0,11,1,1,2,15
10396,1702,2022-11-06 20:56:00,3ff1784c711a9f7b25003a7da6097bb1,0,14,0,0,0,14
10397,1702,2022-11-06 21:02:00,e56bb5290c922ef4d91cfe0988ea08f2,0,14,0,0,0,14
10398,1702,2022-11-06 21:07:00,7414002caf00b801a6824614a4ef5c93,0,16,0,1,0,17
10399,1702,2022-11-06 21:12:00,09c1c99117942d082909baa26d46ebae,0,21,0,1,0,22
10400,1702,2022-11-06 21:18:00,6161db6db4ca06f0cde116e4679ddccf,0,16,0,0,0,16
10401,1702,2022-11-06 21:22:00,6ec646e0183d0094da664689cb590251,0,15,0,1,0,16
10402,1702,2022-11-06 21:26:00,a4fbc7fae85f560719e290bb23388cf3,0,22,2,0,0,24
10403,1702,2022-11-06 21:33:00,5e4c9949bc3711e12e50d72cffe5e6e5,0,7,0,0,1,8
10404,1702,2022-11-06 21:37:00,db16386c11cf166bc5112b4ed9b21fbe,0,13,0,0,1,14
10405,1702,2022-11-06 21:42:00,7fb2ac12a6d22e181c4542f74cc3ada6,0,12,0,1,0,13
10406,1702,2022-11-06 21:47:00,80db37fd97eee81b5c8bb9fdaefeb0bd,0,21,1,0,0,22
10407,1702,2022-11-06 21:52:00,f802d28f6fea9b6233c29b974250c969,0,15,0,1,1,17
10408,1702,2022-11-06 21:56:00,f6186313f09822aee055039883e72842,0,13,0,0,0,13
10409,1702,2022-11-06 22:03:00,ecd2a5b31c868092a44711e6eee3aec1,0,14,0,0,0,14
10410,1702,2022-11-06 22:07:00,ebf8b0b76b946d9d2d3887a1a01202c2,0,6,0,0,0,6
10411,1702,2022-11-06 22:11:00,a762384a5c4cf72d170a2357ca685795,0,5,0,0,1,6
10412,1702,2022-11-06 22:17:00,f9b43e9c35b4fde22e217663a2c87fed,0,7,0,0,1,8
10413,1702,2022-11-06 22:21:00,8f904323c987e5bd5b6214b4969ad5ce,0,14,0,1,2,17
10414,1702,2022-11-06 22:27:00,39684da4346b7724cf6601b5837f07f5,0,17,0,0,0,17
10415,1702,2022-11-06 22:32:00,9b7e87389af4294ccce44c71e9443cad,0,7,0,0,0,7
10416,1702,2022-11-06 22:37:00,4fe102201a91e0486a56b082f51cbd88,0,11,0,1,0,12
10417,1702,2022-11-06 22:42:00,e272aadf10f85cf1101c29b8b0d7f821,0,16,0,1,1,18
10418,1702,2022-11-06 22:48:00,714fc212fe9f161f49265b974d336481,0,12,1,0,2,15
10419,1702,2022-11-06 22:51:00,fe5eb56f999ed64bc11d2b0279a18d6e,0,8,0,0,1,9
10420,1702,2022-11-06 22:57:00,31e6b8a181aa074ff3cdc5c0e2748d4c,0,7,0,0,0,7
10421,1702,2022-11-06 23:02:00,813043181692b68a3a1025904d96a0c0,0,10,1,0,0,11
10422,1702,2022-11-06 23:07:00,5ebd38eec81649fda17775f052153528,0,6,0,1,1,8
10423,1702,2022-11-06 23:12:00,e8c82a92b4d60e3aa45047f8abd4e260,0,6,0,0,0,6
10424,1702,2022-11-06 23:17:00,7226e18d8f56569284e1b4755c2fe374,0,12,0,2,0,14
10425,1702,2022-11-06 23:21:00,3aadb9f14b3fd438517933964ff7f943,0,11,0,0,0,11
10426,1702,2022-11-06 23:26:00,bb1c594a9493dcbf09dae63ecfad74e0,0,9,0,0,0,9
10427,1702,2022-11-06 23:32:00,cc31ae68d3937123529989b7c8b3270d,1,7,0,1,1,10
10428,1702,2022-11-06 23:38:00,d7aa0d3cf1bfd4258a6ff411bfa9a714,0,2,0,1,0,3
10429,1702,2022-11-06 23:42:00,bac9f5956990d364a9a857d5df830535,0,7,0,1,0,8
10430,1702,2022-11-06 23:47:00,97e04aab264e64d22add228bec101fb8,0,7,0,0,1,8
10431,1702,2022-11-06 23:53:00,7b3f3d5989a777bd9e2994af9832d37e,0,4,0,1,0,5
10432,1702,2022-11-06 23:57:00,bbb9d24e7f815ecc9d0101b4314ffc13,0,9,0,0,0,9
10433,1702,2022-11-07 00:02:00,f83fbcb8e143320397534cc80fc36b4e,0,3,0,1,0,4
10434,1702,2022-11-07 00:06:00,427b93b5f15836173596e24a31843a49,0,15,0,2,0,17
10435,1702,2022-11-07 00:12:00,92cae9f54790391473585d53239f426d,0,3,0,0,0,3
10436,1702,2022-11-07 00:16:00,ed4f1f6f2e919c0f4ed080a983832fe4,0,3,0,0,0,3
10437,1702,2022-11-07 00:21:00,b7348a7886867a7bc3b57e5abdc48b7d,0,9,1,0,0,10
10438,1702,2022-11-07 00:27:00,54905cfe286b66f3b4e590488dd0eae5,0,11,1,0,0,12
10439,1702,2022-11-07 00:32:00,5e0872822b2260a806cb546880658748,0,4,0,0,0,4
10440,1702,2022-11-07 00:36:00,814d284a7c776d5cab60171bc0a09dc0,0,11,0,0,0,11
10441,1702,2022-11-07 00:42:00,427b2381578a7e4ffc1899f91294a7a3,0,12,0,0,2,14
10442,1702,2022-11-07 00:48:00,1e59a0f31ae53848b1cc7d00c30cfad8,0,9,1,0,1,11
10443,1702,2022-11-07 00:53:00,b73b06ff59b291a586bc96beda4aa053,0,6,0,0,0,6
10444,1702,2022-11-07 00:56:00,aff8fbb5b4984e7a021cf5be73749cf4,0,1,0,1,0,2
10445,1702,2022-11-07 01:02:00,ced2c0162662752239cfe65a94f1d3bd,0,9,0,0,2,11
10446,1702,2022-11-07 01:17:00,13bc53a30f084aa0b7baac536557d06d,0,3,0,0,0,3
10447,1702,2022-11-07 01:22:00,52717729cd8e3b918792d4852d0e82e5,0,3,0,0,0,3
10448,1702,2022-11-07 01:27:00,fa52e0742ceff401eab61eebef10398d,0,3,1,0,0,4
10449,1702,2022-11-07 01:32:00,31fe07f7f3156632ccfe9cf5d90295cd,0,4,0,0,0,4
10450,1702,2022-11-07 01:37:00,630240102bcbb5f5240baa5ca0c83781,0,1,0,0,0,1
10451,1702,2022-11-07 01:42:00,3d804b16fd07f8394674224af2a96af3,0,0,0,0,0,0
10452,1702,2022-11-07 01:48:00,a27abd4badf85132405bf724dc277f7d,0,6,0,0,0,6
10453,1702,2022-11-07 01:51:00,9a9cd1c52e72d9ec7d17e4396741d3f7,0,4,0,0,1,5
10454,1702,2022-11-07 01:57:00,56f2a97aba45b97f37368080d7eba20d,0,2,0,0,0,2
10455,1702,2022-11-07 02:02:00,eb9d5c90eda37411419417ea9c10cb77,0,7,0,0,1,8
10456,1702,2022-11-07 02:08:00,8dfdf7e3b7c2bc778538b51257830326,0,3,0,0,0,3
10457,1702,2022-11-07 02:12:00,43522854b4efad185d7021055caa848a,0,0,0,0,0,0
10458,1702,2022-11-07 02:16:00,ef2530fa96b35d5714888f25eeb635e0,0,6,0,0,0,6
10459,1702,2022-11-07 02:22:00,73bba802ccf397b7ad370f948e26128d,0,1,0,0,0,1
10460,1702,2022-11-07 02:27:00,b2208e3778ed3870b74057de6429686b,0,3,0,0,0,3
10461,1702,2022-11-07 02:32:00,3304ffc014dfbf7e16b705732fbb3617,0,2,1,0,0,3
10462,1702,2022-11-07 02:37:00,fc9e69347c7c03991f6a0db4e5079bff,0,6,0,1,0,7
10463,1702,2022-11-07 02:42:00,b43a08f4effe0cc34e99eb130f07975f,0,9,0,0,0,9
10464,1702,2022-11-07 02:47:00,71a176726bbb75c229b11a5ad464a1ba,0,8,0,0,0,8
10465,1702,2022-11-07 02:52:00,7bd43020581f27b35434bc81f25c7c51,0,5,0,0,0,5
10466,1702,2022-11-07 02:56:00,da894b078fbeebc7f7e7a81271466785,0,7,0,0,0,7
10467,1702,2022-11-07 03:03:00,4074d12c035128cafc57fb5962e834e7,0,3,0,0,1,4
10468,1702,2022-11-07 03:08:00,3c7fdfed858ed895bff1ba41e611f175,0,2,0,0,0,2
10469,1702,2022-11-07 03:11:00,d4ef5f280f2901c32a3bcd36f11901f0,0,1,0,0,0,1
10470,1702,2022-11-07 03:17:00,564986969bb32b98606fa3afe4bb8981,0,8,0,0,1,9
10471,1702,2022-11-07 03:22:00,2662d76ea7c18e1516f628fefe638c53,0,3,0,0,0,3
10472,1702,2022-11-07 03:27:00,1718048a40b7ed3a95ab68025f8f93cd,0,5,0,1,1,7
10473,1702,2022-11-07 03:32:00,3a2d9906ce90efd4ac6de58dd27302ca,0,7,0,0,0,7
10474,1702,2022-11-07 03:37:00,e533291fb4cb63993f156438e0aa6e79,0,7,0,0,0,7
10475,1702,2022-11-07 03:42:00,ae1a11e3a2245750281f37a10994f021,0,6,0,1,1,8
10476,1702,2022-11-07 03:47:00,5db5214614c0d5d3e2cd351966739b27,0,2,0,0,0,2
10477,1702,2022-11-07 03:52:00,ba65d68b668de0a64ba3746aa9949fdb,0,4,0,1,1,6
10478,1702,2022-11-07 03:56:00,e776c8af86b095fccb533c5c9fc809cf,0,5,0,0,0,5
10479,1702,2022-11-07 04:02:00,eaa2707e92791220e5a21e9c4e62eb82,0,4,0,0,0,4
10480,1702,2022-11-07 04:08:00,94eaa71cdb2b46fda252d3d07e107f0e,0,4,0,0,0,4
10481,1702,2022-11-07 04:12:00,2786cbc91a6661c4050e94274c4b7233,0,2,0,0,0,2
10482,1702,2022-11-07 04:17:00,db33c9f803aa6e497b1c6650e8774f35,0,0,0,0,0,0
10483,1702,2022-11-07 04:22:00,fd3c70e781ba3b2b5445d882dc10f542,0,1,0,0,1,2
10484,1702,2022-11-07 04:26:00,5c83cb52a7ee3817b7ff8950fa28aca7,0,1,0,0,1,2
10485,1702,2022-11-07 04:32:00,37b1bcdcf546a2cf633de059cad6646d,0,3,0,0,0,3
10486,1702,2022-11-07 04:36:00,58229bcd21809eacfdb0e8c57a2a31f5,0,0,0,0,0,0
10487,1702,2022-11-07 04:42:00,109dde4d888f4f8ee327363fbb20c195,0,0,0,0,0,0
10488,1702,2022-11-07 04:46:00,6661249f89762a2432bc5885a833e609,0,2,0,0,0,2
10489,1702,2022-11-07 04:52:00,15fef99389d056d6f525f4f4af251a7b,0,7,0,0,0,7
10490,1702,2022-11-07 04:56:00,108bf1d971517d643e013957e98c7eae,0,3,0,0,0,3
10491,1702,2022-11-07 05:01:00,2c4e3e78e7b4f92cfdd2d52f899d7ca9,0,2,0,0,0,2
10492,1702,2022-11-07 05:06:00,6bb8fb22fb5da0a77115fa5e2be8a3ae,0,7,0,0,2,9
10493,1702,2022-11-07 05:12:00,3ec370916c69db852b07cd4c165f56df,0,1,0,0,0,1
10494,1702,2022-11-07 05:17:00,5b98ac973634f4ec39dcd096a4f24003,0,0,0,0,0,0
10495,1702,2022-11-07 05:22:00,59a7f6f373d1966bf06284d47b8d11f3,0,3,0,1,1,5
10496,1702,2022-11-07 05:26:00,a8a7577d30adf5f0ca3f52affdc1af62,0,3,0,0,0,3
10497,1702,2022-11-07 05:33:00,b7f1738877a50335a234c0a61b210bef,0,0,0,0,0,0
10498,1702,2022-11-07 05:37:00,c1b2785def6ed02257d5320f0f7c1006,0,2,0,0,2,4
10499,1702,2022-11-07 05:41:00,bb29c548b4bf97484701166f916b9489,0,3,0,0,1,4
10500,1702,2022-11-07 05:47:00,b3bb9ffd5f882d27bc9ae1160e8cfa22,0,2,0,2,0,4
10501,1702,2022-11-07 05:52:00,c45c1fb0abfc85b8cf55e9226400377e,0,0,0,0,0,0
10502,1702,2022-11-07 05:57:00,bcd5a267c2527f83656fadab7d976951,0,7,0,0,1,8
10503,1702,2022-11-07 06:02:00,843ba58b504a8969bb409672b2bdd94f,0,7,0,2,2,11
10504,1702,2022-11-07 06:08:00,638927dfcaa21b09c7dc01beee1c4fa4,0,1,0,0,0,1
10505,1702,2022-11-07 06:11:00,7f4b8dbc2fbfe0ed9ad1e54e3fef94f3,0,6,0,2,0,8
10506,1702,2022-11-07 06:17:00,f7594c0dde3e4047096fc13f4d35645f,0,1,0,0,3,4
10507,1702,2022-11-07 06:22:00,7634c59d48be712aa7f6f3e5fba79802,0,1,1,0,0,2
10508,1702,2022-11-07 06:27:00,c8df546b5a9cfd288c4d6a6420f5b09f,0,3,0,0,1,4
10509,1702,2022-11-07 06:32:00,0c2e22fcee5b2fbc1a032a8152e56b25,0,8,0,0,3,11
10510,1702,2022-11-07 06:37:00,c2a4f9c40a8727ed4d35f869b47fd46b,0,6,0,0,3,9
10511,1702,2022-11-07 06:42:00,60c1053b42384d2e5a02330059e5e0f9,0,10,1,0,2,13
10512,1702,2022-11-07 06:48:00,bc2837412bfa2c62bce17550072dcc0f,0,19,0,1,6,26
10513,1702,2022-11-07 06:53:00,e5e4d9b83f5219c234c83ed8dedfd757,0,16,0,0,4,20
10514,1702,2022-11-07 06:57:00,8b529c0ba8fd5a8249c4a45f86cb84bf,0,9,0,2,10,21
10515,1702,2022-11-07 07:02:00,e21647fd6131aab7f2e94dbd53efdef9,1,15,1,1,7,25
10516,1702,2022-11-07 07:08:00,57637d89a39eeecaf8c6bb6052070170,1,10,0,2,12,25
10517,1702,2022-11-07 07:13:00,c1fadb1a7884770ea19a45f292b40aab,0,12,0,1,7,20
10518,1702,2022-11-07 07:18:00,ad71e8a87529f2e221754c631ed521a6,0,17,1,0,9,27
10519,1702,2022-11-07 07:23:00,2b3e5773788455273383859dfc844f16,0,22,0,2,10,34
10520,1702,2022-11-07 07:27:00,7fa6d4138eb164080dd620f14e5cefcb,0,15,1,0,10,26
10521,1702,2022-11-07 07:32:00,a3b277e049a26d2d76e3e3a87dee04af,1,18,0,0,8,27
10522,1702,2022-11-07 07:38:00,809da311e69f00eca2f0f6796ee33002,0,13,0,0,9,22
10523,1702,2022-11-07 07:42:00,2ad10d2cf925e408db05bfac00ca8f34,1,17,2,0,10,30
10524,1702,2022-11-07 07:48:00,8a2054453acbafdb328cafe5c6c16e13,0,13,0,0,10,23
10525,1702,2022-11-07 07:52:00,b19b234940d7b9bfa248f3b3c83fdda6,0,18,0,1,8,27
10526,1702,2022-11-07 07:57:00,10aa6bedb368f78a3c25b276d7784f79,2,17,1,2,5,27
10527,1702,2022-11-07 08:03:00,dc20d1beec3532521cdb4bdbfc789a49,0,14,1,2,13,30
10528,1702,2022-11-07 08:09:00,6df5d751ed92a38bf98a5c301801b280,1,17,0,1,10,29
10529,1702,2022-11-07 08:12:00,5655f1c67ce7de969f60da76e725a8cf,2,19,1,3,5,30
10530,1702,2022-11-07 08:18:00,00315a5b3b525e2ddf2cbbeb1896e200,0,7,0,1,10,18
10531,1702,2022-11-07 08:23:00,7ece606a3122436d7436e0c54da4c024,0,19,0,3,7,29
10532,1702,2022-11-07 08:28:00,b6025cedc0dc861757d2c6675136e5da,0,19,0,4,5,28
10533,1702,2022-11-07 08:34:00,55fe73cc46eb6cb66fbca54e46312be1,1,11,0,2,10,24
10534,1702,2022-11-07 08:37:00,715f8aa17a0c0f50bb9c724de33bf767,0,8,0,0,16,24
10535,1702,2022-11-07 08:43:00,29ff91b795ed24075427d7446d678e00,1,16,0,2,6,25
10536,1702,2022-11-07 08:47:00,afbf693051eac2686d0507e3e83dd1a1,0,14,0,3,6,23
10537,1702,2022-11-07 08:53:00,27b4f0ffe07f5caddf8d07c458e4c4b1,1,9,0,3,12,25
10538,1702,2022-11-07 08:57:00,942aed474a1185eddcd1d399f3dfabb6,0,18,0,0,8,26
10539,1702,2022-11-07 09:07:00,a131b6d550e83136eadfd8cae7fd238e,0,11,1,0,12,24
10540,1702,2022-11-07 09:13:00,4caf50787ee6305d5461c5f706fa7c33,0,13,0,1,6,20
10541,1702,2022-11-07 09:18:00,e46f205ff76c4e9c90881011f7e95efe,0,11,0,1,14,26
10542,1702,2022-11-07 09:22:00,154c946c56f62b2869ee2fae92d21a80,0,15,1,2,9,27
10543,1702,2022-11-07 09:28:00,6847a67c3168fd21b0890a67578f969b,0,17,0,1,11,29
10544,1702,2022-11-07 09:33:00,b0da80daddf7b9c367f4f1275ce02da6,1,18,2,2,6,29
10545,1702,2022-11-07 09:37:00,b28aab87a26f7e8a9e32631f79b36855,0,21,0,1,5,27
10546,1702,2022-11-07 09:43:00,a93cdb8ab273ecf504d14298c0be2ce5,0,15,0,3,8,26
10547,1702,2022-11-07 09:48:00,37d13ae0a3dffe041a71915379b5fe1f,0,15,0,1,7,23
10548,1702,2022-11-07 09:53:00,2a4f2ae2785c29e6124de70e996490a8,0,9,0,0,13,22
10549,1702,2022-11-07 09:57:00,e241d12f43c9448a9ce1fe43abdf4493,0,15,0,1,6,22
10550,1702,2022-11-07 10:04:00,baacd3f3dc56809b911a2814a112b36b,0,10,0,1,11,22
10551,1702,2022-11-07 10:08:00,64c13d9692e662c3b5c4501d99fb8f26,0,11,1,2,13,27
10552,1702,2022-11-07 10:12:00,057a8db77d214fef5300ef5134b6804d,0,10,0,4,10,24
10553,1702,2022-11-07 10:18:00,bbae402dcb779c427d99bdf6f12782f2,0,7,1,4,8,20
10554,1702,2022-11-07 10:23:00,3241248372865c1bc0a155a3549260e9,0,12,0,4,15,31
10555,1702,2022-11-07 10:27:00,06de63279664e47ef6c64cc71ca49cdb,0,13,0,1,16,30
10556,1702,2022-11-07 10:32:00,f9af9a0e427ccf6b2f2f0addb0597493,0,21,1,2,6,30
10557,1702,2022-11-07 10:39:00,ce7a8e1802be03297280612831ec4787,0,12,0,2,9,23
10558,1702,2022-11-07 10:42:00,9a020a43b4b499ddf243a509c143e9b3,0,16,0,5,5,26
10559,1702,2022-11-07 10:47:00,9bf73cafca5fdf04cb615d6d52169326,0,14,0,1,13,28
10560,1702,2022-11-07 10:52:00,46b26124bd6b5b01a38c8fde0ea5ca93,0,11,0,3,11,25
10561,1702,2022-11-07 10:57:00,e221e8d985f74b021be5320073f23e43,0,15,1,1,7,24
10562,1702,2022-11-07 11:03:00,5fd3766b8b7d71a02be1ceb79222184d,1,14,1,6,7,29
10563,1702,2022-11-07 11:09:00,02f148fc55f04c8dc2a35d15206ba123,1,10,0,4,14,29
10564,1702,2022-11-07 11:12:00,3b4816bf9caa5616441af30ca25c4c6e,0,15,1,5,10,31
10565,1702,2022-11-07 11:17:00,a1f91575206506c7cdf5281bb5216ebb,2,8,0,0,11,21
10566,1702,2022-11-07 11:22:00,bd417a69233649043679356ee56580dc,2,16,0,2,11,31
10567,1702,2022-11-07 11:27:00,3e497daaec39224e228bca036271d0ff,0,13,0,4,9,26
10568,1702,2022-11-07 11:32:00,c39537800cb583e2f060dbe228c54161,0,17,0,2,10,29
10569,1702,2022-11-07 11:38:00,9e687f920ce6f967c0fe8ddb473f15db,0,9,0,3,14,26
10570,1702,2022-11-07 11:43:00,65fc5bcbc3b2a4e5281090a3fda2ec61,0,7,0,2,6,15
10571,1702,2022-11-07 11:47:00,40e207ca41cba81a94ec2706140171c4,0,17,0,1,7,25
10572,1702,2022-11-07 11:52:00,407e0f764e63b0192a4158f143f4ba31,0,14,1,2,6,23
10573,1702,2022-11-07 11:57:00,48c840cf71d1f95218c8102f1882c406,0,16,0,5,8,29
10574,1702,2022-11-07 12:03:00,a6fd54f98000b2c1fb444b033165e34a,0,15,1,3,13,32
10575,1702,2022-11-07 12:08:00,f73e4b4ba63bc23b47228e38a0dd393b,1,15,0,0,15,31
10576,1702,2022-11-07 12:13:00,fafa1412781b9b3907ffacc2dc9459a9,0,14,0,1,8,23
10577,1702,2022-11-07 12:17:00,e35e56a448595df151ef3eaae5e6bd95,0,12,0,2,9,23
10578,1702,2022-11-07 12:22:00,f2d1154799508b987adb16434eb714e6,0,16,0,8,3,27
10579,1702,2022-11-07 12:27:00,261b0ee28aaa8864f5c2ad8f6707ebad,0,19,0,1,5,25
10580,1702,2022-11-07 12:32:00,8f0636d148ccfe68d0d3497a6d10f4d9,0,16,0,4,4,24
10581,1702,2022-11-07 12:38:00,698c55afbb477dd391f3f8192f45ca90,1,22,0,3,7,33
10582,1702,2022-11-07 12:42:00,78c5cc3f1af0b750f30f3210a0dea84b,0,17,1,5,2,25
10583,1702,2022-11-07 12:47:00,57c19ed2de7009241b9d15dcf67ceff8,0,18,0,3,2,23
10584,1702,2022-11-07 12:52:00,0b90a17622e54a6e7c22975dd8250718,0,18,0,2,4,24
10585,1702,2022-11-07 12:57:00,b6ff96eaf01881e4bb4ec271f2829548,0,14,0,1,4,19
10586,1702,2022-11-07 13:02:00,b6b2f2677702f6cac8a44886b5a05626,0,10,0,1,13,24
10587,1702,2022-11-07 13:07:00,ae639ccfb0a12341f7959a533bfb66ca,0,14,0,3,11,28
10588,1702,2022-11-07 13:14:00,6fcc38311e029145e9157eb8bb475b57,0,13,0,2,8,23
10589,1702,2022-11-07 13:16:00,0fc2683d65a71fe3c70810d115a7899e,0,17,0,1,4,22
10590,1702,2022-11-07 13:23:00,302644feeeff43f38b4cf0cfdc850dde,0,19,0,3,8,30
10591,1702,2022-11-07 13:28:00,8793f14e9a17862bdfff3d79dcfd3fa8,1,17,0,7,6,31
10592,1702,2022-11-07 13:32:00,7d8fcc32db60ace0bb04ceb6259b634c,1,13,0,5,13,32
10593,1702,2022-11-07 13:37:00,0702bea23ccbd25ef01b744cf789afa9,0,15,0,3,6,24
10594,1702,2022-11-07 13:43:00,62e21aed1bbfac66ac89c1494befdd26,0,13,0,4,11,28
10595,1702,2022-11-07 13:48:00,1578c2b3569659f01c48d79d63cc3218,0,18,0,7,4,29
10596,1702,2022-11-07 13:52:00,ab47b17a8f06c80420c95f73cb9d132a,0,7,1,7,17,32
10597,1702,2022-11-07 13:58:00,fcccd64dc163660551bdd34bd333de47,0,16,0,1,4,21
10598,1702,2022-11-07 14:02:00,d9839e59f8869e65fb707f2cfab73f7d,0,19,0,0,1,20
10599,1702,2022-11-07 14:07:00,122e9a6aa8bf400d9d716142ccc99bcd,0,22,0,1,3,26
10600,1702,2022-11-07 14:13:00,ff2f7763650757cf3c0758b58a80f4d2,0,21,0,1,7,29
10601,1702,2022-11-07 14:17:00,daffeda3d2702ceb612af9ef9e11ae0c,0,15,0,1,3,19
10602,1702,2022-11-07 14:22:00,3e05d48c6b90b556e284debe387f2faa,0,16,0,0,9,25
10603,1702,2022-11-07 14:27:00,519af291b7ab279d8748fb07507caea1,0,14,1,1,8,24
10604,1702,2022-11-07 14:32:00,db27be2f0b94b7e3de49243f14b7f20e,0,17,0,1,6,24
10605,1702,2022-11-07 14:37:00,d9bb5d352b1e74468a892cd2159ed7ed,0,6,0,0,11,17
10606,1702,2022-11-07 14:42:00,3f280deddf1e05a175362e58484860b9,0,13,0,1,7,21
10607,1702,2022-11-07 14:48:00,12100f0fe146b649b3942700f9e72ff6,0,17,1,2,7,27
10608,1702,2022-11-07 14:53:00,e8189646831ee6c3ff6afc07e21c817e,1,22,0,0,10,33
10609,1702,2022-11-07 14:58:00,9632a2b110ed21f391ffbc449cbe8a23,0,13,0,5,4,22
10610,1702,2022-11-07 15:03:00,1388c16ff4cdde7dcb2e83e8618b2250,0,11,0,3,12,26
10611,1702,2022-11-07 15:08:00,f62402d06124fc3ef2dabba11ba5a82d,0,14,0,3,9,26
10612,1702,2022-11-07 15:12:00,66ce6197084a0fc507e469e754dc8328,1,14,0,1,10,26
10613,1702,2022-11-07 15:18:00,23f705077e60f902c54d5dfcb2b62651,0,10,0,2,11,23
10614,1702,2022-11-07 15:23:00,0b2ca645b3112e5b2ff934f00744be11,2,13,0,1,8,24
10615,1702,2022-11-07 15:27:00,33aa26759f306e0c7284ace3e5abbfe1,0,11,0,0,9,20
10616,1702,2022-11-07 15:33:00,e1a3216252b42d97208672af17d757d0,0,7,0,3,13,23
10617,1702,2022-11-07 15:38:00,72fc1079269afc1fd4dc9d2d4382acc0,0,10,0,2,7,19
10618,1702,2022-11-07 15:42:00,a5fdc94bf755d44ce3dc05dd36eb2997,0,9,0,4,7,20
10619,1702,2022-11-07 15:47:00,79bb68e76f7cd85b04c6f92e0880e11e,0,14,0,3,11,28
10620,1702,2022-11-07 15:52:00,a3683f6d81ec9576ac2e81aa1dd2c4b5,1,14,1,5,8,29
10621,1702,2022-11-07 15:56:00,9a0d87393e4f3f04fdd2a16acba04308,0,14,0,3,11,28
10622,1702,2022-11-07 16:03:00,0b9463ac08a131dc2f6aad676cfb934d,0,19,0,1,7,27
10623,1702,2022-11-07 16:07:00,44e6217bfab3f4dd2ebe50c618851a33,0,14,0,1,4,19
10624,1702,2022-11-07 16:12:00,7fedf686ca3fbb37eebe4af44e76c36f,0,14,0,2,6,22
10625,1702,2022-11-07 16:17:00,f4fe9fa32c2c434b4d17ed97b1363aed,0,22,0,3,6,31
10626,1702,2022-11-07 16:22:00,404e6ccd8b488b52451b828d4f9cace4,0,18,2,1,9,30
10627,1702,2022-11-07 16:27:00,f3db671b4bcc3076ca06b2900e1842c9,0,17,1,0,7,25
10628,1702,2022-11-07 16:33:00,bf06b221c210bf265b433337e72b4f48,0,15,2,0,10,27
10629,1702,2022-11-07 16:38:00,913a584040448f41771a4266b7a788f6,0,22,0,1,5,28
10630,1702,2022-11-07 16:42:00,181c21cd49ca807b06bdb3469d64e061,0,19,0,0,3,22
10631,1702,2022-11-07 16:47:00,1f92d5b6da3b740a58dbc7eaee3e2f61,0,16,0,0,0,16
10632,1702,2022-11-07 16:52:00,6c0f47f969c727221e3687d5b8ba4a54,0,13,0,1,4,18
10633,1702,2022-11-07 16:58:00,57b866cd6c8d88eed87e5ca6c222dec8,0,23,0,1,1,25
10634,1702,2022-11-07 17:02:00,b1deb67c799bdf8648262ee52c6bac5c,0,25,0,0,1,26
10635,1702,2022-11-07 17:07:00,4138137b289213cbb0382564022d4a46,0,11,0,0,1,12
10636,1702,2022-11-07 17:12:00,b51561b5cc7e40af9fa816e73bae1adf,0,11,0,1,0,12
10637,1702,2022-11-07 17:17:00,c1f0a069889d42d002692b4806dfc760,0,17,0,2,7,26
10638,1702,2022-11-07 17:22:00,6733f91b54d2f70a5e37ecaf6f1ef083,0,21,0,2,3,26
10639,1702,2022-11-07 17:27:00,f368f14a0aacb0469f479b5fa1fd5e94,1,21,0,2,5,29
10640,1702,2022-11-07 17:32:00,368702970743009fb06619d0dad16f25,0,23,0,5,3,31
10641,1702,2022-11-07 17:38:00,db7524b97fe63b1811217b0820329571,0,24,0,4,1,29
10642,1702,2022-11-07 17:42:00,c50f4b4d4dffc4899694fbaf6eddcd81,0,19,0,6,1,26
10643,1702,2022-11-07 17:47:00,83249c97f043b260fb83494921ec7cb9,1,22,0,1,2,26
10644,1702,2022-11-07 17:52:00,9d2661d49a2963a09fd24b3128d5b827,0,16,0,3,4,23
10645,1702,2022-11-07 17:57:00,33ecc0076457d8bad9203804af46bfae,0,21,0,1,7,29
10646,1702,2022-11-07 18:02:00,46a24e618fda5a71118fb261f8f1bb39,0,26,0,5,2,33
10647,1702,2022-11-07 18:07:00,16f61e9172cd57ef5c182f7cae9df067,0,22,0,5,3,30
10648,1702,2022-11-07 18:12:00,a5513165805226f06267320d980e593f,0,24,0,3,1,28
10649,1702,2022-11-07 18:17:00,95f03dfa3d124cdee31b054be8f1bb99,0,28,0,0,2,30
10650,1702,2022-11-07 18:23:00,258c3dc60cf6cc6acd9514c52a303028,0,26,0,2,0,28
10651,1702,2022-11-07 18:27:00,33f7eb50a4f172900d4deb42de526993,0,28,0,4,0,32
10652,1702,2022-11-07 18:32:00,51027c89173bafe82dfff5d7127821dc,0,19,1,3,2,25
10653,1702,2022-11-07 18:37:00,a8dcd8f61cb0c9cbcb743356ac809684,0,25,0,0,2,27
10654,1702,2022-11-07 18:42:00,07b4dd6954588929c7a4340fdeab6b44,0,25,1,1,5,32
10655,1702,2022-11-07 18:47:00,fa1c8e7c6571649d851fc98acebf5fad,0,26,0,1,1,28
10656,1702,2022-11-07 18:52:00,d4566ecfa3a26890f5ca068667b39ec0,0,28,1,1,1,31
10657,1702,2022-11-07 18:56:00,02441e53e134f64dc3acf78548b0fd3d,0,24,2,0,2,28
10658,1702,2022-11-07 19:02:00,9a05d7edc091be51162b6677b7feb7e5,0,21,1,0,0,22
10659,1702,2022-11-07 19:06:00,27a5b06fff3fb60a27b16b720bd2e554,0,26,0,0,0,26
10660,1702,2022-11-07 19:12:00,fd1e05a832b35295e7d132c4533c1b27,0,22,0,1,0,23
10661,1702,2022-11-07 19:17:00,220ce3b30c3bdc54aa834b8990d43bff,0,22,0,1,0,23
10662,1702,2022-11-07 19:22:00,8ad2e07794ae74a85ddc638cd4fbdb03,0,21,2,0,0,23
10663,1702,2022-11-07 19:27:00,ada2ffa7a6cdee24743d9cfac4185908,0,18,0,0,0,18
10664,1702,2022-11-07 19:32:00,0aff5832ae6c8f9f7ad2f01dd7508980,0,18,0,0,0,18
10665,1702,2022-11-07 19:36:00,40e0e93f1064a0b5c23d165783dad198,0,21,0,4,1,26
10666,1702,2022-11-07 19:42:00,825afbeb4a1b04d1031ba93aedc30242,0,23,0,0,0,23
10667,1702,2022-11-07 19:47:00,652d6309111d9c6dc8daf5f36736d709,0,22,1,0,0,23
10668,1702,2022-11-07 19:52:00,f18c29e9bed162d2c91aca26c940e8d2,0,22,0,1,1,24
10669,1702,2022-11-07 19:57:00,94763cff19140a849ef7add844b65141,0,19,0,0,0,19
10670,1702,2022-11-07 20:02:00,b18455e80490c149f272767c9341b730,0,20,0,0,0,20
10671,1702,2022-11-07 20:07:00,a6b6c9bfdf42140a0b40c6a3c4d199e0,0,25,3,1,0,29
10672,1702,2022-11-07 20:12:00,6135316f1c310e771b4c833f3ad26eba,0,21,1,0,1,23
10673,1702,2022-11-07 20:17:00,9894421baf32a7a9fefab4ef655a48f0,0,14,0,2,2,18
10674,1702,2022-11-07 20:22:00,c825b2a3936c0e6e96efa55d2df32ef5,0,22,4,0,0,26
10675,1702,2022-11-07 20:26:00,fe6b134992aa4c218ed6c33059f4ba6c,0,18,1,0,1,20
10676,1702,2022-11-07 20:32:00,d06f16640182965f683b52026d2bf7ac,0,16,0,0,2,18
10677,1702,2022-11-07 20:38:00,ff6195e2b6dd32fc6f02556ac17ae5ca,0,13,0,1,1,15
10678,1702,2022-11-07 20:41:00,ef475bfb98e542b45d8502c12c853ce6,1,22,0,0,0,23
10679,1702,2022-11-07 20:47:00,e748c5f828b4c3e5c3720c3624f564f1,0,19,0,0,1,20
10680,1702,2022-11-07 20:51:00,7396b28aae9267fc5fa81e752f81f7ff,0,10,3,0,0,13
10681,1702,2022-11-07 20:57:00,599c3c9aa7cc16d1fd67a842d112132d,0,8,0,0,0,8
10682,1702,2022-11-07 21:02:00,adfcb0ed78d536e357f79be4a94cd66d,0,18,0,0,0,18
10683,1702,2022-11-07 21:07:00,79b83b6327771d86452e5299e3e14ece,0,19,0,2,1,22
10684,1702,2022-11-07 21:12:00,ce129dda5e9630fd04be48305a38c406,0,16,0,1,0,17
10685,1702,2022-11-07 21:17:00,e818a280068599a772181659c6ded2c1,0,14,0,0,0,14
10686,1702,2022-11-07 21:22:00,15df641c0785b818dfdb06c650f45861,0,21,0,0,1,22
10687,1702,2022-11-07 21:27:00,4193cd6f7222f3a57806d34df77f136e,0,18,0,0,0,18
10688,1702,2022-11-07 21:32:00,8917e12ec2fff99e0e5d2e2b2cbc70b6,0,11,1,1,0,13
10689,1702,2022-11-07 21:37:00,7b8f7c5ae4c7a15633bcb02916eec0b0,0,11,0,0,1,12
10690,1702,2022-11-07 21:42:00,4bf7476f751072b2d41f036f154e8180,0,7,1,0,1,9
10691,1702,2022-11-07 21:46:00,69e164f0c29f359219a710fc376bf734,0,11,0,1,1,13
10692,1702,2022-11-07 21:52:00,1b22ffd23becc299fb6e0fb4a6f73ab8,0,18,0,0,1,19
10693,1702,2022-11-07 21:56:00,ba021ebfc1ad22fd51a6e39a72eba908,0,18,1,0,0,19
10694,1702,2022-11-07 22:02:00,f7e695fbb5e055086e13c85cf6433057,0,10,0,1,1,12
10695,1702,2022-11-07 22:06:00,cd9e67d6567f40bc9f9f0a6c270e514b,0,9,0,0,1,10
10696,1702,2022-11-07 22:12:00,b1e71ec637c7bf7e9a6d52e4d8131da5,0,9,0,0,0,9
10697,1702,2022-11-07 22:17:00,d7d592f388007bb4fb0175fe8e413644,1,15,0,0,0,16
10698,1702,2022-11-07 22:22:00,f73274b389a2459106de7e766f637d06,0,15,0,1,0,16
10699,1702,2022-11-07 22:26:00,5fc50f3580a787409c9f8f31f3719fda,0,15,0,0,1,16
10700,1702,2022-11-07 22:31:00,fa007144a22eb93ea33d0eef0e0ebf2c,0,9,1,0,1,11
10701,1702,2022-11-07 22:36:00,1f95a54d58d88fd27941b64d9a06c760,0,8,0,0,0,8
10702,1702,2022-11-07 22:41:00,0562f8b134cf5c1c475654b7632641bf,0,12,1,0,0,13
10703,1702,2022-11-07 22:46:00,fc960983ffc87266206ea8a5733e266c,0,14,1,1,1,17
10704,1702,2022-11-07 22:52:00,375fcecf2cd5f7060d6ce58bb3729cdc,0,9,0,0,1,10
10705,1702,2022-11-07 22:56:00,f9031a2a6a79307c6340892d65c9a7e8,0,14,0,0,1,15
10706,1702,2022-11-07 23:03:00,005b462b200278942c52f370d62d439c,0,9,0,0,0,9
10707,1702,2022-11-07 23:07:00,1bf3d4ece301743c0182d1d02979ca49,0,9,0,0,0,9
10708,1702,2022-11-07 23:11:00,7989813ee3a49c4e546d284522edbc0c,0,7,0,0,0,7
10709,1702,2022-11-07 23:16:00,b4290e21a9ce799d88b9e6c908115c29,0,14,0,0,1,15
10710,1702,2022-11-07 23:21:00,3abec002784e1b587b0eb032eb69a8db,0,7,0,0,0,7
10711,1702,2022-11-07 23:27:00,c2ce1751e75fd0027befa719faec6831,0,5,0,0,0,5
10712,1702,2022-11-07 23:32:00,c2ee0cf2a3fcc1759f1c9941f35d9278,0,1,0,0,0,1
10713,1702,2022-11-07 23:37:00,a27fd203c9c1565f773e64d64aceaf3c,0,6,0,0,0,6
10714,1702,2022-11-07 23:41:00,2b02c7baaa6cee324ed09abe55c99bec,0,5,0,0,0,5
10715,1702,2022-11-07 23:46:00,74a58f0a71315fac0d00868afbb708cf,0,9,0,2,0,11
10716,1702,2022-11-07 23:51:00,90d75d25e6740f08df8d83776105b6bc,0,8,0,0,1,9
10717,1702,2022-11-07 23:57:00,ce44cfd3d5fbd3cb9366ee91a20dcdfd,0,5,0,0,0,5
10718,1702,2022-11-08 00:02:00,08ec0308802006cd2ccbd2ecafdf24b6,0,7,0,2,0,9
10719,1702,2022-11-08 00:08:00,cb930fa2a18206ac916b08f253642322,0,12,0,0,1,13
10720,1702,2022-11-08 00:12:00,334ae202c5371a2f91ebd2d6d736f03e,0,15,1,0,0,16
10721,1702,2022-11-08 00:17:00,507b776cc7ee913a226922c426001963,0,3,0,0,1,4
10722,1702,2022-11-08 00:22:00,e2ab76a7ce0abfd87b9ac7a449c8d2d7,0,4,1,0,1,6
10723,1702,2022-11-08 00:26:00,43d21b11d5158707c2b189b4013c94ee,0,13,0,1,0,14
10724,1702,2022-11-08 00:33:00,9eef673786abddda24a6478edbd5faea,0,6,0,0,0,6
10725,1702,2022-11-08 00:36:00,74a3c39f2e2028dbd0f3111c05a44967,0,1,0,0,1,2
10726,1702,2022-11-08 00:42:00,0fc576f972c1df1d65a33e8f8c90b6ac,0,7,0,0,1,8
10727,1702,2022-11-08 00:47:00,11e566d1fa6ec27b638d68098e599864,0,6,0,0,0,6
10728,1702,2022-11-08 00:52:00,5e869f39d35a5bd7cd13aa127d958773,0,4,0,0,0,4
10729,1702,2022-11-08 00:56:00,63a10d9f36e3ce408c3daa8eb53cefc0,0,13,0,0,1,14
10730,1702,2022-11-08 01:02:00,0e5b50af7266ebf82b9fcd124cd6bf84,0,6,1,0,0,7
10731,1702,2022-11-08 01:06:00,40dfa6ea0655b68b2760cf21599594e6,0,3,0,1,0,4
10732,1702,2022-11-08 01:12:00,765c2e1edb7ec30b48f8ce0e15adf75f,0,0,0,0,0,0
10733,1702,2022-11-08 01:17:00,fff7e9b9ab7d074eacdb187e2cd6dbd3,0,6,0,0,1,7
10734,1702,2022-11-08 01:22:00,c9a09b54ba2c72b443f372def0abac2e,0,9,1,0,0,10
10735,1702,2022-11-08 01:27:00,53fdcd3d33a4b4b3ad2dd41223a4925c,0,4,0,0,0,4
10736,1702,2022-11-08 01:32:00,9591ae73d9348bf2cc54c7c5bf924e73,0,3,0,0,0,3
10737,1702,2022-11-08 01:37:00,7e5f6e00f36b53b42bc774946a16624a,0,3,0,0,0,3
10738,1702,2022-11-08 01:41:00,dfdcf55f5a2c8c9e842a9769db2ade37,0,8,1,0,0,9
10739,1702,2022-11-08 01:47:00,70177d1ae89a5cdd68e2e03b5810fdc2,0,2,0,0,1,3
10740,1702,2022-11-08 01:51:00,bf6774b25c02555da7ec53e75ee31b97,0,3,0,0,0,3
10741,1702,2022-11-08 01:57:00,a598f2bf515412f143e85af28055652c,0,2,0,0,0,2
10742,1702,2022-11-08 02:02:00,c52f0a014484881990a03123fd42e7d9,0,5,0,0,0,5
10743,1702,2022-11-08 02:07:00,8d72a3feb4c63a4b61f67368f0d956b7,0,2,0,0,0,2
10744,1702,2022-11-08 02:12:00,64a5110ed5e1b5f27b3dbcd97eac5833,0,4,0,0,0,4
10745,1702,2022-11-08 02:16:00,768652d76073dab8e1a56abbfbca6139,0,5,0,0,0,5
10746,1702,2022-11-08 02:21:00,5977a0d491d13a514f7a8c593abc6144,0,2,0,0,0,2
10747,1702,2022-11-08 02:27:00,c7e6e0ee20a4905c346c691a592c03f2,0,1,0,0,0,1
10748,1702,2022-11-08 02:32:00,b3c330b1bcd1b2ffb19decb30d3fae5f,0,5,0,0,0,5
10749,1702,2022-11-08 02:37:00,7fbb70cfaba9840e4c71dd3f7cfd7489,0,2,0,0,0,2
10750,1702,2022-11-08 02:41:00,29df087c2f6a80c93c9b0524e5df9600,0,2,0,0,0,2
10751,1702,2022-11-08 02:47:00,b57f37ec15be32683d6936e345c24db3,0,3,0,0,0,3
10752,1702,2022-11-08 02:52:00,3e3374bb306684c403a5b8a38fd44d5c,0,1,1,0,0,2
10753,1702,2022-11-08 02:57:00,9def66a8e1f2f3525530e9c0fa4f5dff,0,3,0,0,0,3
10754,1702,2022-11-08 03:02:00,60329e54f555acfc33879c5a353d0506,0,1,0,0,0,1
10755,1702,2022-11-08 03:07:00,24b14daae4f05d497bf4c9056fa0e75a,0,2,0,0,0,2
10756,1702,2022-11-08 03:11:00,642077b2190b03f89637abf38cc53e96,0,2,0,0,0,2
10757,1702,2022-11-08 03:17:00,589da2dfdb6acf947a55ab999d0548b5,0,2,1,0,0,3
10758,1702,2022-11-08 03:22:00,94a7c63f265b0a94d39a3627d559d63e,0,6,0,0,1,7
10759,1702,2022-11-08 03:27:00,9724d866db1727af7c8e965acbe8dfec,0,6,0,0,0,6
10760,1702,2022-11-08 03:31:00,b35a3476ac296ef557ddad6fcf00563d,0,5,0,0,0,5
10761,1702,2022-11-08 03:37:00,f1bb3c8aeb1deec0844fe3d7cf092b8e,0,4,0,0,0,4
10762,1702,2022-11-08 03:42:00,e67d8fb4d4727d56cffd33b949a0c4d4,0,0,0,0,0,0
10763,1702,2022-11-08 03:47:00,6bbb5619430dcc461f73dc936cb36de1,0,4,0,0,0,4
10764,1702,2022-11-08 03:51:00,ccd668f699ab3cb93e5e8cd09d953b67,0,4,0,0,0,4
10765,1702,2022-11-08 03:56:00,b014fa10c5711114de917ec582f00120,0,0,1,0,0,1
10766,1702,2022-11-08 04:02:00,19f5356b3c354506c8d4d7236133f23a,0,6,0,0,0,6
10767,1702,2022-11-08 04:07:00,483cf84ff917b254dfc1f35454d99339,0,0,0,0,0,0
10768,1702,2022-11-08 04:12:00,1903b00b7f67001bdc4a0abd73aa0fc4,0,2,0,0,0,2
10769,1702,2022-11-08 04:17:00,acd73d4014f19a02047bc25113c31219,0,4,0,0,0,4
10770,1702,2022-11-08 04:21:00,3f01a7dc3969fbe4db67e4754ddad157,0,2,0,0,0,2
10771,1702,2022-11-08 04:27:00,bb26e4ebd3bd6881a1c8a94e32bff136,0,1,0,0,0,1
10772,1702,2022-11-08 04:31:00,ee322dcbbabd3f35b7f078fc741db89e,0,4,0,0,1,5
10773,1702,2022-11-08 04:37:00,768913363d76657650884a2a9838bc14,0,4,0,0,0,4
10774,1702,2022-11-08 04:42:00,4bc000eca600261277f4208f4585fe80,0,6,0,0,0,6
10775,1702,2022-11-08 04:47:00,f3a0477b73e61b770911088fc38e8d4f,0,2,0,1,0,3
10776,1702,2022-11-08 04:52:00,9638c283bd65ed8e694d4e763a8bd48f,0,7,0,0,2,9
10777,1702,2022-11-08 04:57:00,e8120a6e5b7be4fdf5b804bc74955cd9,0,0,0,0,1,1
10778,1702,2022-11-08 05:02:00,ee73d58a1e9cf37707fb60db504e4dbd,0,1,0,0,0,1
10779,1702,2022-11-08 05:07:00,2e3eeac2bb1ff92870cb87cd04c46ad4,0,2,0,0,0,2
10780,1702,2022-11-08 05:12:00,c07e112f4328e90bcb24e83f0ed9e95c,0,1,0,0,0,1
10781,1702,2022-11-08 05:18:00,3c353c739d3c19a763a707a6d4517097,0,3,0,0,0,3
10782,1702,2022-11-08 05:21:00,44560d9b4c6ab79e5f830943f58fa087,0,5,0,0,1,6
10783,1702,2022-11-08 05:27:00,3b6dd5d630ca093e47318806a5308a72,0,4,0,0,0,4
10784,1702,2022-11-08 05:32:00,4de835e70af2a56b58e524b2193ec45b,0,11,0,0,0,11
10785,1702,2022-11-08 05:37:00,95c89b00e3e9fdc1f98612831a053eda,0,3,1,0,0,4
10786,1702,2022-11-08 05:41:00,863bd7fdfa0efaf525213a7ea44ff6bb,0,3,0,0,0,3
10787,1702,2022-11-08 05:46:00,25f86fc93b6afd62cc525a4e6121f5d1,0,5,0,0,0,5
10788,1702,2022-11-08 05:51:00,a1f19b81a503cb117fb7fae7902463fc,0,0,2,1,1,4
10789,1702,2022-11-08 05:56:00,b59f1ca75f40e36e069bce7fb17e34dc,0,6,0,0,0,6
10790,1702,2022-11-08 06:02:00,7144c4bc0fb19b8e233992a99827abb8,0,7,0,1,1,9
10791,1702,2022-11-08 06:07:00,e8fc1ec3acb235e9e8fc23dc2eeb2285,0,3,0,1,0,4
10792,1702,2022-11-08 06:12:00,e998a2ea7679b631375ff8fd6ec34c20,0,0,3,0,2,5
10793,1702,2022-11-08 06:16:00,56d9bc8c114c7d54c94a48b21a57b4ae,0,5,2,1,1,9
10794,1702,2022-11-08 06:21:00,b28b4152e2b8cf11dd4abef88064f79f,0,10,0,0,0,10
10795,1702,2022-11-08 06:27:00,d2ab28df1bd3bbe4a7dd013f11a0d030,0,7,2,1,0,10
10796,1702,2022-11-08 06:32:00,68f776e92875659f089bcdba37187f45,0,7,5,0,2,14
10797,1702,2022-11-08 06:37:00,3242261f1e01ac01e0dfbde126d6993b,0,14,1,0,1,16
10798,1702,2022-11-08 06:41:00,2925b016b792878da789b220ca8dc679,0,11,1,0,2,14
10799,1702,2022-11-08 06:47:00,f9df7dbf2fdedce673100f2142fd4102,0,14,1,0,4,19
10800,1702,2022-11-08 06:52:00,4e725ba3660cd5b948b5ac0f6263a15a,0,16,0,0,6,22
10801,1702,2022-11-08 06:56:00,bf28292babe720a597f676c92f58462f,0,20,0,1,6,27
10802,1702,2022-11-08 07:02:00,2490d779ad14dac031745cd0816b3f55,0,12,1,0,4,17
10803,1702,2022-11-08 07:07:00,06a04345ebabb321ed02535abd29c10b,0,22,0,1,8,31
10804,1702,2022-11-08 07:12:00,97f46b28d003540b6eb727df1cf734b7,0,16,1,0,12,29
10805,1702,2022-11-08 07:16:00,e0239b8c3ddfbc5c18aaddf960e83267,0,11,1,2,5,19
10806,1702,2022-11-08 07:21:00,2ae4188f86adaa2b6ed7df94c36de6d9,1,15,0,1,13,30
10807,1702,2022-11-08 07:27:00,edb50a430b593e9e1ae3993e33bf8307,0,20,0,2,5,27
10808,1702,2022-11-08 07:32:00,3a42b6ff03b72554ade50c37c7e7424d,1,11,0,2,13,27
10809,1702,2022-11-08 07:37:00,be1eeaeebad07f18108422f3b7fab67b,1,11,0,2,18,32
10810,1702,2022-11-08 07:41:00,3717ee80d77c083fa456fea5d6ffa7c1,0,12,0,2,6,20
10811,1702,2022-11-08 07:47:00,3aed1d530268579340dc05c6ae2aabc4,0,16,0,1,7,24
10812,1702,2022-11-08 07:52:00,8fa60f70d271784626bf07e83160c292,1,18,0,1,9,29
10813,1702,2022-11-08 07:56:00,fca76272b0dd72de3a05ed2940dae6b4,0,11,0,5,8,24
10814,1702,2022-11-08 08:02:00,117478e68ddd6ee33c0635417ca28d4a,0,13,0,1,4,18
10815,1702,2022-11-08 08:07:00,9ab265ce99329089bcf2c4f3068cc080,0,13,1,0,10,24
10816,1702,2022-11-08 08:11:00,e14940b9c5aadbeb848217b327d2cd08,0,9,0,1,12,22
10817,1702,2022-11-08 08:17:00,7d2f446d258cf29bd86f2686bf985a38,0,17,0,2,6,25
10818,1702,2022-11-08 08:22:00,1210f1829f203f49a04ffb6e7abe83e2,0,16,0,0,13,29
10819,1702,2022-11-08 08:26:00,8604874631545bddf89ac3ff8f906733,0,16,0,4,5,25
10820,1702,2022-11-08 08:31:00,7e9299b2a8823893a56cb5bb452df436,0,13,0,2,5,20
10821,1702,2022-11-08 08:37:00,8ffbd60de0a014fc9ac5dbee65efeedc,0,20,0,0,7,27
10822,1702,2022-11-08 08:43:00,6b6e4f508cf117cbd748f9c715f9b3ed,0,20,0,0,10,30
10823,1702,2022-11-08 08:47:00,55d729fa67091240f41f7f60de69bf65,0,19,0,0,11,30
10824,1702,2022-11-08 08:52:00,97539cdadcac3020d5d8f7eb3de6279d,0,15,0,1,10,26
10825,1702,2022-11-08 08:56:00,6dbcc1d53b972d325859f6b29b1523c6,0,18,0,0,8,26
10826,1702,2022-11-08 09:02:00,75af39b8551eea395ea73e50a734f286,1,9,0,2,8,20
10827,1702,2022-11-08 09:07:00,12b72e3aebe67ea460e29cbebc14483d,0,14,0,0,8,22
10828,1702,2022-11-08 09:12:00,a4d89e1ec099969952fda03e57880c8c,0,13,0,0,16,29
10829,1702,2022-11-08 09:18:00,cf7a46c9a28d96e19a7bffd0da741159,0,19,0,6,3,28
10830,1702,2022-11-08 09:22:00,deb813c4090273eb0c474a8ce8ac93a3,0,9,2,5,13,29
10831,1702,2022-11-08 09:27:00,cfe91ee2b50d5f29e5eb3035897dc3d8,1,19,0,0,14,34
10832,1702,2022-11-08 09:33:00,46008d7c73d95ffe35092df565ad104f,0,14,0,3,11,28
10833,1702,2022-11-08 09:37:00,c2b289101353f3c324589e2aa9ac5565,0,15,0,2,8,25
10834,1702,2022-11-08 09:42:00,e397b03a4df9f39a12e3394ee927defc,0,16,0,2,3,21
10835,1702,2022-11-08 09:47:00,64978348471d12995d0ada6fbba61614,0,7,0,3,12,22
10836,1702,2022-11-08 09:52:00,5114b640c23586f27f6a058d33148a84,0,16,0,0,12,28
10837,1702,2022-11-08 09:57:00,2fa5f013c2619488e002090e6ecddb87,0,15,0,2,7,24
10838,1702,2022-11-08 10:03:00,104a38ca4c78ec68e1673d3464101a4a,0,13,0,0,14,27
10839,1702,2022-11-08 10:08:00,7ebe4f1601a9e9ba79f071738c885305,0,21,1,5,7,34
10840,1702,2022-11-08 10:12:00,9ff6bb6b0d5a756b320d4353c99bada4,0,13,1,1,11,26
10841,1702,2022-11-08 10:17:00,1a0536808e1dfe956c5a24b43a6c40ff,1,15,0,1,14,31
10842,1702,2022-11-08 10:22:00,56c25586f8db625aa3b9e6a6a26b3901,0,23,0,1,11,35
10843,1702,2022-11-08 10:27:00,e5c7f166f2da6ac2fc4013cae7c36eb9,1,18,0,0,10,29
10844,1702,2022-11-08 10:32:00,9e1a0b38a621559b3ce7ebc7531cc93a,1,14,2,7,9,33
10845,1702,2022-11-08 10:38:00,f185d44eab82ab5126bb75bc865dddfe,0,20,0,2,7,29
10846,1702,2022-11-08 10:42:00,0c64adb3bb6a2a5621a0d0ad3722bf4b,0,14,0,3,7,24
10847,1702,2022-11-08 10:47:00,46214ade2dedafeb9b766de2a10e28a9,3,15,0,2,6,26
10848,1702,2022-11-08 10:53:00,b89ccf6f8e9943e290fa881fd0720d76,1,12,0,3,15,31
10849,1702,2022-11-08 10:57:00,bba63b28294658f5e9975725f644b0d7,0,9,0,2,12,23
10850,1702,2022-11-08 11:02:00,ea861a0c0c5a38426922c63685bd7613,0,7,0,3,14,24
10851,1702,2022-11-08 11:08:00,80aa97b0a7dee8744e6bba975b74ae89,0,16,0,0,10,26
10852,1702,2022-11-08 11:12:00,300bcb22e2bf13c774663a0730404f55,0,18,0,3,8,29
10853,1702,2022-11-08 11:17:00,75498700e627e63d5df8a9eb8cf434e8,1,12,0,6,12,31
10854,1702,2022-11-08 11:22:00,dab792d359de48b0729ad94e500ccae7,1,13,0,0,22,36
10855,1702,2022-11-08 11:28:00,2d12442bc439bb6c3d21fe5219146adb,0,15,0,3,4,22
10856,1702,2022-11-08 11:32:00,eebaba30e0a14941a86c9b78976778ab,0,6,2,3,12,23
10857,1702,2022-11-08 11:38:00,0960a6a94868a641e9d8bfebc47f73bc,0,9,0,0,14,23
10858,1702,2022-11-08 11:42:00,3cd9e094078c0d8437c16dc700137d36,0,20,0,2,9,31
10859,1702,2022-11-08 11:47:00,98a3ea7a2c51f3d791beda0782575f46,0,10,1,1,18,30
10860,1702,2022-11-08 11:52:00,854a21663699a031ab221201df705be1,0,11,0,5,13,29
10861,1702,2022-11-08 11:57:00,e36bf22142f04a47befb6555a53d1309,0,14,0,3,9,26
10862,1702,2022-11-08 12:02:00,dc4e12833eebe7dd3bb4d86ec34fb1c9,0,17,1,0,12,30
10863,1702,2022-11-08 12:07:00,8e5993a832e2bd1d6bb2cf36d606393a,0,12,0,2,14,28
10864,1702,2022-11-08 12:12:00,bb015c2500ec56211f78d22aeaf659db,1,12,0,2,5,20
10865,1702,2022-11-08 12:17:00,9f5c6de9e2cbf896ec67d15516da6510,0,17,0,1,7,25
10866,1702,2022-11-08 12:23:00,81dfbbe06af002b1e2cd506076d65b16,3,12,1,5,8,29
10867,1702,2022-11-08 12:27:00,8a5c0bec460a872e2ff65ca22eef1f69,0,11,0,2,9,22
10868,1702,2022-11-08 12:32:00,f37faabb07f41b62ec6d95376ac24724,0,14,0,2,8,24
10869,1702,2022-11-08 12:37:00,b9089ed8beb591f8d57af20a8258860c,0,15,0,0,7,22
10870,1702,2022-11-08 12:43:00,1daab8e531b45b42089575da576f74e0,0,15,0,4,10,29
10871,1702,2022-11-08 12:47:00,f9c6df2f2786080a4e39444122e10f57,0,21,0,3,4,28
10872,1702,2022-11-08 12:52:00,51ffe736508d025caf2901705b85bec9,0,17,0,3,5,25
10873,1702,2022-11-08 12:57:00,323e22dd399cfb45d5f3f98b0f12623c,0,10,0,0,14,24
10874,1702,2022-11-08 13:02:00,21fca96acbac8355ab806fe6be25d920,0,12,0,0,4,16
10875,1702,2022-11-08 13:08:00,4364275e8ef5c66eab2275fb77ee9ef3,0,18,0,5,3,26
10876,1702,2022-11-08 13:12:00,5b6c3063e7a8f03fdd9b3b7c86ece190,0,12,1,4,8,25
10877,1702,2022-11-08 13:16:00,d58e9f3ca8274ac8d209a38b8d7c2910,0,19,0,7,5,31
10878,1702,2022-11-08 13:21:00,a1afc602b369c34a391667b3f3c67137,0,19,0,3,6,28
10879,1702,2022-11-08 13:27:00,2deee266019b721af17e89d909fc313d,0,15,1,4,2,22
10880,1702,2022-11-08 13:32:00,eaf7ec57b2a15dfa3efa7a1133d5d630,0,12,0,5,10,27
10881,1702,2022-11-08 13:38:00,a236d2e84c26eb6d929479029ba84b4c,0,18,0,5,3,26
10882,1702,2022-11-08 13:42:00,057ec7de3899014f9dd26b2c84e261b5,0,21,0,5,4,30
10883,1702,2022-11-08 13:47:00,d8ed9d89afe229ac85ab412ba6804616,0,18,0,5,5,28
10884,1702,2022-11-08 13:51:00,c8c31a7119e0bf43a6ae76f83fba5cc5,0,22,0,3,4,29
10885,1702,2022-11-08 13:57:00,bfa9e10e5d8e3d26d046bcb0fcf89bc3,0,22,0,7,2,31
10886,1702,2022-11-08 14:02:00,12daa6b3da504108a33eb02641c2c954,1,13,0,0,8,22
10887,1702,2022-11-08 14:07:00,af08facae05b6bbfb56a4859c1348cf1,0,14,1,3,14,32
10888,1702,2022-11-08 14:13:00,38c3bae8bbeba5446f54eeab11034460,2,11,0,7,11,31
10889,1702,2022-11-08 14:17:00,35c18a47277f01f9e0e430505bddd1b3,1,8,0,4,14,27
10890,1702,2022-11-08 14:22:00,5d807b40e6bccb3a585b0a170791a4a5,0,17,0,3,3,23
10891,1702,2022-11-08 14:28:00,d92a3cbdbbe199f5984ffb3c5d95bdc7,0,20,0,2,3,25
10892,1702,2022-11-08 14:32:00,2568175b268e1b3b4d9af290d16b3c32,0,20,0,3,4,27
10893,1702,2022-11-08 14:37:00,2fa7db212034457b848780fe4bdf9ce1,0,14,0,1,13,28
10894,1702,2022-11-08 14:42:00,9ffee37c7d3f384f417ffbf11ab14677,0,18,0,0,8,26
10895,1702,2022-11-08 14:47:00,3771bb2ef789d172453792af598a969d,1,16,1,2,7,27
10896,1702,2022-11-08 14:52:00,365ea4cc9654b28d4f1c23c88701c1e4,0,19,0,2,7,28
10897,1702,2022-11-08 14:56:00,fba8c76798d143d2584092659f924f3d,1,18,1,2,6,28
10898,1702,2022-11-08 15:02:00,e89f9ff0cf94be95d331dea74cbeabeb,0,13,0,0,7,20
10899,1702,2022-11-08 15:07:00,f6f0e8f80c4864a776144c2d4c12f768,0,15,0,2,4,21
10900,1702,2022-11-08 15:11:00,5a9379f86800810fe7e21e0d7130b3a6,0,11,0,2,5,18
10901,1702,2022-11-08 15:17:00,b713654ef0278596725d623a57415acc,0,10,0,1,6,17
10902,1702,2022-11-08 15:21:00,92243b44a2adced05022dfcdfc3a491b,2,21,0,2,5,30
10903,1702,2022-11-08 15:27:00,7d97d091c687133ddfec54603c5eb638,1,14,0,1,2,18
10904,1702,2022-11-08 15:32:00,92ce577a128846caddb4296ac1c5adc3,0,19,0,0,2,21
10905,1702,2022-11-08 15:37:00,ddfd753a0dd8f678f3a2f8038adcc59c,1,13,0,0,1,15
10906,1702,2022-11-08 15:42:00,12db53902c9f86dff4ac50c7e0095380,0,16,0,1,5,22
10907,1702,2022-11-08 15:47:00,604899cf5401ccbeb0d3ba6453632ab5,0,13,0,4,5,22
10908,1702,2022-11-08 15:52:00,97a397768450b030c23ce1de7666ed97,1,20,0,3,5,29
10909,1702,2022-11-08 15:56:00,6f19b68abf4cb5b09174925b7eb34aa0,0,15,0,5,9,29
10910,1702,2022-11-08 16:02:00,f58ea177a73f8722a3e2522ba3ee70d7,0,11,0,2,6,19
10911,1702,2022-11-08 16:07:00,0d42424c080e93eac288b035f9554d1a,0,20,0,2,4,26
10912,1702,2022-11-08 16:11:00,ff42a81aaf4ec24505a1aa530192bdf6,1,11,1,2,14,29
10913,1702,2022-11-08 16:18:00,b3e5e6fa20f3185550ae771be775bf7d,0,15,0,2,9,26
10914,1702,2022-11-08 16:21:00,1fe2228d1192985e33750121e065e4a0,0,11,0,1,13,25
10915,1702,2022-11-08 16:27:00,f053902ce3f513cc27f7d75a668eb6ab,1,15,0,1,12,29
10916,1702,2022-11-08 16:32:00,7246f0eb30eadc6e53cad7c3f1fe98b3,0,14,0,0,10,24
10917,1702,2022-11-08 16:37:00,080d5e891aca0055a5561fa82667fbf5,0,17,0,1,10,28
10918,1702,2022-11-08 16:42:00,68b5606e3872adf23164594472406318,0,15,1,0,10,26
10919,1702,2022-11-08 16:46:00,17b90111cd06ffa858809a50c6f8d633,1,18,1,5,9,34
10920,1702,2022-11-08 16:52:00,5b258bae1b29caffa965cafcbb471238,0,17,1,0,6,24
10921,1702,2022-11-08 16:57:00,f3155ebd32a25ddda6d83a1be14b6ba5,0,19,0,1,9,29
10922,1702,2022-11-08 17:02:00,6e451bc8752d16f2fbfcca5ebe907940,0,20,0,2,6,28
10923,1702,2022-11-08 17:07:00,86a7dd9f8b9153c7379ed98e08c04b45,0,19,0,4,10,33
10924,1702,2022-11-08 17:11:00,33d78d32a842e0460ec8284afc9d724e,0,16,0,1,7,24
10925,1702,2022-11-08 17:18:00,23e9176e6eda4c0ec75078729cc967aa,0,22,1,4,4,31
10926,1702,2022-11-08 17:22:00,ff752897f902584273779e7b2cf050ba,0,22,0,6,4,32
10927,1702,2022-11-08 17:27:00,b78d108f853027cb37a5eeb1cf7f7f8e,0,20,0,2,5,27
10928,1702,2022-11-08 17:32:00,f2df3e5e0f6c4dfaf7768f2f246a69f9,0,25,0,3,6,34
10929,1702,2022-11-08 17:36:00,c25b0e4ba9852581d84fab392835da5d,0,20,0,0,7,27
10930,1702,2022-11-08 17:42:00,92c566fc23cc23b067cfd4816afdb201,1,19,1,4,4,29
10931,1702,2022-11-08 17:47:00,af070e72834f01021036fc6afdc14f41,1,18,1,2,10,32
10932,1702,2022-11-08 17:52:00,44ba1369d4521b5003fb332d06ea4d08,0,23,0,1,8,32
10933,1702,2022-11-08 17:57:00,88a11e8256c6f032d692636d6d203f80,0,21,0,1,9,31
10934,1702,2022-11-08 18:01:00,586c5b0d7a884ab6ad6414edc7d3bbfb,1,24,1,3,6,35
10935,1702,2022-11-08 18:07:00,9fd0ca804ec3e970d360cf0dbd942489,0,17,0,2,12,31
10936,1702,2022-11-08 18:11:00,f9ed3d9b11f969dc60085cea2e07b865,0,18,0,0,9,27
10937,1702,2022-11-08 18:17:00,57b75195e08f5d5704fd11c66472c3dc,0,16,1,1,15,33
10938,1702,2022-11-08 18:22:00,1de072cd256466b92b3119f917b37511,0,18,0,1,8,27
10939,1702,2022-11-08 18:27:00,8a8b6f74f91017c6f2db8bacc242c5d5,0,16,1,1,9,27
10940,1702,2022-11-08 18:32:00,1617da8ce35184eaa218108430047201,0,15,0,0,9,24
10941,1702,2022-11-08 18:37:00,d86209b00fb30d2ebe8ce1a08b565623,0,19,0,1,9,29
10942,1702,2022-11-08 18:42:00,18672c35598a6bc3f97527f75ec5dad1,0,25,0,1,7,33
10943,1702,2022-11-08 18:47:00,0e519f04660812f663e644b42b7e1bb6,0,18,1,2,10,31
10944,1702,2022-11-08 18:53:00,e3757e723ec4581a9c1b5f5d621f2ec5,0,17,1,4,6,28
10945,1702,2022-11-08 18:56:00,3beee2f5a0e51f25803a789e05b2dbe3,0,14,0,1,4,19
10946,1702,2022-11-08 19:02:00,76be66499ea77ce2c40ae9d8f569c0c1,0,17,0,0,2,19
10947,1702,2022-11-08 19:08:00,6725bcf3877fed62c79185484b2a199b,0,26,5,0,1,32
10948,1702,2022-11-08 19:11:00,2eb1592fed5114bc7de9b04b5eecc513,0,18,0,0,1,19
10949,1702,2022-11-08 19:18:00,a3daf6aff24f494cb14b0019f153293e,1,25,0,0,0,26
10950,1702,2022-11-08 19:22:00,787d0dc9ff5f2408395183b6ef03c450,0,20,1,0,1,22
10951,1702,2022-11-08 19:26:00,8e56be9a623d13bbfd43186071edebde,0,20,0,0,0,20
10952,1702,2022-11-08 19:32:00,b42cb9f8b64fa5cf7e9c42ffea9f4f96,0,22,3,2,0,27
10953,1702,2022-11-08 19:37:00,9ac22766c58a905d13e43f3b67561829,0,24,0,1,2,27
10954,1702,2022-11-08 19:41:00,26fc4caac925d8e4aa0742ff8cd7ee97,0,20,0,1,2,23
10955,1702,2022-11-08 19:47:00,034bc5e1db609d0f458128fd4bcbbe02,0,24,2,0,1,27
10956,1702,2022-11-08 19:53:00,15447479925720943255836d5cd33e68,0,19,0,1,1,21
10957,1702,2022-11-08 19:56:00,baf5f4dd39ec9bb14e1633356f2dc823,0,16,0,1,0,17
10958,1702,2022-11-08 20:02:00,e9c258f07c36600cdf3e345a49ce5f24,0,16,0,0,0,16
10959,1702,2022-11-08 20:07:00,e54ad9ac761457a955251894cb9016b8,0,15,1,0,0,16
10960,1702,2022-11-08 20:12:00,201fa9af31110bd2dcd020a6fce6d8d6,0,14,0,1,1,16
10961,1702,2022-11-08 20:17:00,a3d49f35b817ba7576487252f3624d50,0,14,4,0,0,18
10962,1702,2022-11-08 20:22:00,6dc50dc821cdbb8f653794f306c7738e,1,22,0,0,0,23
10963,1702,2022-11-08 20:27:00,12b1bb319c17e81fa3f350c9575ca113,0,19,1,0,0,20
10964,1702,2022-11-08 20:32:00,5a3646a44f50f035a30fc2e17a0699cc,0,17,0,0,0,17
10965,1702,2022-11-08 20:38:00,808a7e33dea8786b7d272cc63cea562a,0,8,2,1,0,11
10966,1702,2022-11-08 20:41:00,7d0d6bafffca88f110aed2947cd377cf,0,19,0,0,0,19
10967,1702,2022-11-08 20:47:00,2b332a6466e06c70c4b1d35e5151fbe2,0,15,0,0,0,15
10968,1702,2022-11-08 20:51:00,39cab2bccbab546654afaa189694ccde,1,18,1,1,0,21
10969,1702,2022-11-08 20:57:00,6cebc066b16d57d3a2a1b15390ad4188,0,16,1,1,0,18
10970,1702,2022-11-08 21:02:00,a706a378c192ca47b6ddf2c7b5c3d1f5,0,20,0,0,0,20
10971,1702,2022-11-08 21:07:00,f5a2b8a3e97b75511f019d06ec9a354f,0,17,0,0,0,17
10972,1702,2022-11-08 21:11:00,3de91b96be9b876dbe0ddb2e4125a7a2,0,16,0,0,0,16
10973,1702,2022-11-08 21:17:00,29c241a980cb7fd5bfb60c50ff35930f,0,23,3,0,2,28
10974,1702,2022-11-08 21:22:00,6f59ec180231befcd5a3cfb15c1e041c,0,28,1,1,0,30
10975,1702,2022-11-08 21:26:00,28f1af22e807e9c8ec97fa7f6ef949d1,0,15,0,0,0,15
10976,1702,2022-11-08 21:32:00,38681d878f0561d501398e0377456259,0,17,1,0,1,19
10977,1702,2022-11-08 21:38:00,0c16cb9de900babd9ac694319eb97a8b,0,19,0,0,2,21
10978,1702,2022-11-08 21:41:00,9a8f4efa21e23e1b9fccf45b45bdf2af,0,22,0,0,0,22
10979,1702,2022-11-08 21:47:00,72482a677e5db3a37c895d4d40ed2c10,0,15,1,0,0,16
10980,1702,2022-11-08 21:52:00,b3610ee559f02d0d45d2ca21b7395ef7,0,15,0,0,2,17
10981,1702,2022-11-08 21:57:00,d930112d33e27f489baca8ed67ffc1b9,0,14,1,0,1,16
10982,1702,2022-11-08 22:02:00,9a6a704dfbeb5eb2c74984b034c50770,0,6,0,0,1,7
10983,1702,2022-11-08 22:06:00,65cd8dc2f18fb45dc1711b9839ec8929,0,10,1,0,1,12
10984,1702,2022-11-08 22:12:00,92677ddf39760f4aad460b1469416f26,0,21,0,0,0,21
10985,1702,2022-11-08 22:16:00,64abd65d9f763e3255528572c0e5aa99,0,14,1,1,2,18
10986,1702,2022-11-08 22:22:00,9112d3d270d7de6eb777fb37cfeb69f4,0,9,0,0,1,10
10987,1702,2022-11-08 22:27:00,9be792144461d89d1512643c3991138c,0,15,0,1,1,17
10988,1702,2022-11-08 22:32:00,0008b5ccb27d6fe039b14150b812e878,1,10,1,0,0,12
10989,1702,2022-11-08 22:36:00,583bbbfeed1f8d4741e6d78dec124eb7,0,17,0,1,0,18
10990,1702,2022-11-08 22:41:00,882fb7400a9800670b9579f4c30bd359,0,22,1,0,0,23
10991,1702,2022-11-08 22:46:00,2d876a8b3c208d20fcffa799a524bbdf,0,18,2,0,0,20
10992,1702,2022-11-08 22:51:00,8e7e26b1ded7c48d1352bb89734d1a08,0,8,1,0,0,9
10993,1702,2022-11-08 22:57:00,2b52e9489da84b821a86c1e9d7dd675a,0,7,0,0,0,7
10994,1702,2022-11-08 23:02:00,978e1905eddd50254d48ec7dcb606c87,0,5,0,0,1,6
10995,1702,2022-11-08 23:07:00,fc3e7616b8ed7c113750eba38f31e8a9,0,9,0,1,0,10
10996,1702,2022-11-08 23:12:00,365cb8629b40393d682a8005621bfce6,0,13,0,0,1,14
10997,1702,2022-11-08 23:16:00,3e04c6fa56828ab8b7d5ecc7c9b44508,1,5,1,0,0,7
10998,1702,2022-11-08 23:21:00,de4acccbdfcff0804832f596231d90b3,0,5,0,0,1,6
10999,1702,2022-11-08 23:26:00,f5f42bea5a9e646f9775a59f0c1464f1,0,9,0,0,1,10
11000,1702,2022-11-08 23:32:00,cf09f302ba81143f43b30ffe2eb3dd81,0,2,0,1,0,3
11001,1702,2022-11-08 23:36:00,e4f136ce874b8595065f3c654ef58da2,0,4,0,0,0,4
11002,1702,2022-11-08 23:42:00,a82f1e8f1344017e61451166392b4622,0,7,0,0,0,7
11003,1702,2022-11-08 23:46:00,cedaa4faecd1e4f9229d42e9b46bb3c4,0,6,2,0,0,8
11004,1702,2022-11-08 23:51:00,d0fef960401ee03e5705d690c0c1567c,0,0,0,0,0,0
11005,1702,2022-11-08 23:57:00,77418b3cb0d5ebe6e17b64cfa3ebad14,0,13,1,0,1,15
11006,1702,2022-11-09 00:02:00,5ccd556abd2d8602e6e7faf1340b1828,0,11,0,0,0,11
11007,1702,2022-11-09 00:06:00,65ef1a5516fe8f0c5443b20ab478e9b6,0,5,0,0,0,5
11008,1702,2022-11-09 00:11:00,9d12ce1cdf6aab587f5b1f86f40cda20,0,13,0,0,0,13
11009,1702,2022-11-09 00:22:00,643dcea08b718ba965160300c1b62a69,0,3,0,0,0,3
11010,1702,2022-11-09 00:27:00,e11d04bf52e7b40d9cbb2a66af44bcea,0,6,0,0,2,8
11011,1702,2022-11-09 00:32:00,0f23a7242351e07e6d1fc96276e82ba1,0,9,0,0,0,9
11012,1702,2022-11-09 00:37:00,3dce58ac1a3e9ea4dc2e08d450bdf340,0,13,0,0,1,14
11013,1702,2022-11-09 00:42:00,15c047b625b2cb6d48175a173280a9e7,0,8,0,0,1,9
11014,1702,2022-11-09 00:47:00,9e2c11e8db8dd8a26733acf1267e98b3,0,7,0,0,0,7
11015,1702,2022-11-09 00:52:00,36e7ebff4477975b7fd97a367c8048cc,0,4,0,0,0,4
11016,1702,2022-11-09 00:57:00,a048743ae0d8c2fe85fffd2420981ed5,0,4,0,1,0,5
11017,1702,2022-11-09 01:02:00,15e49e97596a834e94e2817f87944bbb,0,3,0,0,0,3
11018,1702,2022-11-09 01:07:00,99d5ab6036f3e9bcbdc9fb2ecb21d423,0,6,0,0,1,7
11019,1702,2022-11-09 01:11:00,07f263f8a8ca66a8172410ad8122bc63,0,10,1,0,0,11
11020,1702,2022-11-09 01:17:00,262af95ba8b52a9bb1ef3b376057550f,0,3,0,0,0,3
11021,1702,2022-11-09 01:22:00,704c03ef6f4b085be843074aecc6304c,0,4,0,0,1,5
11022,1702,2022-11-09 01:26:00,732cbe3bb76b37d8d00bc7de3bc4b5ef,0,14,0,1,0,15
11023,1702,2022-11-09 01:31:00,6562a8f06300b8ddc9e90a54e3bee2b6,0,9,0,1,1,11
11024,1702,2022-11-09 01:37:00,72155dda00f1b2655d933c773afd99ff,0,5,0,0,0,5
11025,1702,2022-11-09 01:41:00,56e66de4e925a3b2d2e1027b42091602,0,2,0,0,0,2
11026,1702,2022-11-09 01:47:00,0ddf5eace2fef0e34272c28f4d49ebde,0,5,0,1,0,6
11027,1702,2022-11-09 01:52:00,768c5681ce103bb76d145801136a2922,0,8,1,0,1,10
11028,1702,2022-11-09 01:56:00,402fa8b3611b935bd3a228327d5d1eed,0,8,1,0,0,9
11029,1702,2022-11-09 02:01:00,523e5b296fe83796118a038d6738cc40,0,6,0,0,0,6
11030,1702,2022-11-09 02:07:00,5bba43f2f25a22d4601103df9c01071e,0,6,0,1,2,9
11031,1702,2022-11-09 02:12:00,cb652e7386de8aa5effd849310f59d1a,0,6,0,0,2,8
11032,1702,2022-11-09 02:16:00,09e019f2de676fe61ba35b00c012626c,0,9,0,0,0,9
11033,1702,2022-11-09 02:21:00,249ce476b11b4f0859d4aacf05b14265,0,7,0,0,0,7
11034,1702,2022-11-09 02:26:00,861b93cb48fcf114eebfec188e75d300,0,10,0,0,0,10
11035,1702,2022-11-09 02:32:00,0f55a46cbc6791bdf29506af9d7704e5,0,1,1,0,1,3
11036,1702,2022-11-09 02:37:00,b04e9af98f88329407af45f57f38c440,0,6,0,0,1,7
11037,1702,2022-11-09 02:42:00,65ddecbb3a0cd541e8c3f34b7c4af4cf,0,7,0,0,1,8
11038,1702,2022-11-09 02:47:00,84dead1221d0ccd188827a2e5fe1a501,0,5,0,0,1,6
11039,1702,2022-11-09 02:51:00,a878297a201c926ebfcec99dfb4fdada,0,8,0,0,1,9
11040,1702,2022-11-09 02:56:00,1093b0eb0dd1010724870b7f4e26db41,0,3,0,0,0,3
11041,1702,2022-11-09 03:02:00,de2b83113719b31b8d285171882351d5,0,3,0,0,0,3
11042,1702,2022-11-09 03:06:00,1130cb50700c0ebd0f12215d8ee6110e,0,2,0,0,0,2
11043,1702,2022-11-09 03:11:00,73c587e28aa9cb53807279991611c592,0,7,0,0,0,7
11044,1702,2022-11-09 03:17:00,ec17892afe45cc425ef7d4511c3de067,0,10,1,0,0,11
11045,1702,2022-11-09 03:22:00,f264bcee8952b995067fc3ce57601c7e,0,4,2,0,0,6
11046,1702,2022-11-09 03:26:00,22792a4e95d39bd4d61660d87e6fd1d4,0,0,0,0,0,0
11047,1702,2022-11-09 03:32:00,37ff4dc6cceb4aba437e95e17c74288a,0,5,0,0,3,8
11048,1702,2022-11-09 03:38:00,a57a4d642f1b5feaf51d337d82618db6,0,1,0,0,0,1
11049,1702,2022-11-09 03:42:00,51c6e0db6d0ff5e9ba0cca993fd854c7,0,10,0,0,1,11
11050,1702,2022-11-09 03:47:00,b92247d621db85e01fc8d0e0913a9af8,0,4,0,0,0,4
11051,1702,2022-11-09 03:52:00,c22c87ea262653426864d6b90954e595,0,12,0,0,0,12
11052,1702,2022-11-09 03:56:00,44b9e6da4045b5f152ea75b5ade2e695,0,1,0,0,0,1
11053,1702,2022-11-09 04:03:00,11f165460fd7ad1c45722419a98abca0,0,4,0,1,1,6
11054,1702,2022-11-09 04:07:00,8dd76d8e7967e63c66d1cd60d9780aa0,0,3,0,0,1,4
11055,1702,2022-11-09 04:12:00,d9508c3352c63d5044a93c2abc1cc251,0,2,0,0,1,3
11056,1702,2022-11-09 04:17:00,209053a946dbedf714211be62db9844b,0,0,0,0,0,0
11057,1702,2022-11-09 04:22:00,c7cb8d23c06fad8c700b4eb7199084f5,0,6,0,0,1,7
11058,1702,2022-11-09 04:27:00,2b80122e020647be9e8e1a10be63a32b,0,0,0,0,0,0
11059,1702,2022-11-09 04:31:00,51e20f8c54a6661fd55bbcea27628b6a,0,1,0,0,0,1
11060,1702,2022-11-09 04:36:00,fe90b7ecb9448c78eec4eeb8701edd2d,0,0,0,0,0,0
11061,1702,2022-11-09 04:41:00,1740eaed8bfc0191d9c5505e3e3dbdda,0,4,0,0,0,4
11062,1702,2022-11-09 04:47:00,e413c5199821c12b325af3ad97277197,0,6,0,0,0,6
11063,1702,2022-11-09 04:52:00,77013bb2d759f5b289a467a3c99183fd,0,0,0,0,0,0
11064,1702,2022-11-09 04:56:00,b35e1463742afb31e73cbf6ee19355bd,0,0,0,0,0,0
11065,1702,2022-11-09 05:02:00,fa5a5ad2506eb8f60ef8563303eacb4f,0,0,0,0,0,0
11066,1702,2022-11-09 05:06:00,904b7612a3368df1558d854092539b8a,0,1,1,1,0,3
11067,1702,2022-11-09 05:11:00,74e5a86987b1d6b9db80f2795a812232,0,9,2,0,0,11
11068,1702,2022-11-09 05:17:00,deff098dcfa5f6361e7ab63af9ab1224,0,6,0,0,1,7
11069,1702,2022-11-09 05:22:00,34865bfcbc548972e02d9b537dc320d7,0,3,0,0,0,3
11070,1702,2022-11-09 05:26:00,9a172e791347ac3b9f46eb2f900cd727,0,3,0,0,1,4
11071,1702,2022-11-09 05:31:00,2d0851c212ea49590edd30d606eb5cfc,0,7,0,0,0,7
11072,1702,2022-11-09 05:37:00,94f84b4142629363e16eef5d84a59f3d,0,5,1,0,0,6
11073,1702,2022-11-09 05:41:00,e8a735dfeb655203fb69965bdc3ef431,0,6,0,1,0,7
11074,1702,2022-11-09 05:47:00,b9ad139e113e9bffca9dafb8d10b82db,0,2,0,0,1,3
11075,1702,2022-11-09 05:57:00,d7dfd8722a6d0c81706b0120d4a2d94f,0,6,0,0,0,6
11076,1702,2022-11-09 06:01:00,46af9c4fefef004003a633a0e3a04318,0,1,0,0,0,1
11077,1702,2022-11-09 06:07:00,bd49b922a39112ea28d407511fcac5d7,0,3,0,0,1,4
11078,1702,2022-11-09 06:11:00,dd30394d8f8517032a462e24f5a1f113,0,6,0,1,1,8
11079,1702,2022-11-09 06:16:00,209b5ae92fb96604cb315970927d8674,0,4,1,1,1,7
11080,1702,2022-11-09 06:22:00,638766fc1797a4a4fe902c69d885fa07,0,5,0,2,1,8
11081,1702,2022-11-09 06:26:00,ea9911e7e845d6e8822613655a7cb637,0,1,0,0,0,1
11082,1702,2022-11-09 06:32:00,a82cb47ddd873f80f26b13ec5686617c,0,10,0,0,0,10
11083,1702,2022-11-09 06:37:00,e38e12af22518aa103f57550d95a0bdb,0,8,2,0,3,13
11084,1702,2022-11-09 06:41:00,0a80802d16ec23b133b464b38d0180d2,0,16,1,1,5,23
11085,1702,2022-11-09 06:47:00,3ccbedd40afd1ca2e8cb6bde763d2247,0,19,0,1,1,21
11086,1702,2022-11-09 06:52:00,0644de854406f4f7e996a45586f7eed1,0,17,1,3,1,22
11087,1702,2022-11-09 06:56:00,bf0937b38b7e6ace5759ab01d1a8e45f,0,23,0,0,5,28
11088,1702,2022-11-09 07:02:00,017edc7f30576ddfb7a748380559116d,2,14,0,0,10,26
11089,1702,2022-11-09 07:06:00,c1d7c60666ad152ce943e3ebebf6bf08,0,15,0,3,4,22
11090,1702,2022-11-09 07:12:00,2400d6c592d562ff35245b1b203609b9,1,9,0,1,14,25
11091,1702,2022-11-09 07:16:00,2fad10fd77d6e67ef601551c63ac7a50,0,21,0,5,7,33
11092,1702,2022-11-09 07:22:00,0b96ad91624d740c1745822d32cf9338,0,15,0,0,8,23
11093,1702,2022-11-09 07:27:00,201dee7f7e991486ee02f6b36198e483,1,15,0,0,13,29
11094,1702,2022-11-09 07:32:00,208e64a71cb7fee1ca588e380e044402,0,20,0,1,7,28
11095,1702,2022-11-09 07:37:00,4207a3909764716596d979c3ee2df470,0,17,0,1,7,25
11096,1702,2022-11-09 07:41:00,35d2137988bb77f448adfdc00ee1a942,1,10,0,3,13,27
11097,1702,2022-11-09 07:47:00,272afca18d4e83558977e79317d18144,0,14,1,4,8,27
11098,1702,2022-11-09 07:52:00,fde57b985d41cc1fbb46cafde50ad811,0,21,0,1,6,28
11099,1702,2022-11-09 07:57:00,de33492d95c23b95ffa87939aede02ee,0,14,0,5,3,22
11100,1702,2022-11-09 08:03:00,be39d6e20e41f97bf733dd0b14b6314b,1,20,0,3,4,28
11101,1702,2022-11-09 08:07:00,03eb60b78548daf8589f6b1e57af69e5,1,16,0,2,7,26
11102,1702,2022-11-09 08:12:00,14b7453d77293be4a0875446c77d67dd,0,13,0,1,9,23
11103,1702,2022-11-09 08:17:00,fa941f4fe1beba055e5f840cf6e2516f,0,18,0,0,6,24
11104,1702,2022-11-09 08:22:00,020d00b5aa57deaf314e77e9b82726c3,0,17,0,1,7,25
11105,1702,2022-11-09 08:27:00,d8be3c7a9b938932e88cef7a02718023,0,19,0,1,5,25
11106,1702,2022-11-09 08:32:00,22e0b0a19843cf8d53210442aea061fa,1,13,0,0,13,27
11107,1702,2022-11-09 08:37:00,2d47ed956e93068cc8479dde5cf79f12,1,15,0,2,6,24
11108,1702,2022-11-09 08:42:00,1403ef61790d66a2bc7d546ce363ad5b,0,9,0,1,7,17
11109,1702,2022-11-09 08:47:00,757607b2d146b03e93b2e55806313aac,0,12,0,0,4,16
11110,1702,2022-11-09 08:52:00,156298629fb0487cf4a3eca0ed5625c3,1,15,0,1,2,19
11111,1702,2022-11-09 08:58:00,85acdbf8e07e1df686df75dcee5bba9f,0,20,1,0,6,27
11112,1702,2022-11-09 09:03:00,0227e6749525c1a77d6eaa74ca79c78c,0,10,1,1,7,19
11113,1702,2022-11-09 09:07:00,6effa617dfb943b50514718fe0f1c08b,1,10,0,3,7,21
11114,1702,2022-11-09 09:13:00,8adc917a06606bc8ec6daa5e54db5342,0,13,0,0,5,18
11115,1702,2022-11-09 09:17:00,dfe8e0296787f9443efb688f6584de1f,0,17,1,1,6,25
11116,1702,2022-11-09 09:22:00,e1096f1aa7190af86045775b839a9df5,1,16,0,2,9,28
11117,1702,2022-11-09 09:27:00,3401f7061a123a158afcdc54ec32d379,1,17,0,1,11,30
11118,1702,2022-11-09 09:32:00,c8c37a9556c6a7db1c2d13f52bc51154,1,17,2,1,10,31
11119,1702,2022-11-09 09:41:00,a7ed3b7ffb8d868958de37421739707e,0,13,0,1,6,20
11120,1702,2022-11-09 09:47:00,0b146d0ddaa4d2df21b2a4a3bced128a,0,10,0,4,11,25
11121,1702,2022-11-09 09:52:00,0343bdf13ba232783f2308360684c708,0,12,0,4,8,24
11122,1702,2022-11-09 09:57:00,3163586b8254f265c0bba0b1d5e70a40,0,12,0,1,4,17
11123,1702,2022-11-09 10:02:00,828611b6c6279d94a50fdcc5b5318259,1,9,0,1,10,21
11124,1702,2022-11-09 10:08:00,b81d3e9334068595103b771951c4e1fb,1,9,0,3,10,23
11125,1702,2022-11-09 10:12:00,83a23341c170abeb46dc3cd6c4f0a0eb,0,13,0,4,13,30
11126,1702,2022-11-09 10:17:00,87d535970b639e34c28473df0a82a9ee,0,7,0,3,14,24
11127,1702,2022-11-09 10:22:00,7922babe25c7672c7bc5c742d89393e0,0,13,0,1,7,21
11128,1702,2022-11-09 10:27:00,37c1a8b3b02cdf1bd065c98e7b29c606,0,11,0,2,17,30
11129,1702,2022-11-09 10:32:00,9ed2c9a00de6ae3d89d84d9151eb2a13,4,10,0,5,8,27
11130,1702,2022-11-09 10:37:00,817ae74586453855d113828d5dd2877b,2,8,0,1,14,25
11131,1702,2022-11-09 10:42:00,00acee4a67e5eb328caecc528dc629d0,0,16,0,1,8,25
11132,1702,2022-11-09 10:47:00,5d67fe41fd1f62fe2cb56f08110bd8d6,0,14,0,1,10,25
11133,1702,2022-11-09 10:53:00,3f311665ce02daefb1810895a15e1b80,0,15,0,4,9,28
11134,1702,2022-11-09 10:57:00,408ae1bc61f04bfd7b78c38a0f2e3183,2,18,1,4,6,31
11135,1702,2022-11-09 11:02:00,8614b97f82a97b9a1cbff52c5b203e35,0,13,0,2,8,23
11136,1702,2022-11-09 11:08:00,639bb8edef03c803c433a83111c198d3,3,19,0,5,3,30
11137,1702,2022-11-09 11:12:00,47a9a0977913aaa713479e1282316bfc,0,10,0,2,10,22
11138,1702,2022-11-09 11:17:00,da4c59b8702a3c9527f2a9eb357dd84c,0,16,0,2,10,28
11139,1702,2022-11-09 11:22:00,4f00f09b054284a43a4f053f9b4a65eb,2,11,0,0,11,24
11140,1702,2022-11-09 11:26:00,447d7ff70009b6628ebc21ad126b1e77,1,14,0,4,7,26
11141,1702,2022-11-09 11:32:00,d519cb711457d0096c33378a3afc8c0e,0,10,0,0,7,17
11142,1702,2022-11-09 11:37:00,a5bdb8487bbd7948c26323863c9146f7,0,10,1,3,9,23
11143,1702,2022-11-09 11:42:00,4ea5c5f24a063bc884ca31e146e4dc9a,0,13,0,0,7,20
11144,1702,2022-11-09 11:47:00,e4106f7d0e4a91b4f3078d63be0eb0cc,0,5,0,4,9,18
11145,1702,2022-11-09 11:52:00,4705135925c3e22a0c829b2673c32a5b,0,13,0,0,8,21
11146,1702,2022-11-09 11:57:00,cd0a33c9ad2035a85004958163f47dbb,0,11,0,1,11,23
11147,1702,2022-11-09 12:02:00,55ade7c24800b84ffa7b013bbe5a5b89,0,13,0,3,6,22
11148,1702,2022-11-09 12:07:00,37df7ecd47ef0dd57db457d25615c720,0,15,0,5,5,25
11149,1702,2022-11-09 12:12:00,687a2f75da3f195d5beb13ed954fbc59,0,10,0,0,12,22
11150,1702,2022-11-09 12:17:00,ede94e5fdcf90638c939f915e76a8127,0,14,0,1,7,22
11151,1702,2022-11-09 12:22:00,105ed5e1eb76216fa92d6f0cbdddef18,0,12,0,5,7,24
11152,1702,2022-11-09 12:27:00,d1654eac6ca2b7b46a533ec3fb222b4e,0,10,0,1,11,22
11153,1702,2022-11-09 12:32:00,cdb9baf726348d26a017a5e3fb2625ff,0,11,0,1,6,18
11154,1702,2022-11-09 12:37:00,c33b19e36bafbb858aa38f4d27b75dcf,0,10,0,2,11,23
11155,1702,2022-11-09 12:41:00,8e6e8c9b4de332b8553843e73f0354e0,0,10,0,1,10,21
11156,1702,2022-11-09 12:47:00,fb7c1ab3e51ceddf8bebd435f59487c4,2,14,0,0,12,28
11157,1702,2022-11-09 12:53:00,8f7cf6bd5088acb6de4e6189e1820681,0,12,0,4,9,25
11158,1702,2022-11-09 12:57:00,a43b6a92c24b70725ad87f6845a933a9,0,14,0,0,12,26
11159,1702,2022-11-09 13:03:00,c62093b28db1205cde3b57628469b1e4,0,7,0,1,16,24
11160,1702,2022-11-09 13:08:00,68f988cffa66586689f2934c8dd2881c,0,16,0,1,13,30
11161,1702,2022-11-09 13:12:00,a044e3eae3ee06e268a6504ed55cd26c,0,20,0,2,8,30
11162,1702,2022-11-09 13:18:00,95f6f7a3b332af2a22478463cc3b4e04,1,9,0,3,12,25
11163,1702,2022-11-09 13:22:00,86938a5f31cd31beab75713a9fd20449,0,11,0,2,10,23
11164,1702,2022-11-09 13:27:00,e9a1dede90111128c962ddcbd6b372b9,0,12,0,2,12,26
11165,1702,2022-11-09 13:32:00,e12a6dfc349dc1f9134a5d1394e0d648,0,11,0,3,9,23
11166,1702,2022-11-09 13:38:00,7c647342b0777cf24f4212dd7864f237,0,13,0,0,7,20
11167,1702,2022-11-09 13:42:00,32efdb911b5390bdf166ff12dcd7f973,0,10,0,0,15,25
11168,1702,2022-11-09 13:47:00,a2820f3ed664dcf81cc398a519c58672,0,10,0,5,4,19
11169,1702,2022-11-09 13:52:00,ec3808608141d0f51f57247686f2b867,0,13,1,2,18,34
11170,1702,2022-11-09 13:57:00,ef88d2c20b063f00a24fb9f747521919,0,11,0,7,12,30
11171,1702,2022-11-09 14:02:00,bc0c9616a20e4d0e737c5d28f443150e,0,9,0,3,13,25
11172,1702,2022-11-09 14:08:00,3ae21d7e46b80cb7db9e41a1531b5bbb,0,9,1,5,8,23
11173,1702,2022-11-09 14:12:00,b19b1441af9e0efdcd6e08507d980c4a,0,7,2,3,13,25
11174,1702,2022-11-09 14:18:00,da4cea358c43f237fb15961b62c70180,0,10,0,2,12,24
11175,1702,2022-11-09 14:22:00,a30234087f9d1d849063276b173bfe53,0,11,0,3,9,23
11176,1702,2022-11-09 14:27:00,0a1aa2261070a9137d225a20fbef02ee,0,11,0,4,11,26
11177,1702,2022-11-09 14:32:00,f079867f4158030ad61c78ebba387e31,0,13,1,1,14,29
11178,1702,2022-11-09 14:38:00,5cf51d3605253e810fc681917d7b2105,0,8,0,0,14,22
11179,1702,2022-11-09 14:42:00,6be3ba14800c4aa19febb0a7c535c643,0,10,0,3,9,22
11180,1702,2022-11-09 14:47:00,bc855401237eb56eb8dcb29b50df3586,0,12,0,0,13,25
11181,1702,2022-11-09 14:52:00,0d6c8fccca23a6d63efb811eafc9b715,1,12,0,3,7,23
11182,1702,2022-11-09 14:57:00,3a27c4231409df60c08193d4aaa7649b,0,13,0,8,15,36
11183,1702,2022-11-09 15:02:00,9d2fa9d2ec2e831e3e293455d3f5008a,0,10,1,0,7,18
11184,1702,2022-11-09 15:06:00,9a217d7317c7e76722142673036d5a7a,0,9,0,0,12,21
11185,1702,2022-11-09 15:12:00,43f6a370d3defd1464588aa73dffced7,0,11,0,2,14,27
11186,1702,2022-11-09 15:17:00,af2ddae954a486e0cd17cf6796994e4b,0,13,1,1,13,28
11187,1702,2022-11-09 15:22:00,cd0745b0b429f77e6d64a25081199ddd,0,6,0,0,16,22
11188,1702,2022-11-09 15:26:00,c6dd7ea7c0f8dd30ecfdc918baf4f78e,0,15,0,5,12,32
11189,1702,2022-11-09 15:32:00,89e7f53ce7cd6441d3ca7c494c903a29,0,15,1,3,7,26
11190,1702,2022-11-09 15:37:00,7cfdff7c71edb7fa858593341293d1b7,0,15,1,0,15,31
11191,1702,2022-11-09 15:42:00,883d907288d05083cc169c53e55ba489,0,15,0,2,13,30
11192,1702,2022-11-09 15:47:00,c95406426f57feefc549edce37b79782,0,12,0,5,10,27
11193,1702,2022-11-09 15:52:00,f46ad3fb5353cab8be34329f6777384c,0,13,1,4,14,32
11194,1702,2022-11-09 15:57:00,493cb5754cffcea036b4c34c24849804,0,17,0,2,10,29
11195,1702,2022-11-09 16:02:00,d33301345405c83c6a24c314ca3dd6e6,1,13,1,5,8,28
11196,1702,2022-11-09 16:08:00,45979e8d03ea8b73f79462b2aa554178,0,10,0,1,11,22
11197,1702,2022-11-09 16:11:00,6594403f10149ffe287ef7b5f1330e6a,0,12,0,3,13,28
11198,1702,2022-11-09 16:18:00,e2650280e0b25c45254297f97fdb73b8,0,8,0,0,10,18
11199,1702,2022-11-09 16:21:00,e015b113167a46437aa337f0e5a951aa,2,16,1,4,10,33
11200,1702,2022-11-09 16:27:00,51fad1fb2227efda849008761be72b03,0,17,0,3,7,27
11201,1702,2022-11-09 16:32:00,3b6216d4aa5d32bc9b50bbb330fbf0e3,1,17,0,0,13,31
11202,1702,2022-11-09 16:37:00,3840888adc2eb1d73f843e9155c408b4,0,22,1,3,4,30
11203,1702,2022-11-09 16:42:00,206deabbfef041e6708f54f9e6ade91d,0,13,0,2,13,28
11204,1702,2022-11-09 16:46:00,0795fb4722d3e672719cca3915b4cdcb,0,14,0,1,7,22
11205,1702,2022-11-09 16:52:00,adc4bb587fea10e7f61ae8b67ef8f763,0,18,0,2,9,29
11206,1702,2022-11-09 16:57:00,1d62cb66ddf93e1784f55aa2e0ad5d50,1,9,1,0,12,23
11207,1702,2022-11-09 17:02:00,4990130598de4825a62008e5663bf378,0,14,0,2,12,28
11208,1702,2022-11-09 17:07:00,a8ed12b691797d091df59b6512ffdf6e,0,16,1,3,11,31
11209,1702,2022-11-09 17:13:00,92f7a7406257bb0d2d8f82a942d549ff,0,17,0,3,8,28
11210,1702,2022-11-09 17:17:00,4eb4fc27e1b8c6dab1f6bd7df101a852,1,16,0,5,12,34
11211,1702,2022-11-09 17:22:00,220321ba1b3f8a4ec624f90b7ded8948,0,16,0,2,9,27
11212,1702,2022-11-09 17:27:00,886f799395b986ebb936c998346407b0,1,14,0,3,16,34
11213,1702,2022-11-09 17:32:00,b78a468a941b564a3bf8917aa96a62ad,0,15,0,2,7,24
11214,1702,2022-11-09 17:37:00,03d4d3ce01a841ea31359e147b5702aa,2,17,1,4,9,33
11215,1702,2022-11-09 17:41:00,949b98db9fbe91299b3d7149fa20bf4f,0,14,1,5,7,27
11216,1702,2022-11-09 17:47:00,44e5076f54937d648e421a60f6698d32,0,17,0,1,8,26
11217,1702,2022-11-09 17:52:00,374ce0f52b6167e429639b2b3934d034,1,19,3,7,7,37
11218,1702,2022-11-09 17:56:00,a3a64a83fd6b9ec28691d30c3af93cad,0,14,0,1,14,29
11219,1702,2022-11-09 18:03:00,b489570f59e69b144f4b5763dae3d4b6,1,14,0,5,12,32
11220,1702,2022-11-09 18:07:00,2c054ab83eb3f27b31431fa0d7f76cb8,0,22,0,7,8,37
11221,1702,2022-11-09 18:12:00,c9f18b775b5c61cfb2f34f9ddc0f9dc7,1,18,1,6,11,37
11222,1702,2022-11-09 18:17:00,c743f6a6775426e8e3a607cf8c5eca89,0,20,2,3,7,32
11223,1702,2022-11-09 18:22:00,5c3a2ceca9eb4c46151e636891605fc6,0,17,1,3,7,28
11224,1702,2022-11-09 18:26:00,ac60d83a58653e42fcc0a08ba873d522,0,21,0,2,5,28
11225,1702,2022-11-09 18:32:00,54bde7c152b6a723321f6e59c5cbd91f,0,15,0,0,7,22
11226,1702,2022-11-09 18:38:00,1196aedf56a2a1d989bea6d73e19f9ec,0,25,1,0,7,33
11227,1702,2022-11-09 18:41:00,cad89703bbf3c81625001253927bcfea,0,25,0,0,8,33
11228,1702,2022-11-09 18:47:00,7a029653fd850f55e41b5a30ab9e5e51,0,13,0,0,10,23
11229,1702,2022-11-09 18:52:00,05e3a7ce48246c3211b1333725746071,0,19,1,2,4,26
11230,1702,2022-11-09 18:56:00,f131da25cba89150edae1f171d6fd4eb,0,19,0,0,2,21
11231,1702,2022-11-09 19:02:00,0f202539a75b7fbf7ca570e6bd026eae,1,20,0,0,4,25
11232,1702,2022-11-09 19:07:00,a2d346713be6cae41c975565d7ef0af2,0,21,1,2,1,25
11233,1702,2022-11-09 19:11:00,264e548bd4604f2ec47901da2407e0e8,0,10,0,0,2,12
11234,1702,2022-11-09 19:17:00,303c2e4d8d8cbecf231b8526e0eb0bac,0,16,3,2,1,22
11235,1702,2022-11-09 19:22:00,92f73b49afdd989328e80f941d3962a8,0,13,1,1,2,17
11236,1702,2022-11-09 19:26:00,df9f63a6d1ac1399763171b1d258601f,0,16,3,2,1,22
11237,1702,2022-11-09 19:31:00,67491c278be5e380927be323e21cd9e6,0,15,0,1,0,16
11238,1702,2022-11-09 19:37:00,5e900ab0ce5cfc344b7ab766a8c525cd,0,18,2,0,4,24
11239,1702,2022-11-09 19:42:00,0083cc2890e8b35e6131751524f15d1d,0,20,0,0,1,21
11240,1702,2022-11-09 19:47:00,069280ae2768d1d51331c1540f843299,0,24,0,0,4,28
11241,1702,2022-11-09 19:52:00,61b9fabb6f9f1c01267d669c1f5cadbc,0,20,0,2,0,22
11242,1702,2022-11-09 19:56:00,d3412e9ef26611811bbb26848fcbb29a,0,11,2,2,0,15
11243,1702,2022-11-09 20:02:00,e6eeb8b2aeed32fed346dd64e7b10c9c,0,15,1,1,0,17
11244,1702,2022-11-09 20:06:00,e8adca3dedaf3a77c2b33e4813918d8f,1,19,0,1,0,21
11245,1702,2022-11-09 20:11:00,1727acb49e4280d7c9aeec9d9d6ac682,1,20,2,0,1,24
11246,1702,2022-11-09 20:17:00,0f703c5729cfa44140cc52103224ff87,0,17,1,0,0,18
11247,1702,2022-11-09 20:22:00,bc2be50b80385e3580961a9adfbac527,0,19,0,0,0,19
11248,1702,2022-11-09 20:27:00,a55d947a35cc01dc0cb303d4ee5099fe,0,8,1,0,1,10
11249,1702,2022-11-09 20:31:00,cdf428414874bf841b9a6b0785c27f6c,0,28,3,1,4,36
11250,1702,2022-11-09 20:36:00,ff88c4d0e9cbda19ad0269014d955c63,0,14,0,0,1,15
11251,1702,2022-11-09 20:41:00,b7a0c3c9562bc8d92620def4b049ee02,0,26,1,0,0,27
11252,1702,2022-11-09 20:46:00,a378ce91e1d0ff9b6ba91b7fe3e0d445,0,15,1,0,1,17
11253,1702,2022-11-09 20:52:00,d9e80ed53bd8f515e87b5b460aa3c2cd,0,16,2,1,1,20
11254,1702,2022-11-09 20:57:00,8025ff43358e671d56fba5544846288c,0,17,1,0,2,20
11255,1702,2022-11-09 21:02:00,7f79f2ce63ba2c20dea83057edc79945,0,27,0,0,0,27
11256,1702,2022-11-09 21:07:00,8adea81fd2eb9eb8781efddaff66d85d,0,12,2,0,3,17
11257,1702,2022-11-09 21:11:00,89e7593c68456b05812cb8b1d5c09fa2,0,14,0,1,0,15
11258,1702,2022-11-09 21:17:00,4c51902893ff2471a511926be304ac77,0,18,0,0,0,18
11259,1702,2022-11-09 21:22:00,e26702f325e28b55061170578b791674,0,18,2,1,4,25
11260,1702,2022-11-09 21:27:00,2dec8e1246670007feef3a5ec5af6e7b,0,22,0,2,2,26
11261,1702,2022-11-09 21:31:00,0357c271df69c7460f33e225c982a9c4,0,25,0,0,0,25
11262,1702,2022-11-09 21:37:00,382d14f04dfab021a5ee1746a92ee985,0,20,0,0,1,21
11263,1702,2022-11-09 21:42:00,4fd91d43ff6836005cd8f2a93842de2f,0,24,0,0,0,24
11264,1702,2022-11-09 21:48:00,966944fc3b71a8fef134cfc3d74c55b8,0,15,0,0,0,15
11265,1702,2022-11-09 21:53:00,9e34a90c0b59bcacd2480aea980e908e,0,13,1,0,0,14
11266,1702,2022-11-09 21:56:00,9276b729ec1dfa0d8d0e4378fe2365cd,0,10,0,2,1,13
11267,1702,2022-11-09 22:02:00,f008fa6d9ad3ce485150182761e5bf0f,0,15,0,0,1,16
11268,1702,2022-11-09 22:07:00,d0f33d75a509f0812e7bbed41a3791d6,0,17,1,0,0,18
11269,1702,2022-11-09 22:11:00,c4aae3f3c92ade015d8bb3ce76564b08,0,19,1,0,0,20
11270,1702,2022-11-09 22:17:00,f9106a59c457a352ec2499763e7d81c0,0,13,1,1,1,16
11271,1702,2022-11-09 22:22:00,61b992b009f5ce7a02032c7c25698d1c,0,9,0,0,0,9
11272,1702,2022-11-09 22:27:00,4795a069fa965cca7c63f18b6e0e2cf1,0,11,2,0,3,16
11273,1702,2022-11-09 22:32:00,5c07c11fbc22a21cb6a481492eac0432,0,15,1,0,0,16
11274,1702,2022-11-09 22:37:00,e904ccaabf90788e3db05e9788f04532,0,10,0,0,1,11
11275,1702,2022-11-09 22:41:00,66ed51badd452b92b0bff35fbf4f62de,0,5,0,0,0,5
11276,1702,2022-11-09 22:48:00,9e0fb8b5cd9dbbd896b25a9450c6bc2b,0,9,1,0,2,12
11277,1702,2022-11-09 22:52:00,01cfd5a8284652449592295021c7f389,0,8,0,1,1,10
11278,1702,2022-11-09 22:57:00,a24107b6f7ee832d0839bdbffb14648f,1,12,0,0,1,14
11279,1702,2022-11-09 23:02:00,e12cb588e53c503fa4e981aeeb172b92,0,12,0,0,0,12
11280,1702,2022-11-09 23:07:00,4f08000e104e27adbdfc26e80d3f883a,0,7,0,0,0,7
11281,1702,2022-11-09 23:12:00,1ba4e6fc39042175f8d0b18a94274446,0,10,0,0,2,12
11282,1702,2022-11-09 23:17:00,28866db16368d04535c0e8c66a594119,0,13,0,0,1,14
11283,1702,2022-11-09 23:22:00,cab90c271385e08f8a288d39b778ee12,0,7,2,0,1,10
11284,1702,2022-11-09 23:26:00,a8642e7b5e80bdf8cd6269df41b3f01b,0,10,2,0,0,12
11285,1702,2022-11-09 23:32:00,6323f88a84a59c97f67b2ac7a0f24e69,0,9,1,0,0,10
11286,1702,2022-11-09 23:37:00,e08a24da5b8d669735fc0f67b0115621,0,20,1,1,0,22
11287,1702,2022-11-09 23:42:00,11eb1de620be4ea4ed1b6aa7f0f624af,0,7,0,1,0,8
11288,1702,2022-11-09 23:47:00,7ec68e85c529322c4aeaaf42370e17e4,0,13,0,0,0,13
11289,1702,2022-11-09 23:52:00,a090fcbc4957f4fa5cd9b756fe65c85d,0,15,0,0,1,16
11290,1702,2022-11-09 23:56:00,c3db0e2b19ab1bf0ea63e32842ef172e,0,3,0,0,0,3
11291,1702,2022-11-10 00:02:00,0e72dbb579dbab17f61db4ac99f6c875,0,2,0,1,0,3
11292,1702,2022-11-10 00:09:00,b74f7617a38838156a0e78c90432abed,0,6,0,1,0,7
11293,1702,2022-11-10 00:12:00,cfea4d43dd254832d353cdf0f33178ea,0,5,0,0,1,6
11294,1702,2022-11-10 00:17:00,2dc20abfadd1d97e6ed010ea22176afc,0,8,2,0,0,10
11295,1702,2022-11-10 00:22:00,402400725e539301f0284336055c18fc,0,8,0,0,1,9
11296,1702,2022-11-10 00:26:00,4ec2eb37c4dda18a2cf036120af4e456,0,12,0,0,0,12
11297,1702,2022-11-10 00:32:00,5d90fc4515c20373a8c399e1d75cc58f,0,13,3,1,1,18
11298,1702,2022-11-10 00:37:00,9653ab341bfb3d7ec30af02f7f5cdee9,0,6,1,0,2,9
11299,1702,2022-11-10 00:41:00,87e57ccb2369224948c9e84bc4daff41,0,11,2,0,1,14
11300,1702,2022-11-10 00:47:00,785798c916eb27121f357d17be234dc5,0,11,0,0,1,12
11301,1702,2022-11-10 00:52:00,af893e04d0a6aeaa7b6b1b39a54e774f,0,7,0,1,1,9
11302,1702,2022-11-10 00:57:00,a8d4fe7e292267075671c63acbfaf99e,0,8,0,0,1,9
11303,1702,2022-11-10 01:01:00,d9ea020fbefce14c82bee00b0a92ad7f,0,12,0,0,0,12
11304,1702,2022-11-10 01:06:00,34c12860082aa2a471019cffb3915aa0,0,8,0,0,0,8
11305,1702,2022-11-10 01:12:00,c37fd3c1a6a5650d14c3cec806842aea,0,10,0,0,0,10
11306,1702,2022-11-10 01:17:00,0f1eff4354fe3073fdfd4260d562f349,0,7,0,0,3,10
11307,1702,2022-11-10 01:22:00,881496ee995a94e0ab624329954c8f0d,0,8,0,0,0,8
11308,1702,2022-11-10 01:26:00,d430e5f97a129c0670c08ad6124cc0e3,0,10,1,0,0,11
11309,1702,2022-11-10 01:32:00,29a688c096da7f46f40e8e1ec186a8fd,0,6,1,0,1,8
11310,1702,2022-11-10 01:37:00,d1fe1be8afbf534d70426cd7074fc72f,0,14,0,0,1,15
11311,1702,2022-11-10 01:42:00,b63ea85603972be58865811edeab8e2b,0,3,0,0,0,3
11312,1702,2022-11-10 01:47:00,41eb310f951c967ce129528e85c12849,0,4,0,0,0,4
11313,1702,2022-11-10 01:52:00,db6ade89a9e747cd83680cfc7130b4e9,0,12,0,0,0,12
11314,1702,2022-11-10 01:57:00,2da39598fb48c0f9f11d4748d8ff6608,0,7,0,0,1,8
11315,1702,2022-11-10 02:02:00,c9f8175e2785f97a6538b6d054681527,0,3,2,1,0,6
11316,1702,2022-11-10 02:06:00,77091390aa97d46ada16963827622197,0,8,1,0,0,9
11317,1702,2022-11-10 02:11:00,5d9cb5066ccfe0c712620b78fd5fb86d,0,1,1,0,0,2
11318,1702,2022-11-10 02:16:00,2633eed4824097dee40486e5d54a057b,0,4,0,0,0,4
11319,1702,2022-11-10 02:21:00,97007c86c67da0f642bdbc8949fc0824,0,6,0,0,0,6
11320,1702,2022-11-10 02:26:00,50cea5440f807367ae454625b20e9d93,0,4,0,1,0,5
11321,1702,2022-11-10 02:31:00,8e4335f04f1b692da909ef1a87277e77,0,5,0,0,0,5
11322,1702,2022-11-10 02:37:00,866f38232f15f1d7f76072336629e3b0,0,14,0,0,0,14
11323,1702,2022-11-10 02:41:00,8ae50f11d2b58b224805cfd2d8303fd1,0,5,0,0,0,5
11324,1702,2022-11-10 02:47:00,a6640c1048147c7bbcd21de34b26353f,0,1,2,0,0,3
11325,1702,2022-11-10 02:52:00,7370621e40538ade3bd5b9052d626d32,0,5,0,0,0,5
11326,1702,2022-11-10 02:56:00,2823ebc0fff02d1a5d1f3aec2c4e97df,0,5,0,1,0,6
11327,1702,2022-11-10 03:01:00,504aa589db8e88d9be2af131510ca4f3,0,3,0,0,1,4
11328,1702,2022-11-10 03:08:00,ec912763001bbb2e4a55b72927cf76bb,0,0,1,1,0,2
11329,1702,2022-11-10 03:11:00,e95caf549cae83c13dd5d13cc384dabe,0,4,0,0,0,4
11330,1702,2022-11-10 03:16:00,76d3d2f20805c9d944bfafe550f858a7,0,1,0,0,0,1
11331,1702,2022-11-10 03:22:00,07016affcbfbc3ba668a9464d80e330c,0,0,0,0,0,0
11332,1702,2022-11-10 03:26:00,2779db108b619777a918ef4262a0935b,0,3,0,0,0,3
11333,1702,2022-11-10 03:32:00,f84ef645f62868001923c3250b596428,0,1,0,0,0,1
11334,1702,2022-11-10 03:38:00,c20325240df24ae55094ddeb15731420,0,0,0,0,0,0
11335,1702,2022-11-10 03:41:00,776008932b1ff47d5a853a68fc09d390,0,2,0,0,0,2
11336,1702,2022-11-10 03:47:00,c11ef4ba28bbd7b688cc03e6ced38cfd,0,0,0,0,0,0
11337,1702,2022-11-10 03:52:00,863a0e8537a031487fbcf904293c0a0b,0,1,0,0,0,1
11338,1702,2022-11-10 03:57:00,999cb7cb5413b70b4f6f0dd1faf00750,0,0,0,0,0,0
11339,1702,2022-11-10 04:02:00,39844211bf1d17f6efe3a5198fdd89e8,0,1,0,0,0,1
11340,1702,2022-11-10 04:06:00,a4e27d498b77ed2c914d37ce016af886,0,1,0,0,0,1
11341,1702,2022-11-10 04:12:00,1a68bd64c31d7a47fb22493476d3d1f8,0,2,0,0,0,2
11342,1702,2022-11-10 04:17:00,814ebf80d039865ca69b00f8b908ae66,0,1,0,0,0,1
11343,1702,2022-11-10 04:22:00,29eb31248e94f998db978eee9ec5a109,0,0,0,0,0,0
11344,1702,2022-11-10 04:26:00,59339916f78b03fe2a4cfad2a2388c18,0,0,0,0,0,0
11345,1702,2022-11-10 04:32:00,a994addcc19b1dfe8ae81be62f9a8837,0,1,0,0,0,1
11346,1702,2022-11-10 04:38:00,23b03e2bff0b1e4b10ac32deb6275363,0,0,0,0,0,0
11347,1702,2022-11-10 04:41:00,e395c048b26d98135c1e4e7d65674df4,0,2,0,0,0,2
11348,1702,2022-11-10 04:47:00,e61f146be4e17c26db01bb2d75404876,0,0,0,0,0,0
11349,1702,2022-11-10 04:51:00,b32debc346b363ccd5d0becc73de9293,0,0,0,0,0,0
11350,1702,2022-11-10 04:57:00,d4ad5104d9194342166ec9ac2cadbbd9,0,0,0,0,0,0
11351,1702,2022-11-10 05:03:00,bc6007f0ea48eaee9df28edfda57821e,0,0,0,0,0,0
11352,1702,2022-11-10 05:07:00,d33f158a00b555bf7e8e5fc791bfa9fe,0,1,0,0,0,1
11353,1702,2022-11-10 05:12:00,8e9cf0780d9ccd91728a4cff2d8b5453,0,1,0,1,0,2
11354,1702,2022-11-10 05:17:00,c0a55c7a99ba8933d6ac508a23f42a97,0,4,0,0,0,4
11355,1702,2022-11-10 05:22:00,e8533be9c7bf0cd0a5d4fad00508ad6e,0,0,0,0,0,0
11356,1702,2022-11-10 05:27:00,fd41984323f9f07694bc6a0b34b22479,0,1,0,0,0,1
11357,1702,2022-11-10 05:32:00,3b9e599575189f237c1e55cd5f554a44,0,0,0,0,0,0
11358,1702,2022-11-10 05:37:00,9ab8d2b9d78f1d5bebb73f65923af574,0,2,0,0,0,2
11359,1702,2022-11-10 05:42:00,7cafc8b5bba03f749407a8177f7b9bda,0,1,0,0,0,1
11360,1702,2022-11-10 05:47:00,c7b912b24d6ff498026110bdae3d1a80,0,0,0,0,0,0
11361,1702,2022-11-10 05:52:00,a83720319071a8cb0764ce69adb43a8f,0,0,0,0,0,0
11362,1702,2022-11-10 05:57:00,5f6a29d13241e7d395d459f7e7221987,0,2,0,0,0,2
11363,1702,2022-11-10 06:02:00,7bc40e143bc2ea111d90abf3a8db37f1,0,5,0,0,0,5
11364,1702,2022-11-10 06:07:00,81d441919eff59a8b0ecbbd31ff86186,0,2,0,0,0,2
11365,1702,2022-11-10 06:12:00,dfb0d37b801154b75f3c41ef323d1572,0,0,0,0,1,1
11366,1702,2022-11-10 06:17:00,533527c302de204644c8eb13f9983069,0,0,0,0,0,0
11367,1702,2022-11-10 06:22:00,881fa9bbb1108773144b51468aadc3bd,0,0,1,1,0,2
11368,1702,2022-11-10 06:26:00,1c6b85d5d2f9c0fa82098a880f75e2c0,0,13,0,0,0,13
11369,1702,2022-11-10 06:32:00,d6120a7499d771ab5abf483f6f472318,0,7,0,1,1,9
11370,1702,2022-11-10 06:37:00,5cda3009e6853c123cd217910a031616,0,9,0,0,0,9
11371,1702,2022-11-10 06:41:00,825e38f95739447ee127d18245dc3b66,0,4,0,0,0,4
11372,1702,2022-11-10 06:47:00,958a9e5152d85abe2302887901292371,0,9,0,0,0,9
11373,1702,2022-11-10 06:52:00,81989a1024479de4606a93781177be7f,0,6,0,0,1,7
11374,1702,2022-11-10 06:56:00,8084ee54cf00f52656d301f943500cac,0,13,0,0,1,14
11375,1702,2022-11-10 07:02:00,e62d1dde0ba7f982392abb99fa75dd02,0,12,0,5,0,17
11376,1702,2022-11-10 07:08:00,264a572f40527ea7fe6b3ad46254542a,0,13,0,4,1,18
11377,1702,2022-11-10 07:12:00,a70a6b70fd0e5d4142a5f1ede8dde164,0,16,0,0,1,17
11378,1702,2022-11-10 07:18:00,325263dc3071578c968f08eeeb7a44b6,0,19,2,1,5,27
11379,1702,2022-11-10 07:23:00,7a43dfa9b8dde7d687a2cff3790fa956,0,25,0,1,0,26
11380,1702,2022-11-10 07:26:00,8d8a866c455f890a19205f67d8ffc321,0,14,0,2,4,20
11381,1702,2022-11-10 07:37:00,81eec149d00c92298c4eb0d6a484d97e,0,17,0,1,6,24
11382,1702,2022-11-10 07:42:00,b3546a2ef240acfac3576b8c0bfc1403,0,13,0,0,12,25
11383,1702,2022-11-10 07:48:00,b464a32103178d14722a722cd82c822b,0,15,1,0,11,27
11384,1702,2022-11-10 07:51:00,604672bd272d01357dfdd0b5e66d89e1,0,24,0,0,4,28
11385,1702,2022-11-10 07:57:00,d6b8bbbd357415b91e277d6342b85c96,1,14,0,3,5,23
11386,1702,2022-11-10 08:03:00,e569c097ed16b9dcf000f8a6ece82c78,0,22,0,2,11,35
11387,1702,2022-11-10 08:07:00,d42213e18417b3ca72d6a38704adb942,0,17,0,4,3,24
11388,1702,2022-11-10 08:11:00,3e5edf773c047c2772fd70e3b294dad3,0,12,0,4,11,27
11389,1702,2022-11-10 08:18:00,9760e5a0010c4be00b46237ffac0c169,0,19,0,1,10,30
11390,1702,2022-11-10 08:22:00,5553486585b855ae24c5b68c1a3b3594,0,8,0,1,10,19
11391,1702,2022-11-10 08:26:00,52176b8be124549c7cd0182971e72944,1,17,1,1,6,26
11392,1702,2022-11-10 08:33:00,7139cd0119a7e8236736185f7b5f897d,0,7,0,0,14,21
11393,1702,2022-11-10 08:38:00,33fa77a66a11722352a8272f9bf91325,0,16,0,1,8,25
11394,1702,2022-11-10 08:42:00,3e7730b9e88236282b518166e0843c1b,0,12,1,0,13,26
11395,1702,2022-11-10 08:47:00,43ad6d170cbfad9ee5ad998adcfcfaa8,0,11,1,4,12,28
11396,1702,2022-11-10 08:53:00,60b2d2a8a3cc9438ad8bef5208a254c3,0,23,0,4,11,38
11397,1702,2022-11-10 08:56:00,9896b5c7d0aac2519afb79fdf0c9ede8,0,19,0,1,19,39
11398,1702,2022-11-10 09:02:00,c8d31ed704a6fb077c9b4fa875fa79d9,4,23,0,3,7,37
11399,1702,2022-11-10 09:07:00,9a9b37e8caf0b800a97e2490d28eef5e,0,17,1,3,8,29
11400,1702,2022-11-10 09:11:00,3cbb9f174c3dc1e04a059a814fadc5c9,0,6,0,3,15,24
11401,1702,2022-11-10 09:18:00,4368816db9c153f78c4d13d45cbd1fd1,0,17,0,3,11,31
11402,1702,2022-11-10 09:23:00,45cde304767151156f34502f5f598d27,0,15,0,1,10,26
11403,1702,2022-11-10 09:27:00,ad678daab38a345a81e67b7ebee09147,0,17,1,1,8,27
11404,1702,2022-11-10 09:32:00,386da85d4b056ad54c0f8ae6a6a5a314,1,9,0,2,13,25
11405,1702,2022-11-10 09:37:00,aed456dc7d0560aa3610e71da512083d,0,14,0,2,9,25
11406,1702,2022-11-10 09:42:00,b9d9540ba8d1230725a21523a34b0564,0,13,2,4,8,27
11407,1702,2022-11-10 09:47:00,3775e70ca0d0a87669d054d47de487b8,0,13,0,5,5,23
11408,1702,2022-11-10 09:52:00,cb2850a5a8de037b52deda34ca6dc642,0,8,0,1,12,21
11409,1702,2022-11-10 09:58:00,d134d6aa63a1e6a4bd028fd26d98817d,0,11,0,2,13,26
11410,1702,2022-11-10 10:02:00,7f0447426537f87ab20b5c4ed3f39911,2,15,0,6,11,34
11411,1702,2022-11-10 10:07:00,04a8d267af8de4a64da84831e5a7deda,0,10,0,2,10,22
11412,1702,2022-11-10 10:12:00,22faa6a17115f6e49eaa380cc025e4f0,1,11,0,1,15,28
11413,1702,2022-11-10 10:18:00,e82ba36b8a433c3aae6dcd657f3bffb1,0,17,0,5,6,28
11414,1702,2022-11-10 10:23:00,82efaee99225a8dfb2d237d1d2631f67,1,14,0,0,11,26
11415,1702,2022-11-10 10:27:00,b6ba48c046292dfd344aa2e93e7158de,0,11,1,6,10,28
11416,1702,2022-11-10 10:32:00,7aedfa2b7c65cdbe65583332e791d992,0,11,0,4,11,26
11417,1702,2022-11-10 10:38:00,98dc70a1544eadd1489a7edb388a1c68,0,14,0,5,11,30
11418,1702,2022-11-10 10:42:00,caf3414e2c85b570e255ebfa062ebafe,0,13,0,0,18,31
11419,1702,2022-11-10 10:47:00,ce0580fcedbcdd3457ae1dc3b650d9ec,1,10,0,3,13,27
11420,1702,2022-11-10 10:52:00,747741f0b152a81884cc8e4c13f8578d,0,13,0,3,19,35
11421,1702,2022-11-10 10:58:00,8538fd4ceb1167b041dbb6251eb52249,4,12,0,3,7,26
11422,1702,2022-11-10 11:03:00,a54ac369f520e01899535904e5fba1c8,0,13,1,3,12,29
11423,1702,2022-11-10 11:07:00,bfbbad5a24134c7fd0794622b09e3ba6,0,12,0,6,10,28
11424,1702,2022-11-10 11:12:00,d42e4b213c00757a6f0d6cb753ff3c4b,0,15,0,1,10,26
11425,1702,2022-11-10 11:17:00,cf1959df9fe7596da2d947e702e10443,0,17,0,4,8,29
11426,1702,2022-11-10 11:22:00,6f4bf0394d031ca344d258df17d676ee,0,11,0,2,15,28
11427,1702,2022-11-10 11:26:00,308e32da55ef505493362c7991a22574,0,11,0,3,11,25
11428,1702,2022-11-10 11:31:00,3ea01d63117806e7557b08092ec219aa,0,16,0,4,12,32
11429,1702,2022-11-10 11:38:00,65a2580e240b592542d0a375acee5916,0,8,0,3,10,21
11430,1702,2022-11-10 11:41:00,ef285d2e3a21cac864829aa65b009af2,0,20,0,0,6,26
11431,1702,2022-11-10 11:47:00,5321fb68dd8ba8a54503991a0de7adeb,0,10,1,4,11,26
11432,1702,2022-11-10 11:52:00,6037e6035c6b40dba0f20109823ae20f,0,14,1,3,11,29
11433,1702,2022-11-10 11:57:00,b26baa28730c19855927340b58e58231,0,16,0,12,7,35
11434,1702,2022-11-10 12:02:00,83c6e71c2a191e5debbc8e0d17b2781b,0,13,0,3,7,23
11435,1702,2022-11-10 12:07:00,f03c7de336c607d29c902b1370686e94,0,11,1,3,9,24
11436,1702,2022-11-10 12:12:00,8b9c67efeb3c1d63d3defcfc2519593a,0,13,0,5,8,26
11437,1702,2022-11-10 12:17:00,830270aade4f37bf3a8e515f9a319913,0,6,0,1,14,21
11438,1702,2022-11-10 12:23:00,1900ee0e6beda38a30de463c12aab34a,0,6,0,1,10,17
11439,1702,2022-11-10 12:27:00,99be3f30bd4729da835474830d0bba39,0,11,0,5,5,21
11440,1702,2022-11-10 12:32:00,dfb020c9ce0923f548701b352f42f191,0,13,1,2,4,20
11441,1702,2022-11-10 12:42:00,83f49696acd7d808d2347873f42ae711,0,13,0,4,6,23
11442,1702,2022-11-10 12:47:00,17a7490183d27c831991e2ebe1cf2a4a,0,13,0,4,13,30
11443,1702,2022-11-10 12:52:00,32b1ce5a501c60254dbd31472a214080,0,18,0,3,5,26
11444,1702,2022-11-10 12:56:00,45494275c45bf04462457aa9b7dd3eba,0,22,0,1,7,30
11445,1702,2022-11-10 13:02:00,49a47a992052a0cfd97b2ce1ced24afb,0,20,0,4,4,28
11446,1702,2022-11-10 13:07:00,3808d32ac97b5549c25614eef7fdada3,0,16,2,1,14,33
11447,1702,2022-11-10 13:12:00,f0b5b8bcc0ca8f51c2266d2b0a316b6e,0,11,0,2,9,22
11448,1702,2022-11-10 13:17:00,ed66b10d03db00c2f1a20c31b61869a4,0,15,1,6,8,30
11449,1702,2022-11-10 13:22:00,449d8a6b7e0de436024422e78b3b65b9,0,16,0,3,5,24
11450,1702,2022-11-10 13:27:00,e49c0f61f9e200080ca72775b5675d02,1,8,0,3,12,24
11451,1702,2022-11-10 13:32:00,4aa9a8f1f08030608f5ee423f7bfd217,0,13,0,3,13,29
11452,1702,2022-11-10 13:38:00,298c9856b14b8b3087003769375231f2,0,16,0,3,10,29
11453,1702,2022-11-10 13:43:00,fe4668e1d93e105a3737c1d58d07a8a4,0,19,0,0,10,29
11454,1702,2022-11-10 13:47:00,f727fd72cad8e00636ae7434ac62eca2,1,12,0,3,8,24
11455,1702,2022-11-10 13:52:00,e75cd367eea4e87f8f3cf017ca6bbad2,0,9,0,3,11,23
11456,1702,2022-11-10 13:57:00,f043ff1383bdb73ff8560b81be5f4ea9,0,8,0,1,17,26
11457,1702,2022-11-10 14:03:00,d70db1d9a00aa11aba3ea4e2e3a65f42,0,8,0,10,12,30
11458,1702,2022-11-10 14:08:00,439375452f6145fa39f1f2a662d972e9,2,9,0,0,17,28
11459,1702,2022-11-10 14:13:00,2ea304876fa90cb155527443e01b75aa,0,17,0,6,7,30
11460,1702,2022-11-10 14:17:00,069c5510afed80cf59f74a4712fedea3,0,10,0,6,10,26
11461,1702,2022-11-10 14:22:00,b0506e7acb4cfa94b6773e4d9f334525,0,9,0,2,6,17
11462,1702,2022-11-10 14:27:00,76b15e16e3bfaa5ce2e363cc2132f10e,0,12,1,2,12,27
11463,1702,2022-11-10 14:32:00,a7ef9d896032fdd85c4bf7498fd4ed7c,0,16,1,1,10,28
11464,1702,2022-11-10 14:37:00,6e602d4823ed946fceafe680dca1dac7,0,12,0,6,9,27
11465,1702,2022-11-10 14:42:00,bb2f99d4cb2fe4bde40acf8956123bc8,0,17,0,3,10,30
11466,1702,2022-11-10 14:47:00,d6fbcc9c27591fcc59661b9b4b84ef0f,1,7,0,1,15,24
11467,1702,2022-11-10 14:52:00,ec34cdac899f1743302be75befcc8b27,0,17,0,5,6,28
11468,1702,2022-11-10 14:57:00,724683abfbcac75786760e26fff3f859,0,12,0,2,11,25
11469,1702,2022-11-10 15:03:00,61ff76f8118433eda0385e1e107c0b27,0,12,0,0,10,22
11470,1702,2022-11-10 15:08:00,d3d96069ad4cd12a72a2f81e847754e5,0,12,1,1,11,25
11471,1702,2022-11-10 15:12:00,82d7667389ab5d04d5d7be14ae686e40,1,15,0,0,10,26
11472,1702,2022-11-10 15:17:00,82dde1fb12de701631f120e3d2922815,0,16,0,0,10,26
11473,1702,2022-11-10 15:22:00,ef9609e9e7bc45fa3d4fb552864a30c7,0,11,0,1,12,24
11474,1702,2022-11-10 15:27:00,ae67a9ac4e6a9d05a4f16591fe74fe60,1,19,0,1,7,28
11475,1702,2022-11-10 15:32:00,614330d9fbfaef56d7084d8b75284eba,1,16,0,2,5,24
11476,1702,2022-11-10 15:37:00,70ad9fbf9aa4987a06289ea2b9ce7d06,0,20,0,7,9,36
11477,1702,2022-11-10 15:43:00,451dfc0c008fdfeb390eda6d42c51989,2,24,0,0,10,36
11478,1702,2022-11-10 15:47:00,b2d7fe060dfbe0f2c6484bb812baabae,1,17,0,2,7,27
11479,1702,2022-11-10 15:53:00,43b37204df5693f878bf3f6c24ad4886,0,22,0,2,5,29
11480,1702,2022-11-10 15:57:00,d44bfebd85c907377b3faef8ebfcb87f,0,16,0,7,7,30
11481,1702,2022-11-10 16:02:00,45893f1aab7384fb65aeb987f553259d,0,19,0,8,5,32
11482,1702,2022-11-10 16:08:00,d016f909e897e091af71fb448cab7f8b,0,21,0,3,3,27
11483,1702,2022-11-10 16:12:00,f27746675b01bcf9a6f57fd317f6a21e,1,21,0,7,7,36
11484,1702,2022-11-10 16:17:00,e49c5fe12d1f2bdb6a2c5f81ed821599,0,16,0,7,8,31
11485,1702,2022-11-10 16:22:00,648b4a518f127ddd97118773e088ddae,1,19,1,6,9,36
11486,1702,2022-11-10 16:27:00,71f439e1b8c0b45585b43e1ffa46710d,0,22,0,4,9,35
11487,1702,2022-11-10 16:32:00,bb3dfdda67f625d27ce47a34f1f9fdb9,0,15,0,4,12,31
11488,1702,2022-11-10 16:38:00,2794cb5ce9593793328dc28035f871e3,0,21,0,2,11,34
11489,1702,2022-11-10 16:42:00,8941a73bcc9dbffd7d6180183e7e4511,0,18,0,4,11,33
11490,1702,2022-11-10 16:47:00,8c4371eb5b1792ed2f2681a12e5993ee,0,13,0,6,10,29
11491,1702,2022-11-10 16:53:00,42ae862984e211862802084cfcf1c9c3,0,14,0,3,15,32
11492,1702,2022-11-10 16:58:00,268040e6022a9b8fa2ae260551e47707,0,14,0,6,12,32
11493,1702,2022-11-10 17:02:00,223c2f1bf8542fc0e59a947e00f5c85f,0,16,0,2,10,28
11494,1702,2022-11-10 17:08:00,eb67148ca95cc994bc9b1223d2a77a07,0,11,0,9,9,29
11495,1702,2022-11-10 17:13:00,18158a09490dac2c9f5a9b10f3d42e4e,0,19,0,2,8,29
11496,1702,2022-11-10 17:17:00,06181879cbdb67f5d5632b54048e30f2,2,16,1,5,8,32
11497,1702,2022-11-10 17:22:00,6442a914a32639cfda76b05d3d798da1,0,18,0,6,8,32
11498,1702,2022-11-10 17:28:00,601437409f12cf0d62fc7a4f36ebe7af,0,15,1,3,12,31
11499,1702,2022-11-10 17:32:00,be88eed8c45b6c558ff41dd557c9bbd3,0,14,0,6,10,30
11500,1702,2022-11-10 17:38:00,deb2926036f32e18907509726351c47b,2,16,1,8,8,35
11501,1702,2022-11-10 17:43:00,dd2010a3009b2403fd7575774e940260,0,15,1,0,17,33
11502,1702,2022-11-10 17:47:00,c32f7a700a1cfc4b48a250467bdbefca,0,17,0,8,7,32
11503,1702,2022-11-10 17:53:00,856ba85418941c78e0cfd46392c1c08e,0,14,1,6,6,27
11504,1702,2022-11-10 17:57:00,06fcf6a55bb73f67a5de3000fd9fa4df,1,14,0,3,9,27
11505,1702,2022-11-10 18:02:00,b73488789105472f569413132dfdad76,0,21,0,4,9,34
11506,1702,2022-11-10 18:07:00,dcb1aee6b2cc6a300229a2e6d77be83f,0,7,0,1,9,17
11507,1702,2022-11-10 18:13:00,ef54b70cb83fac052df2744c34870871,1,17,0,3,14,35
11508,1702,2022-11-10 18:17:00,41f3b67c7fec6993b371e596ae835eda,1,17,3,0,8,29
11509,1702,2022-11-10 18:22:00,9d42525605ae04b96f234cf2acffe7d1,0,15,0,0,8,23
11510,1702,2022-11-10 18:27:00,ccf86d4d7c54ab77f37db782ca6d1b7d,1,18,0,4,9,32
11511,1702,2022-11-10 18:32:00,62222344942fbb9bbb7cf02c4368256f,0,24,1,0,4,29
11512,1702,2022-11-10 18:37:00,54e7b52af0e8de7b80fcf40355da798e,1,22,1,0,9,33
11513,1702,2022-11-10 18:41:00,a30f1dee76a752866428da0232ebbb25,0,26,0,0,7,33
11514,1702,2022-11-10 18:48:00,fc4ecd21570e24d6b75189cfbe637152,0,20,0,0,4,24
11515,1702,2022-11-10 18:52:00,6c45e1b1e2a7e458e910753527623476,0,22,0,1,4,27
11516,1702,2022-11-10 18:57:00,db0366bba0fa00c3e8a3248b9cbc2c2b,2,19,2,1,4,28
11517,1702,2022-11-10 19:02:00,e881fe456c68b0012f2723ea03aed7e3,0,17,1,0,0,18
11518,1702,2022-11-10 19:06:00,2b6913fe78e8c91e9138991c99bf0c4b,0,20,1,1,1,23
11519,1702,2022-11-10 19:12:00,58716de46140419b841134d08b2e8946,0,15,3,1,0,19
11520,1702,2022-11-10 19:17:00,95ce7abf36a7ea75eb4c93659fabbc21,0,14,0,0,0,14
11521,1702,2022-11-10 19:23:00,4f16a520c754566b69f055a9ca004562,0,18,0,0,0,18
11522,1702,2022-11-10 19:27:00,ea89b3c8d38ad469fc758fdf9daa02cb,0,13,0,1,2,16
11523,1702,2022-11-10 19:32:00,fe258eef4a35b6ad18d3964cf3f151a0,0,20,2,0,0,22
11524,1702,2022-11-10 19:38:00,c5f3229c0be6b33d8180b6bd61f0e489,0,25,0,0,1,26
11525,1702,2022-11-10 19:42:00,17e494db3d1f57af3568cb6516eea66b,1,17,0,1,0,19
11526,1702,2022-11-10 19:47:00,3f4f1013f9b3f6af363d1a859e50d46a,0,17,0,0,1,18
11527,1702,2022-11-10 19:52:00,9760cf60b9ca85e23ed5bd91c67fa65f,0,25,0,0,0,25
11528,1702,2022-11-10 19:57:00,774bdedf5346b73b57bb5fa5840242e5,0,12,0,0,1,13
11529,1702,2022-11-10 20:02:00,c474d4ec9cd2195970cf1bea6e387c4e,0,15,0,0,1,16
11530,1702,2022-11-10 20:06:00,6cdfebf687a452abc112ef228ec70f05,0,21,1,0,1,23
11531,1702,2022-11-10 20:11:00,6b71d3f4bb95bf8bdbd0519548805ea4,0,20,0,1,0,21
11532,1702,2022-11-10 20:17:00,0dd8aec81a48d87f315551ddc9b7c6e3,0,13,0,0,0,13
11533,1702,2022-11-10 20:23:00,d67dfc12266ccd9282c58942c2b59381,1,13,2,0,0,16
11534,1702,2022-11-10 20:26:00,45769c30f1d4f60d59d7f3da305c4517,1,22,2,1,1,27
11535,1702,2022-11-10 20:32:00,6effd7b2f270d1bd6649c3188be6d957,0,17,0,1,0,18
11536,1702,2022-11-10 20:37:00,1d807160008c933349ff27ac939ffd68,0,12,0,0,1,13
11537,1702,2022-11-10 20:42:00,7a81cec54ebcc524e735aa13034b1069,0,5,0,2,0,7
11538,1702,2022-11-10 20:48:00,9be48f6ffcc679faa36218699922150a,0,10,0,1,0,11
11539,1702,2022-11-10 20:52:00,221280ef449aa05cf2ba4bd61befdae7,0,14,0,0,0,14
11540,1702,2022-11-10 20:56:00,712d4b54a4498d0ae03b13eddda539e2,0,15,1,0,0,16
11541,1702,2022-11-10 21:01:00,e2216f652399cca436689bc3a19ebf73,0,22,2,0,0,24
11542,1702,2022-11-10 21:07:00,a12369b92963a54e8d1d3d11b6253110,0,20,0,0,0,20
11543,1702,2022-11-10 21:12:00,1c484c8ca549df1b954d256405907f44,0,24,0,2,0,26
11544,1702,2022-11-10 21:16:00,9bac270a639f0e238ce745248ec74b83,0,17,1,0,0,18
11545,1702,2022-11-10 21:22:00,54281f80dcbbc1c1be8e860e48521122,0,19,0,1,0,20
11546,1702,2022-11-10 21:26:00,5ba4eb005737ac633c4dfa8fccfbdc5e,0,26,0,0,0,26
11547,1702,2022-11-10 21:31:00,7b897d8d5c90bc3abf66afc6753eb8ae,0,23,0,1,1,25
11548,1702,2022-11-10 23:26:00,c8744bf32203434ca7dd683efba78eec,0,11,0,0,0,11
11549,1702,2022-11-10 23:31:00,a1a46a95d5ca0cc1b1ca38f6624177fe,0,9,0,0,1,10
11550,1702,2022-11-10 23:36:00,34f95ca5ff477a3d5a3df9f4ea55ffbb,0,7,0,0,0,7
11551,1702,2022-11-10 23:42:00,390ed6c5e6b6ab35aa523d116f522e16,0,10,1,0,1,12
11552,1702,2022-11-10 23:47:00,b7bc321bf5baefa54f7c8505e86f77fc,0,11,2,0,1,14
11553,1702,2022-11-10 23:52:00,316c08b85dd28ec8e5e890d77a1ebc31,0,3,0,0,1,4
11554,1702,2022-11-10 23:56:00,68c75d22fb9dca4ffce25edd036ec380,0,18,0,0,0,18
11555,1702,2022-11-11 00:02:00,c8087707e46d19d9be673bf3798bc3a2,0,11,1,0,0,12
11556,1702,2022-11-11 00:06:00,32b60808752381bf7b790e5ef45bc50e,0,10,0,0,1,11
11557,1702,2022-11-11 00:12:00,f56b671cde11f6511b69b0c27adabd2e,0,9,0,0,0,9
11558,1702,2022-11-11 00:17:00,43807ef6a549dce06ebb290efbc45471,0,13,0,0,0,13
11559,1702,2022-11-11 00:22:00,38e7fe7d7e315c336a238605014041f8,0,7,0,0,0,7
11560,1702,2022-11-11 00:26:00,dc04facc89974501acb45ef43958e4ce,0,7,0,0,0,7
11561,1702,2022-11-11 00:31:00,fe5e22658832d6d3bbc12cd8f8d832e3,0,12,2,0,1,15
11562,1702,2022-11-11 00:37:00,3481fee3c3f1592c3140cef005cf3e8a,0,10,0,0,0,10
11563,1702,2022-11-11 00:41:00,2eafac20912d2949d555d8454ce7b64d,0,15,0,0,1,16
11564,1702,2022-11-11 00:48:00,a4af0202f30e6ba944d592b664b3c73a,0,4,0,1,2,7
11565,1702,2022-11-11 00:52:00,324d6bf160d50292d6c83b6d2faff621,0,10,0,0,1,11
11566,1702,2022-11-11 00:56:00,c29d416b22b1f949a592793c9b76d694,0,10,0,0,1,11
11567,1702,2022-11-11 01:02:00,b6f7efbc3e68837466ea66b6046de408,0,3,0,0,0,3
11568,1702,2022-11-11 01:07:00,f800db6ac0de5e6f45cd37d488669156,0,6,0,0,0,6
11569,1702,2022-11-11 01:12:00,26b261abd12bcc73fa0f8373876e03e9,0,5,0,0,0,5
11570,1702,2022-11-11 01:17:00,c782c871b6bddc6c0b5e60d35e618094,0,8,0,0,0,8
11571,1702,2022-11-11 01:22:00,b54bf54ea64a7db38f5ede644949a893,0,2,0,0,1,3
11572,1702,2022-11-11 01:27:00,7fb4a9c19028c7f1116b1074a2096ea7,0,14,0,0,0,14
11573,1702,2022-11-11 01:32:00,e109a917f0415b8303641697a1c98655,0,8,0,0,1,9
11574,1702,2022-11-11 01:36:00,253ec80dcdea5e485ba9ffd0aea91bbd,0,5,0,1,0,6
11575,1702,2022-11-11 01:42:00,ec3090f932736655c0854cea674f4368,0,8,0,0,1,9
11576,1702,2022-11-11 01:47:00,fe274a6ef443a9d0243805065bbc6b59,0,2,0,0,2,4
11577,1702,2022-11-11 01:52:00,4edc34ee36966543aa55b1b52631a008,0,5,2,1,0,8
11578,1702,2022-11-11 01:57:00,9383110003142422930871e65c70feda,0,4,0,0,1,5
11579,1702,2022-11-11 02:02:00,6cba83109e7cb924d0991ee1e84bd513,0,2,0,1,0,3
11580,1702,2022-11-11 02:07:00,341af1149b2102363809161d1349c5d9,0,3,0,0,1,4
11581,1702,2022-11-11 02:12:00,3670594f36deb32beaa6fcf321c4a4c3,0,4,0,0,0,4
11582,1702,2022-11-11 02:17:00,d455b171917cbd078f99faa9f58bff2a,0,4,0,0,2,6
11583,1702,2022-11-11 02:22:00,fbfe058d97be740c2bc0e3eb2b80122f,0,10,1,0,0,11
11584,1702,2022-11-11 02:26:00,cf3c5a14f1631086d4938000cb182f5a,0,10,0,0,0,10
11585,1702,2022-11-11 02:31:00,94d01911e0b05e5bbf89f3f04ea6fa6a,0,7,0,0,1,8
11586,1702,2022-11-11 02:37:00,de9b2412cb9e56ed63f679f1788686b0,0,8,0,0,0,8
11587,1702,2022-11-11 02:42:00,2d80192c2a73ee971aaf9208f4570580,0,6,0,0,0,6
11588,1702,2022-11-11 02:46:00,fe694a5c2036f2c6decc060cdbf92358,0,2,0,0,0,2
11589,1702,2022-11-11 02:52:00,1d929233ab9d7f3ad1162db32405e3f1,0,13,0,0,0,13
11590,1702,2022-11-11 02:57:00,92c0363f89086ac04a1c92b8ff35be89,0,6,0,0,0,6
11591,1702,2022-11-11 03:01:00,910c30fa9395b6c1ab8e03da7f3c776a,0,8,0,0,0,8
11592,1702,2022-11-11 03:06:00,e5cd0b3b3644208140c2818f48a5d6e4,0,3,0,0,0,3
11593,1702,2022-11-11 03:11:00,73f76a28224680004a83eb82fd3a0a12,0,7,0,0,0,7
11594,1702,2022-11-11 03:18:00,f65a7f146860a721e40b136a72e1f68c,0,0,0,0,0,0
11595,1702,2022-11-11 03:22:00,a18ebb33a3a3cf0a45b56c460298fb39,0,6,1,0,1,8
11596,1702,2022-11-11 03:26:00,71770a0e9bb5ed9e1e39b77af3a873fb,0,4,0,0,0,4
11597,1702,2022-11-11 03:32:00,dd8df15e7f859290fb37020618f21119,0,8,0,0,0,8
11598,1702,2022-11-11 03:37:00,5461ac35bcc52caaf0770a3a038e5807,0,2,1,0,0,3
11599,1702,2022-11-11 03:41:00,86ee28c90b5a610e8623f2afeb51702e,0,7,0,0,0,7
11600,1702,2022-11-11 03:47:00,791e5af6b23442babd3e8be553a3039a,0,5,0,0,0,5
11601,1702,2022-11-11 03:51:00,7232c7961cc8dc3d0c38262c93cde87f,0,8,0,0,0,8
11602,1702,2022-11-11 03:57:00,10858e1f0cdfbc5e7144474ccf2f053c,0,7,0,0,2,9
11603,1702,2022-11-11 04:02:00,c4128aef61b536deb463c1d2afb872d4,0,6,0,0,1,7
11604,1702,2022-11-11 04:07:00,1f393d14f7dc4a80126f061a536d5184,0,2,1,0,0,3
11605,1702,2022-11-11 04:11:00,7881b44d364a21c0d4e4c6509af95626,0,8,0,0,0,8
11606,1702,2022-11-11 04:17:00,cef0fb084eace23d060901494464cb80,0,0,0,0,0,0
11607,1702,2022-11-11 04:21:00,3a4a75125cf8ffb303af76dcf5b637ec,0,10,0,0,0,10
11608,1702,2022-11-11 04:26:00,7eede144fdd177b78efbcb0bb4027328,0,2,0,0,0,2
11609,1702,2022-11-11 04:32:00,dc9dd206db25a92fb99d0fb0dbf2d4c1,0,3,0,0,0,3
11610,1702,2022-11-11 04:37:00,a9ac47c5c9a4fd44563730c9d16f0849,0,2,0,0,0,2
11611,1702,2022-11-11 04:41:00,ae0bbd678dd3ecb06632ae01c912658b,0,6,1,0,0,7
11612,1702,2022-11-11 04:47:00,e1b2b63a446a8820d431d7ee639837f3,0,10,0,0,1,11
11613,1702,2022-11-11 04:52:00,0c3162835cba668b98d1c2ea7cc9e9e8,0,5,0,0,1,6
11614,1702,2022-11-11 04:57:00,1441fcb1a9b93128ba17912860411031,0,0,0,0,0,0
11615,1702,2022-11-11 05:02:00,5b54e2440acef789135cfc0c36141372,0,17,0,0,2,19
11616,1702,2022-11-11 05:07:00,1eec07a9b64ee73e0468f7145a5cd359,0,0,0,0,0,0
11617,1702,2022-11-11 05:12:00,c64bb5f7793c88c393607589feefc3da,0,3,0,0,1,4
11618,1702,2022-11-11 05:17:00,9ea7ec5bf9ff4a66871138e77ce5a78e,0,6,0,0,1,7
11619,1702,2022-11-11 05:21:00,d2366580ec241d4d660c2419b51a853d,0,3,0,0,1,4
11620,1702,2022-11-11 05:27:00,d74f9cc2502325f6e6d946abd0e2d4c2,0,2,0,2,0,4
11621,1702,2022-11-11 05:32:00,e0acbc626ed52450ebbadd04bde973b6,0,2,0,1,0,3
11622,1702,2022-11-11 05:36:00,85b2a932a821b1b37d96cf2cbd35770e,0,1,0,0,0,1
11623,1702,2022-11-11 05:42:00,7937ffa9b8db6468ef77b5327877ab1e,0,3,0,1,0,4
11624,1702,2022-11-11 05:46:00,f72387e74aab2069972cd4b36b5606ac,0,10,0,0,2,12
11625,1702,2022-11-11 05:51:00,30d237331da5f9ce6c994b87b8d5df77,0,5,0,0,0,5
11626,1702,2022-11-11 05:56:00,859cd46d0fb2ced95d22608c0a5c3418,0,2,1,0,2,5
11627,1702,2022-11-11 06:02:00,b38659c9250acd452ffc7e712dd079a7,0,9,1,2,1,13
11628,1702,2022-11-11 06:07:00,e762a0f64c20c588f3c73f01144b46d9,0,10,0,0,0,10
11629,1702,2022-11-11 06:12:00,603b6619879624c6aa09b40d685f4188,0,5,0,0,0,5
11630,1702,2022-11-11 06:17:00,007f4955bf96fcd68214df6658198bfd,0,9,1,0,0,10
11631,1702,2022-11-11 06:22:00,dffa38eadd38a34c60dc500a15c11116,0,8,0,0,0,8
11632,1702,2022-11-11 06:26:00,74ffc97a824044d64a52e2112d9998a6,0,13,0,0,1,14
11633,1702,2022-11-11 06:31:00,bb3d0d442ca7da880cc3dcdb4f942205,0,17,0,2,1,20
11634,1702,2022-11-11 06:37:00,31b9deb5aa6b4789d1a2dcb6fd039c06,0,11,1,0,1,13
11635,1702,2022-11-11 06:42:00,f7d803a2a010f97984e80b82969cf5a5,0,8,1,0,8,17
11636,1702,2022-11-11 06:47:00,8bf5c4aaabfc614be17a30b49e408a3a,0,16,0,1,4,21
11637,1702,2022-11-11 06:51:00,dcef9e9a4051349c7098642554615775,0,11,0,2,12,25
11638,1702,2022-11-11 06:57:00,a6a41a1af623ecf4feab4b6249367c7a,0,13,0,3,6,22
11639,1702,2022-11-11 07:02:00,c7e1513b4b8a103a9cb95b93279493a2,0,19,1,0,11,31
11640,1702,2022-11-11 07:07:00,50eb8c274162b035f362ff8843ed210b,0,12,4,1,9,26
11641,1702,2022-11-11 07:11:00,39c0efefd75b1f29ddc3eda97b9e3fac,0,16,1,0,2,19
11642,1702,2022-11-11 07:17:00,ffa7258a3395d7b1afc6fef888475a20,0,9,0,6,7,22
11643,1702,2022-11-11 07:22:00,8e51c223134160c8bbbef4ced077a1a3,3,17,0,1,5,26
11644,1702,2022-11-11 07:27:00,03c8d3c0c592a2b2a4dedb6c35280c38,0,16,0,3,6,25
11645,1702,2022-11-11 07:32:00,e6c4d347b982044f4bd4a0d3929206d5,0,18,0,3,7,28
11646,1702,2022-11-11 07:38:00,3da401fa72c1bca2b46d8e7310c14cac,0,11,0,1,15,27
11647,1702,2022-11-11 07:41:00,e11bccf8f9beb7ee1a31a8e1b5799417,3,22,0,1,11,37
11648,1702,2022-11-11 07:47:00,5a18d03dd0ee390dac3bbf37531fb80b,0,11,0,1,9,21
11649,1702,2022-11-11 07:52:00,42a9ea7ba2dabb9d4fedf4f5aa454e26,0,20,0,0,7,27
11650,1702,2022-11-11 07:57:00,aaa381684856367e01dff5aabfdcb255,2,12,0,0,7,21
11651,1702,2022-11-11 08:02:00,d7ae5ce6d9f18159368a43780c917d1c,1,17,0,3,5,26
11652,1702,2022-11-11 08:07:00,c3b2e6ab8eb0187d4454fe4349fb3750,0,15,0,1,5,21
11653,1702,2022-11-11 08:11:00,5d01d451d39fa00f8051318569ce684e,0,18,0,2,8,28
11654,1702,2022-11-11 08:17:00,ba812de2144251f73610b88ab6e842dd,1,20,0,2,12,35
11655,1702,2022-11-11 08:22:00,4a7459f3050992719b6d4fdabc823f6a,0,8,0,3,7,18
11656,1702,2022-11-11 08:27:00,6c0c27781891c2da3bf72755c7a2942c,0,12,0,1,14,27
11657,1702,2022-11-11 08:32:00,c6c5cf2531b5eff056d0db5bf4a3653d,0,16,0,0,6,22
11658,1702,2022-11-11 08:37:00,a615ff1085ba3e067f2f1e96a2223842,1,18,0,0,3,22
11659,1702,2022-11-11 08:42:00,6665c25539263e7ab94f95ddbc6538bc,0,18,1,0,10,29
11660,1702,2022-11-11 08:47:00,5db92a5759bcb5d1fdff9b59848b233a,3,19,0,1,4,27
11661,1702,2022-11-11 08:52:00,3b4216862c246fdded2e62cb6d3ba768,0,17,0,2,8,27
11662,1702,2022-11-11 08:57:00,5843b42baa8a66a5829427114b507916,2,21,0,1,5,29
11663,1702,2022-11-11 09:02:00,4776be0959378f01f42bd45965b3ef14,0,19,0,2,10,31
11664,1702,2022-11-11 09:07:00,1eadd2b9ab5b44be356aa304cb9c73a2,4,9,1,5,7,26
11665,1702,2022-11-11 09:12:00,6978ce7e60d38c3ebbc68bd65e827c68,0,18,0,2,6,26
11666,1702,2022-11-11 09:17:00,3fc3ba44cceed95c723550ed29c39f00,2,10,0,1,10,23
11667,1702,2022-11-11 09:23:00,012e5b83c78273a7d07f232396d51b89,0,23,0,2,3,28
11668,1702,2022-11-11 09:26:00,32e8348a72c89b2a46c5abb981da7533,2,30,0,0,6,38
11669,1702,2022-11-11 09:33:00,f2207202dca5f15442d2d3a7e4f945b2,0,19,1,3,6,29
11670,1702,2022-11-11 09:37:00,964a43d9b4f26808ca5d7ac777eea96a,0,16,0,0,9,25
11671,1702,2022-11-11 09:42:00,3474bd94869d27ac520b249d41fca547,0,14,0,3,13,30
11672,1702,2022-11-11 09:47:00,dc985f016f46375ca54885648ace7fc2,1,11,0,2,12,26
11673,1702,2022-11-11 09:52:00,fea7b8f73d689b0134fbc4138ea1b8c7,0,14,0,2,6,22
11674,1702,2022-11-11 09:56:00,2b619a52b33431388a18799b057cf4eb,0,14,0,2,12,28
11675,1702,2022-11-11 10:02:00,aed3e00d0189505eb556e291dbdd19a1,0,16,0,3,6,25
11676,1702,2022-11-11 10:07:00,b4c89e936d1daacffe4a130d97287171,0,12,0,4,6,22
11677,1702,2022-11-11 10:12:00,6e3e79240512b39f389236f2a7eb29cc,0,18,0,3,8,29
11678,1702,2022-11-11 10:17:00,121f605fa2214f0d732ea51a6e4da62b,0,11,1,1,16,29
11679,1702,2022-11-11 10:22:00,a749acbefd51426d6f64f4b8559813e5,0,9,0,5,16,30
11680,1702,2022-11-11 10:27:00,746a09fd61cf5b878dcb74194b059a87,0,11,0,2,10,23
11681,1702,2022-11-11 10:32:00,62cc9a757519cb5c93c06281e139ae0b,0,12,0,8,12,32
11682,1702,2022-11-11 10:37:00,3138e3c9454e05e69f6c5d35eb0f5b5f,0,10,0,3,9,22
11683,1702,2022-11-11 10:41:00,c3002ad8ce5ac965906adf69954c0af5,0,13,0,3,9,25
11684,1702,2022-11-11 10:47:00,3743622c43ef7169abae8dbef64b8c4f,0,11,1,4,11,27
11685,1702,2022-11-11 10:53:00,173d41ad6d570a1ca5a7bd46b8f30864,0,11,0,1,12,24
11686,1702,2022-11-11 10:56:00,26c95d6dad583c74c1f805d33199fca9,3,14,0,3,10,30
11687,1702,2022-11-11 11:02:00,038c99d629cff168ba39e8dacf4ff43f,1,8,0,1,13,23
11688,1702,2022-11-11 11:07:00,5853e68ac5f9105b514a6c6c8173eede,0,20,0,0,11,31
11689,1702,2022-11-11 11:12:00,20deb095ab8a8677acae92ed5786dc96,0,15,1,4,10,30
11690,1702,2022-11-11 11:16:00,7161da69c7058ff28681b59417127afb,0,16,4,4,7,31
11691,1702,2022-11-11 11:22:00,bc77943585aa6dccf226fdaca69c4e79,0,13,0,2,14,29
11692,1702,2022-11-11 11:27:00,ad54a2f6f30ca07924fc7be111c4b5c2,0,14,0,2,14,30
11693,1702,2022-11-11 11:32:00,36e6b32ce0a61ccfe1d2876d62c89759,0,12,0,1,10,23
11694,1702,2022-11-11 11:37:00,54459d4afde56a43f2af2d322334dfa6,0,20,0,4,11,35
11695,1702,2022-11-11 11:42:00,a8bf00a2721696240e13c963bf6d0122,0,20,2,6,6,34
11696,1702,2022-11-11 11:47:00,1d17991dcf3e2eb342c4fb62e1ea1cb3,0,17,2,5,9,33
11697,1702,2022-11-11 11:52:00,e6446e2c801cce368a94b2dc95aab1ea,1,11,0,2,5,19
11698,1702,2022-11-11 11:56:00,149a02b27d98a94511d9a87b19566572,0,14,0,3,6,23
11699,1702,2022-11-11 12:02:00,305e599bd01dad066dc32cb12adaed73,0,12,1,1,8,22
11700,1702,2022-11-11 12:07:00,31ae22b72713878050632aad0c977b4f,1,9,0,0,15,25
11701,1702,2022-11-11 12:12:00,fa644a1215faace1b62b8ba8a1242e9b,0,12,0,3,14,29
11702,1702,2022-11-11 12:17:00,6b694b3179a795b31b539fcf631c20ad,0,17,0,4,15,36
11703,1702,2022-11-11 12:23:00,b02f81f2ad05658cf6e30d4056bf8c5c,0,16,0,3,9,28
11704,1702,2022-11-11 12:27:00,b3b3ec393fc14b8d09b6aa78f4ffefcb,0,17,0,2,13,32
11705,1702,2022-11-11 12:32:00,f446cb4848932028fe7f5c6910ed1cdd,0,6,0,2,14,22
11706,1702,2022-11-11 12:37:00,6e390ba609f05050b47a1048f14a9d92,0,22,1,1,7,31
11707,1702,2022-11-11 12:42:00,fed74da093be5521c3a0610c3f713f25,3,17,0,7,6,33
11708,1702,2022-11-11 12:47:00,726e45cf1ceb16665eed00bd2cd32852,0,17,0,3,10,30
11709,1702,2022-11-11 12:52:00,809e60e93edbfe13c2050ba6cea7a840,0,11,0,6,12,29
11710,1702,2022-11-11 12:57:00,765853dcce0dfdcb2de40165455c7033,1,20,0,3,15,39
11711,1702,2022-11-11 13:02:00,f77b25504454eb21ef37c51bf03d6665,1,19,0,0,10,30
11712,1702,2022-11-11 13:08:00,71732914116f3dbdcee015f8ec195d76,0,19,0,1,8,28
11713,1702,2022-11-11 13:12:00,e8ecae09672a4d376d35abff1fa51171,0,15,0,4,5,24
11714,1702,2022-11-11 13:17:00,c90bbdfe1b72f06b28d31cad3de1c2eb,0,15,0,3,6,24
11715,1702,2022-11-11 13:22:00,1e34e2457d52bb8da1287bac386446a1,0,17,0,4,8,29
11716,1702,2022-11-11 13:27:00,77b311b7b2357369cc2d479fe38f8c19,0,14,0,2,9,25
11717,1702,2022-11-11 13:32:00,0b1c09ceaa1593f84339040cbe14d528,0,20,0,1,9,30
11718,1702,2022-11-11 13:37:00,3b5c44e57d89964dea2f2da0b1540197,0,17,1,4,7,29
11719,1702,2022-11-11 13:42:00,ef52f370b4ed8bb7886cb2608857e63b,0,15,0,7,1,23
11720,1702,2022-11-11 13:47:00,a53b84a648e69be4ef4e4d0cd56bee3b,0,15,0,2,4,21
11721,1702,2022-11-11 13:52:00,fffc7cf35b79f6ce5b79201f79014511,0,17,0,6,4,27
11722,1702,2022-11-11 13:57:00,8f2b344f73ceb4cee437348cdc52ec26,1,14,1,2,5,23
11723,1702,2022-11-11 14:02:00,72b70b9406da558fac5ead809dfa9bf4,0,15,0,7,6,28
11724,1702,2022-11-11 14:08:00,bc1e253f0793ab0d0912651d4b3f7f4d,0,13,0,4,7,24
11725,1702,2022-11-11 14:12:00,a1e818d9a59db8cff9242ed8b4ae287a,0,16,1,2,14,33
11726,1702,2022-11-11 14:17:00,b073d0b76a0639b6e1051d846a39ac1f,0,17,0,4,8,29
11727,1702,2022-11-11 14:22:00,8ab3753891ea802ee5507eb60a53d7cd,0,12,0,2,11,25
11728,1702,2022-11-11 14:27:00,64659e37f27ca218b25debb650a04479,0,14,1,5,7,27
11729,1702,2022-11-11 14:32:00,2eee25e2bcb3bf05bc4070c7c212a968,0,11,0,6,12,29
11730,1702,2022-11-11 14:37:00,2ed3e2badab4d249ffe2fa593e6ca32c,1,16,0,1,13,31
11731,1702,2022-11-11 14:41:00,35acd9c39cc4f2f473a2a78736dd03b0,0,14,0,9,7,30
11732,1702,2022-11-11 14:47:00,16406516afd9d94514b588c731ba006c,0,17,0,8,8,33
11733,1702,2022-11-11 14:51:00,17a63f154dd7ae446eb6369c9a8147c3,0,11,0,9,10,30
11734,1702,2022-11-11 14:57:00,bcbe911d447e69fa454170a6533e8080,0,12,0,2,13,27
11735,1702,2022-11-11 15:02:00,c1d61635758935999920d36e6ddb6350,0,20,1,2,11,34
11736,1702,2022-11-11 15:07:00,6a7ab2ae629089ac4d43a205f4c60db9,1,11,1,6,12,31
11737,1702,2022-11-11 15:12:00,af643b6126271892704ce0593993b286,0,12,0,5,14,31
11738,1702,2022-11-11 15:17:00,00cf98ee78faa72786be6213a3c87900,0,19,0,5,8,32
11739,1702,2022-11-11 15:22:00,3bd3903da88983ef4940716f5442f061,1,14,0,4,4,23
11740,1702,2022-11-11 15:27:00,8dfb8ca800afee8549a321a82c272f6f,1,12,1,2,11,27
11741,1702,2022-11-11 15:32:00,7d2bf08a9aec3f3fead1a4365f8e7c66,0,10,0,2,13,25
11742,1702,2022-11-11 15:37:00,087511ec306e30726b89b8c740eae58e,0,11,1,1,5,18
11743,1702,2022-11-11 15:42:00,01bcfe8b631c4000dda2fb0de3345f0b,0,13,2,1,9,25
11744,1702,2022-11-11 15:47:00,ecd48fffb8116005540531c6aba82f89,0,8,0,2,12,22
11745,1702,2022-11-11 15:52:00,da09671bd50f0a045406fbe3ced77baa,0,13,0,12,8,33
11746,1702,2022-11-11 15:57:00,0b47bb45439aff07245c71a27154e253,1,21,0,1,12,35
11747,1702,2022-11-11 16:02:00,95a6dd59e21892814de8e3bdbf857703,0,18,0,4,6,28
11748,1702,2022-11-11 16:08:00,ac7433bb8c108291c2670d6e04f3e3ef,0,9,1,1,18,29
11749,1702,2022-11-11 16:12:00,afd1a8eaf175ca1def1561e57435fba6,2,16,0,1,11,30
11750,1702,2022-11-11 16:16:00,3a02ad2d4648390f37226c1bb2649e8e,0,12,0,2,12,26
11751,1702,2022-11-11 16:22:00,bc388c7f4bd2e649a3377032a3456a1b,0,18,0,5,5,28
11752,1702,2022-11-11 16:27:00,e45a12292d811b58a6e2337799bb5a7e,1,12,1,6,6,26
11753,1702,2022-11-11 16:32:00,bcd4e65af856b81db7e88ad4e7e5da1a,0,18,0,1,8,27
11754,1702,2022-11-11 16:37:00,23a8d0d633db35b7c2139a66362ac8e8,0,11,0,2,10,23
11755,1702,2022-11-11 16:41:00,0d9a54815b690aa678561632bfb57f53,1,20,0,4,4,29
11756,1702,2022-11-11 16:46:00,b3ad67ddd3606277ca5069676eb676dd,0,20,0,6,7,33
11757,1702,2022-11-11 16:52:00,6444384a8a4c47c6169e48f7ae6e48f7,0,14,1,7,7,29
11758,1702,2022-11-11 16:57:00,9899035aa97af959c3d21a373fd3cb68,0,12,0,1,16,29
11759,1702,2022-11-11 17:02:00,50c8ab5f1b7bfcb5a960ea7f3d9e22dd,0,22,0,3,6,31
11760,1702,2022-11-11 17:07:00,89370f83bc7ff1dff40f5dbc53b4e4c2,0,14,0,5,7,26
11761,1702,2022-11-11 17:12:00,080ecdd84dd7a5c6e47942db73d68125,0,18,0,7,7,32
11762,1702,2022-11-11 17:17:00,c0ac3ff688afffe97d478e7148076aaf,0,19,1,4,10,34
11763,1702,2022-11-11 17:23:00,11c4c2faf58c15ebd34000622fcf2c38,0,21,2,0,6,29
11764,1702,2022-11-11 17:27:00,4f352cf7031c892ae08d70617740c584,0,21,1,0,11,33
11765,1702,2022-11-11 17:32:00,ae8bc7c78de8d9de2f0959ce39304c22,1,20,0,8,3,32
11766,1702,2022-11-11 17:37:00,2988093402302b664128229416995e7c,0,25,0,1,5,31
11767,1702,2022-11-11 17:42:00,9076b66459f03bab10285b268eacf2d5,0,16,3,5,13,37
11768,1702,2022-11-11 17:47:00,1cc9323f8f7f1b7dcdb64f009670d4f7,1,24,0,6,5,36
11769,1702,2022-11-11 17:52:00,09738f7a5039d5a44bdcf8087f48422d,0,17,0,3,13,33
11770,1702,2022-11-11 17:57:00,10a7b8dbfcebdd3704cf2e0420c36cb3,0,17,0,5,12,34
11771,1702,2022-11-11 18:02:00,950e826d59f27c483276540c6ea566c3,0,17,0,6,11,34
11772,1702,2022-11-11 18:07:00,d15e5e919bcbdd0ba104ac5b11520123,0,19,0,2,10,31
11773,1702,2022-11-11 18:11:00,36a3bdbbaf94b4694e9082d77ec9e28a,0,19,1,6,6,32
11774,1702,2022-11-11 18:17:00,1008558f10df589a688419c936eca93d,0,16,0,4,12,32
11775,1702,2022-11-11 18:22:00,54f9e0c6ae6b3ac3d184142337ff164a,0,17,0,8,13,38
11776,1702,2022-11-11 18:27:00,3912ee7cfacf91185f4c63628c6220d4,0,19,0,2,11,32
11777,1702,2022-11-11 18:32:00,acddbbb53d7c699f7159d1a64195e2ce,2,20,0,7,14,43
11778,1702,2022-11-11 18:37:00,cc19374d60c7780ec9490f8acc609bc5,0,16,0,4,9,29
11779,1702,2022-11-11 18:42:00,95c2503e187277eb0ea94677705b1fa1,1,14,0,0,13,28
11780,1702,2022-11-11 18:47:00,f1a1260bc14e20bc874e873214d2328e,0,22,0,0,9,31
11781,1702,2022-11-11 18:52:00,319cacaf8e70ff9145666f1481cb985c,0,18,1,3,4,26
11782,1702,2022-11-11 18:56:00,e7838dc0ac9f0a67a1cc292ded478d11,0,18,0,0,8,26
11783,1702,2022-11-11 19:01:00,5f7c6b1e7f3eee17d3ab5dcdefe176d3,0,18,0,1,1,20
11784,1702,2022-11-11 19:07:00,9731216456fc9a0b1a96fad2bc9fe98a,0,20,0,1,1,22
11785,1702,2022-11-11 19:11:00,60f8141a26c35f1b4c0dadd650e2c107,0,22,1,0,1,24
11786,1702,2022-11-11 19:16:00,7f74de5a85879054006d93698d2b338e,0,15,2,1,1,19
11787,1702,2022-11-11 19:21:00,320a1a8b5f8f2b36ee79bae53467c295,0,17,1,0,0,18
11788,1702,2022-11-11 19:26:00,9816ddf6728f1e268c883a0ce1f5338f,0,18,2,1,1,22
11789,1702,2022-11-11 19:32:00,a308ce7f17da45dd15dc79937798a739,0,20,0,0,2,22
11790,1702,2022-11-11 19:37:00,acd83d2c5f18f19e8bd13c78799129ae,0,17,1,2,2,22
11791,1702,2022-11-11 19:41:00,618c24da25edba8536ec9cf68e04b6ea,0,18,2,0,0,20
11792,1702,2022-11-11 19:47:00,d02a1edfa2239b9545801c8e70180cc6,0,18,2,2,2,24
11793,1702,2022-11-11 19:51:00,4da1ead591f1af7e1c55512968b91864,0,18,0,0,0,18
11794,1702,2022-11-11 19:57:00,a04ffe32d1a3b34f62279cfe417ea273,0,13,0,2,1,16
11795,1702,2022-11-11 20:02:00,afa54f7f332781bc583dad847247ce55,0,17,1,0,1,19
11796,1702,2022-11-11 20:07:00,1b6f64403b1e6f0c5d285934caa4de76,0,14,0,1,3,18
11797,1702,2022-11-11 20:12:00,0002616de7ce12fc1d767c61cae748fb,0,19,0,0,3,22
11798,1702,2022-11-11 20:16:00,c8fce28db518ad4f5d66a35c337be2ab,0,17,0,4,0,21
11799,1702,2022-11-11 20:22:00,ec665d4ae6b6af94205755b43f3c56a4,0,14,2,0,3,19
11800,1702,2022-11-11 20:26:00,368000c74324eb3d5cbf39a73e05efc6,0,15,1,1,1,18
11801,1702,2022-11-11 20:32:00,fd254b088644b8f975ca9a6ad24f385b,0,21,1,1,2,25
11802,1702,2022-11-11 20:36:00,b53a0c3d3a105fa39645f981230b2bc9,0,24,1,0,1,26
11803,1702,2022-11-11 20:41:00,436c4ce88dbd0da934d7a52277832c7a,0,25,1,0,0,26
11804,1702,2022-11-11 20:47:00,4f6942ff6112c773a861c11dad932e48,0,20,2,0,2,24
11805,1702,2022-11-11 20:53:00,5d947cc2a325fb19ebd4bc38f7b951d3,0,10,2,0,1,13
11806,1702,2022-11-11 20:56:00,ac0b431667c795b104515572691568dc,0,17,0,1,2,20
11807,1702,2022-11-11 21:02:00,3f677e39e88f7517efb30ab8b336b1f4,0,27,0,0,0,27
11808,1702,2022-11-11 21:07:00,facbda6ba1e281742671c850c2f555ec,0,16,0,1,0,17
11809,1702,2022-11-11 21:12:00,63444a1b280ab92e712287f39c6354c0,0,25,0,1,0,26
11810,1702,2022-11-11 21:17:00,825ad4a9e2a4bd9be1313119cba04dba,0,18,2,1,1,22
11811,1702,2022-11-11 21:22:00,00fd7c87b5884cda4aed15120bc02970,0,18,3,0,1,22
11812,1702,2022-11-11 21:26:00,86a9453b295e7aa2db55355ef3864670,0,24,1,0,1,26
11813,1702,2022-11-11 21:32:00,ad21ea3b11fb3f696645e90bf5b8caa8,0,22,1,0,2,25
11814,1702,2022-11-11 21:37:00,9a17169d6b0f4cc194d614c44ac75004,0,20,1,0,1,22
11815,1702,2022-11-11 21:42:00,9aa69785e483e81752e43e406dff35fb,1,26,4,0,0,31
11816,1702,2022-11-11 21:47:00,326ed279403ac6c62fd5dcbe066a2161,1,25,2,2,1,31
11817,1702,2022-11-11 21:52:00,437c3b5999efe50b0fbbd8df72b80be9,0,26,0,0,0,26
11818,1702,2022-11-11 21:56:00,b82da40d112ca5ac1bec7dcfcea548e8,0,17,1,1,0,19
11819,1702,2022-11-11 22:01:00,6423611b503e04352e78a04ad57ace59,0,20,0,1,0,21
11820,1702,2022-11-11 22:06:00,e0afd341c510c6d1bea6cac49d73f763,0,23,1,0,0,24
11821,1702,2022-11-11 22:11:00,f66f4ec607d7bceaea18af0aea220f93,0,24,0,0,1,25
11822,1702,2022-11-11 22:17:00,1ec61b13abbd0c16fad22bd16eb994a5,0,22,0,1,1,24
11823,1702,2022-11-11 22:22:00,4c4035fd6dc3f213fe9b73a8abdcad67,0,22,0,1,1,24
11824,1702,2022-11-11 22:26:00,b74114dc402f6266e5b22e72aee006c0,0,17,0,0,0,17
11825,1702,2022-11-11 22:32:00,2ba57021be1ce4b211b97e1a4013acf7,0,25,0,0,1,26
11826,1702,2022-11-11 22:37:00,a2db5267cf2e9bca797aba598cf6f416,0,20,1,1,0,22
11827,1702,2022-11-11 22:42:00,7b12a34f4227f313f92a6b5f41253a1d,0,24,0,1,1,26
11828,1702,2022-11-11 22:47:00,e6df9e9d1ae5f699655369b1fa8c4931,1,21,0,1,1,24
11829,1702,2022-11-11 22:52:00,214a4c68bc65b8e4fcb728a3c1730977,0,19,0,0,1,20
11830,1702,2022-11-11 22:57:00,2c4e2b0c2044abce1b4e1146f9986ec9,0,22,0,0,0,22
11831,1702,2022-11-11 23:01:00,5b5eafe6a227f4a045dd8a7c160f1de0,0,21,1,0,0,22
11832,1702,2022-11-11 23:07:00,c9306774c7fa37df780daa73622f18ae,0,22,0,0,0,22
11833,1702,2022-11-11 23:11:00,f15dee377b7f76d83d8717bd7d2aeac4,1,29,0,1,0,31
11834,1702,2022-11-11 23:17:00,5a627a88c2c480c0b68e4145206a09d0,0,18,0,0,1,19
11835,1702,2022-11-11 23:22:00,96daa9ac9bc34ac60afad30e986369a6,0,10,1,0,0,11
11836,1702,2022-11-11 23:26:00,d4a0279f0b144d501767ce495db9316c,0,15,0,0,1,16
11837,1702,2022-11-11 23:32:00,d7a05ff6936d138fa985a14c436020f8,0,20,0,0,0,20
11838,1702,2022-11-11 23:37:00,0ad51d124e11d2568860521863be58bd,0,21,1,0,1,23
11839,1702,2022-11-11 23:41:00,fcdbdaf56943d7046ca79dfca32505e7,0,19,0,0,1,20
11840,1702,2022-11-11 23:47:00,7b7d94e18ecb3f88eb5dea63df0b7ad3,0,18,1,0,1,20
11841,1702,2022-11-11 23:52:00,a78989c8ef7b0bf4dcb4e088eeb5501d,0,17,1,1,1,20
11842,1702,2022-11-11 23:58:00,8f7d269ad604adbe76626ac91da627a0,0,14,0,0,2,16
11843,1702,2022-11-12 00:01:00,415bf23cce8a1be033c0b760fe5aa974,0,10,0,0,0,10
11844,1702,2022-11-12 00:06:00,a83890b9b8e530f7ea0bfc542f905af1,0,19,0,2,0,21
11845,1702,2022-11-12 00:11:00,e782a4d028fe93238f8ca7fcf93c1d99,0,21,1,0,2,24
11846,1702,2022-11-12 00:17:00,bddffc5a590c855fa026f6ed26be3e44,0,16,0,1,0,17
11847,1702,2022-11-12 00:22:00,dcfe0118411364233603ec5305baf3d1,0,13,1,0,2,16
11848,1702,2022-11-12 00:27:00,bc027e4adfaf8467ed3d61e066a20851,0,11,1,1,1,14
11849,1702,2022-11-12 00:31:00,3adbda14cab4043690bfb2c9844747fa,0,13,1,0,1,15
11850,1702,2022-11-12 00:37:00,ec31160d3056a3fa77c72117688ac687,0,10,0,0,2,12
11851,1702,2022-11-12 00:42:00,b57c4156cca487729fae56005073cdac,0,6,1,0,2,9
11852,1702,2022-11-12 00:47:00,e3fb336326b3a5679f74ee4b4714a701,0,16,0,0,0,16
11853,1702,2022-11-12 00:51:00,b91bd88a357539afe702d258254ce69e,0,11,0,0,1,12
11854,1702,2022-11-12 00:56:00,947992bc3ecef94c6c1aa4c883d60ff2,0,10,0,0,0,10
11855,1702,2022-11-12 01:01:00,daa36734d8c2bc22d260ad80596e049f,0,15,0,0,2,17
11856,1702,2022-11-12 01:06:00,47210ac9bc3f9755738f26f8148a63d5,0,16,1,0,1,18
11857,1702,2022-11-12 01:11:00,aeca2282b0505c9b5f7f1629c8cb7757,0,8,0,0,1,9
11858,1702,2022-11-12 01:17:00,70a441196ecd20d8b31523bfce5ab5f8,0,8,0,0,0,8
11859,1702,2022-11-12 01:22:00,7957cfbf442ff1e75bfc244e4ae0abfc,0,11,0,0,0,11
11860,1702,2022-11-12 01:27:00,52e5b0a9f5b3c985717ac31ff4186c11,0,7,0,0,1,8
11861,1702,2022-11-12 01:31:00,58c1d470d6def42cc421a7e2eec601f8,0,6,1,1,0,8
11862,1702,2022-11-12 01:37:00,af1a1d72c8c6e97357efdbc547a7c365,0,5,0,0,1,6
11863,1702,2022-11-12 01:41:00,f1b5dcd1006432724f6d2fdabd8b7ea7,0,12,0,1,0,13
11864,1702,2022-11-12 01:47:00,c677078bb0b490e133fdc60ddf13bf5c,0,6,0,1,0,7
11865,1702,2022-11-12 01:51:00,69c78dc1c3f9606fb0a102cef0f7e967,0,15,1,1,0,17
11866,1702,2022-11-12 01:56:00,3f27e11d3d7e5114f6d4e4384a4becee,0,12,0,0,3,15
11867,1702,2022-11-12 02:02:00,a117ad5fe836204674e493c988fabbc6,0,10,0,0,1,11
11868,1702,2022-11-12 02:07:00,a9b2329e86ba5e41f9e0a669f7d72dbc,0,10,2,0,0,12
11869,1702,2022-11-12 02:12:00,c07ea1020b65c20968ecfb1e9d18d1b0,0,9,0,0,0,9
11870,1702,2022-11-12 02:17:00,c6d4cc39db5f4c709731c8009513de2a,0,15,1,1,2,19
11871,1702,2022-11-12 02:22:00,aafad91bf9f2290c3be370631cf47543,0,5,0,0,0,5
11872,1702,2022-11-12 02:26:00,66c6f52c53f2d649327e7554d6088371,0,10,0,1,1,12
11873,1702,2022-11-12 02:31:00,2d944298a236da02272524442e81b5cd,0,11,0,0,1,12
11874,1702,2022-11-12 02:36:00,e549027c6dae2aa6dafd567acf15d90f,0,3,2,0,2,7
11875,1702,2022-11-12 02:41:00,9441f66bcf78219637e6199558d0f7fe,0,6,0,0,0,6
11876,1702,2022-11-12 02:47:00,b1350de5979a3012135a92039ae6ad38,0,5,0,0,1,6
11877,1702,2022-11-12 02:51:00,68c4f29dadc498953afdd15716ac5f33,0,2,0,0,0,2
11878,1702,2022-11-12 02:56:00,067afc13358c93c6602683d137fa8ccb,0,5,0,0,1,6
11879,1702,2022-11-12 03:01:00,611f4bd6125cb06a9e190867d41988ce,0,3,1,2,1,7
11880,1702,2022-11-12 03:07:00,941ec886f9e8b84b9667efe60a0ae63b,0,6,0,0,0,6
11881,1702,2022-11-12 03:12:00,b085ba0bcc8098547d44ce0fce0bc239,0,2,1,0,2,5
11882,1702,2022-11-12 03:17:00,928a322a862d681f64544845c4a83e33,0,7,1,0,0,8
11883,1702,2022-11-12 03:22:00,1f638f9fff41e391ec1385e259c72773,0,7,0,0,0,7
11884,1702,2022-11-12 03:26:00,2bfa77167d575d7f6e670e79fac3cacc,0,3,0,0,0,3
11885,1702,2022-11-12 03:31:00,e4ecd6ff881b8771f646d86c1a44f620,0,15,1,0,0,16
11886,1702,2022-11-12 03:37:00,093af2aa4f905b6fe36ad6c82d540402,0,9,0,0,0,9
11887,1702,2022-11-12 03:41:00,6d04a09609307816942963889c2b8d70,0,5,0,0,0,5
11888,1702,2022-11-12 03:46:00,113a92ebd84b848898955991f2387d3b,1,3,0,0,0,4
11889,1702,2022-11-12 03:51:00,ecd31c34c6e95d860da0af322759e93c,0,12,0,0,2,14
11890,1702,2022-11-12 03:57:00,ddd81811987d58f893ccd86bd8e1167b,0,3,1,0,0,4
11891,1702,2022-11-12 04:02:00,80226772bbbcafbbb07b3451c9d80cb1,0,13,0,0,0,13
11892,1702,2022-11-12 04:07:00,04dd34a3e5fa25cc91cd6d842304185e,0,6,0,0,0,6
11893,1702,2022-11-12 04:11:00,6c2bc421dcc4f3ca305ae6c806ad7edd,0,10,0,0,0,10
11894,1702,2022-11-12 04:16:00,4789344c7280a6c80018fb0e0773be9a,0,2,0,0,0,2
11895,1702,2022-11-12 04:22:00,94c4839994715b237ab8869bbe557520,0,1,0,0,0,1
11896,1702,2022-11-12 04:27:00,7157be4adf5bfbc9b4f994162be272cd,0,8,0,0,2,10
11897,1702,2022-11-12 04:32:00,6ab2c489bbbe2d707b1e87adca8fd9ba,0,4,0,0,1,5
11898,1702,2022-11-12 04:38:00,68021f0c81c321a84634b7f32b352224,0,8,1,1,1,11
11899,1702,2022-11-12 04:42:00,24b008b41e2991e09e353c1246587d03,0,6,0,0,1,7
11900,1702,2022-11-12 04:46:00,750e5681429f09dc28c0aa273860f1ca,0,6,1,0,0,7
11901,1702,2022-11-12 04:51:00,3725c3a90bd2ca6f2828fe490df7f02b,0,6,0,0,0,6
11902,1702,2022-11-12 04:57:00,d9bcd93afe911238b63a9c5626833aa6,0,8,0,0,1,9
11903,1702,2022-11-12 05:02:00,2ff585dfdba62daf41a15f7f65be51a0,0,3,0,1,0,4
11904,1702,2022-11-12 05:07:00,cb5451d24afb93d38d3d82ae91a8c0a8,0,8,0,1,0,9
11905,1702,2022-11-12 05:11:00,0b18250439b77bb628db3670f1c6cae8,0,7,0,0,0,7
11906,1702,2022-11-12 05:17:00,1f5b2fe494b2413192ac9e8c4475b36b,0,6,0,0,0,6
11907,1702,2022-11-12 05:22:00,ab760637e24f08a08556a5a92daeb970,0,6,0,0,0,6
11908,1702,2022-11-12 05:27:00,527c30a95b83601003f618252f64b552,0,9,0,0,0,9
11909,1702,2022-11-12 05:31:00,b6ddb6739f2cfb60aaf6eebbb27ea114,0,3,0,0,0,3
11910,1702,2022-11-12 05:38:00,052c73f07e83627c13295ec185756002,0,4,0,2,0,6
11911,1702,2022-11-12 05:41:00,4f990a417c47ea10fb1e57feaff53b01,0,2,0,0,0,2
11912,1702,2022-11-12 05:47:00,763b2593d3b6ecf0fcbffd5d29656e07,0,6,1,1,0,8
11913,1702,2022-11-12 05:52:00,76a2b3411b32cb6c72ccb0d02ca6f081,0,5,0,0,0,5
11914,1702,2022-11-12 05:56:00,22089d44b266df370974832a2733a856,0,11,0,0,1,12
11915,1702,2022-11-12 06:02:00,bd77e5fe14d457782fe46d62d7dc52c7,0,11,0,1,2,14
11916,1702,2022-11-12 06:07:00,c776334be4a409e93755145f9e7ba1ef,0,1,0,1,0,2
11917,1702,2022-11-12 06:12:00,7e98e3b51599e0beaf30c3de65d139a3,0,8,0,1,1,10
11918,1702,2022-11-12 06:17:00,446a86c7782b23c694d06e173c26989d,0,6,0,1,1,8
11919,1702,2022-11-12 06:22:00,3b97cfd40d7b8bc4885f734ae9ddb145,0,4,0,1,0,5
11920,1702,2022-11-12 06:27:00,2a3a442e7c582d9bb8b9337937523c56,0,9,0,1,2,12
11921,1702,2022-11-12 06:32:00,5709ffabb5c3577905eca7406de0f887,0,15,0,0,0,15
11922,1702,2022-11-12 06:37:00,5d3e7dc89ee1b0edb6adc907424b264e,0,8,0,1,1,10
11923,1702,2022-11-12 06:42:00,9da53aa953146b5c140c23ded370bd43,0,15,0,0,1,16
11924,1702,2022-11-12 06:47:00,bb768df6fa74900af0170221ac444147,0,5,1,1,1,8
11925,1702,2022-11-12 06:52:00,1383b95a71113fcf785d819ef9c5ac94,2,8,0,0,2,12
11926,1702,2022-11-12 06:57:00,385657e62abbe6062df18a2b409ce2c4,0,13,0,1,7,21
11927,1702,2022-11-12 07:02:00,4fe94c4adbd921049442cae168209621,0,10,0,1,5,16
11928,1702,2022-11-12 07:07:00,9625a9bbcbfac64db76edad79bc5778d,0,13,0,0,4,17
11929,1702,2022-11-12 07:12:00,f59e3ac58b874392ed5860dcd30b1d19,0,11,0,0,6,17
11930,1702,2022-11-12 07:17:00,96400413ceb25c3b346fc68e9418b102,0,11,0,2,8,21
11931,1702,2022-11-12 07:23:00,251c9615a793b0118a1d516b94609f5d,0,10,0,2,4,16
11932,1702,2022-11-12 07:27:00,6831d14b60065b73c31697715c20da78,0,10,2,2,2,16
11933,1702,2022-11-12 07:32:00,b3516ed35695b151db7feb9a9f109d20,2,14,3,1,7,27
11934,1702,2022-11-12 07:37:00,fa907c25a754fd4850d10f9628f57f6f,0,9,0,2,10,21
11935,1702,2022-11-12 07:42:00,4c9d39b069c8a32c9ebbda4803a57722,0,7,0,1,10,18
11936,1702,2022-11-12 07:47:00,747a56546d50192d910f991b5459af6f,2,10,0,2,7,21
11937,1702,2022-11-12 07:52:00,4146a70a1faea06d99c31335ce175f73,2,13,0,2,9,26
11938,1702,2022-11-12 07:57:00,8604399158fca430851c74c457e9f05c,0,10,0,1,9,20
11939,1702,2022-11-12 08:02:00,1094c81bbbc0bc5cc4675e8af3e695e6,1,9,0,3,14,27
11940,1702,2022-11-12 08:07:00,650bfa9ed2ff0a54ca9a7c354dc95303,0,9,0,0,5,14
11941,1702,2022-11-12 08:12:00,f059369010124352217ad428a7a59bc2,0,16,0,1,13,30
11942,1702,2022-11-12 08:17:00,96276d6bf6861656224294162ebaf01c,0,12,0,5,8,25
11943,1702,2022-11-12 08:22:00,9f5e17890598cfc04a827c2820655c9f,3,14,1,2,9,29
11944,1702,2022-11-12 08:26:00,3224af247673f65915b3f6aa928fb8cd,0,11,0,2,11,24
11945,1702,2022-11-12 08:33:00,c544d070345eb0dd87b1e5ca62e97655,0,12,1,0,4,17
11946,1702,2022-11-12 08:38:00,494e6f6a73174732e96ee9008702d517,0,11,1,1,5,18
11947,1702,2022-11-12 08:42:00,473c80ea4e1b26da408dc297ef5daa2a,0,15,0,3,12,30
11948,1702,2022-11-12 08:47:00,df60882f8ca41426864411e7a3947d5f,0,16,0,4,6,26
11949,1702,2022-11-12 08:52:00,4ec4d98cc384da15310e411362225c0b,0,13,0,3,10,26
11950,1702,2022-11-12 08:58:00,85b0cd4a8a7afbfb1c89ec301b729709,0,18,0,1,10,29
11951,1702,2022-11-12 09:02:00,b563c50ff978d19e23436c7a0ed128a7,0,8,0,2,15,25
11952,1702,2022-11-12 09:07:00,0b89118d8822a2660bf68aa0bcfc57e1,0,11,0,4,10,25
11953,1702,2022-11-12 09:11:00,4982668dd1eb0deca87fa14c9d5dc061,0,13,0,0,14,27
11954,1702,2022-11-12 09:17:00,93f1915304e4bfd7327ebd4f2ef7f6b4,0,14,2,0,8,24
11955,1702,2022-11-12 09:23:00,f414cd895d8084c643e50a8f82be6f34,0,10,0,0,9,19
11956,1702,2022-11-12 09:27:00,d0bd16de7a393bdcf78c5720d8577ce5,0,13,1,2,14,30
11957,1702,2022-11-12 09:32:00,4a3471f8f348c984c9f8257a2360f98a,1,13,2,0,13,29
11958,1702,2022-11-12 09:37:00,a156a9f75cfa00e53f779f96625893e1,1,19,1,4,8,33
11959,1702,2022-11-12 09:42:00,2ca49c980a8e0b138cec24550a879765,1,11,2,1,13,28
11960,1702,2022-11-12 09:47:00,b60a23fd652b3e4b597bf8802e93e4f1,0,19,0,2,9,30
11961,1702,2022-11-12 09:52:00,a548ee48aeb2b09818cd502e968f0f4f,0,17,0,4,9,30
11962,1702,2022-11-12 09:57:00,7387a9c49355a28c21d0528a53ab0738,0,13,0,0,10,23
11963,1702,2022-11-12 10:02:00,5db96d013fab755624b4570e56884e58,0,10,0,3,16,29
11964,1702,2022-11-12 10:07:00,908c2daa2f72ef203d8c9301b8c03545,0,14,0,3,9,26
11965,1702,2022-11-12 10:12:00,84a2cf62cb94e05bb2d0bb26b7ea0381,0,10,0,1,13,24
11966,1702,2022-11-12 10:17:00,fa8c6114cefaa2f1440d9413457d7ff7,0,18,0,1,15,34
11967,1702,2022-11-12 10:23:00,fab3a383fa367d68940997dfd497e38f,0,11,0,3,14,28
11968,1702,2022-11-12 10:27:00,4d69a0f4143a5f09dc7cf1274d522a04,1,13,0,2,10,26
11969,1702,2022-11-12 10:32:00,52bf97e29c6f76656db6e9f2ebc3ea96,2,13,1,1,15,32
11970,1702,2022-11-12 10:37:00,527673a3cd6fbe0cafcf21da993301a6,0,17,0,4,8,29
11971,1702,2022-11-12 10:42:00,f80634555f22b3da630037c0610b5247,0,18,1,0,9,28
11972,1702,2022-11-12 10:47:00,0155cddd8e7a96cf160e7f426dd044d8,0,18,0,3,8,29
11973,1702,2022-11-12 10:52:00,2c07db66b7a100ccce12a07327caa2ef,1,21,2,1,6,31
11974,1702,2022-11-12 10:56:00,d3f3216057d76f74fa26c3fbeed7d5de,1,14,0,2,17,34
11975,1702,2022-11-12 11:02:00,8561b86ae2b8f9f41f70610c28c8df33,0,11,0,3,16,30
11976,1702,2022-11-12 11:07:00,2788a95a20b2224bbdfbb12005cbd742,0,10,0,2,19,31
11977,1702,2022-11-12 11:12:00,8915ef25ad3087810494c74719dd7e25,0,19,0,8,4,31
11978,1702,2022-11-12 11:17:00,b6974c29ad3488059d23176ee2487708,0,9,0,0,16,25
11979,1702,2022-11-12 11:21:00,db40c896f57a17ccb25ee8696d8f0080,0,17,0,2,10,29
11980,1702,2022-11-12 11:27:00,6fc0e22b14fa80d62dfc74c2bc035a14,0,11,0,1,12,24
11981,1702,2022-11-12 11:32:00,7f1aad3caa83403b4c0f4c09c492f61b,0,13,0,0,10,23
11982,1702,2022-11-12 11:37:00,d9093af192e555996359c721487b25f9,0,10,0,5,12,27
11983,1702,2022-11-12 11:41:00,f4eae8f1ae273ecc59bf4503a600e0dc,0,10,0,5,13,28
11984,1702,2022-11-12 11:47:00,63d6a8b94c7e4e82b6522e0f4d957939,1,18,0,2,7,28
11985,1702,2022-11-12 11:52:00,66df2576bceef3eb71ecf2f74526ad8d,0,22,0,1,7,30
11986,1702,2022-11-12 11:56:00,971b66d6d715825524fc9fc7390267f4,0,12,0,2,18,32
11987,1702,2022-11-12 12:02:00,52194b1c1a6323095026f2ee0f29bab5,0,12,0,1,12,25
11988,1702,2022-11-12 12:07:00,b533ce683ff56710675ae006d5bdb602,2,15,0,6,14,37
11989,1702,2022-11-12 12:12:00,3aa133a6e1bd5268f9cdebcd32748a0b,1,14,0,0,7,22
11990,1702,2022-11-12 12:17:00,ddf73ab97e981be1d2d93ace658c7f4c,0,19,0,3,6,28
11991,1702,2022-11-12 12:22:00,ac5ede700c525840a785a063f6d132c7,0,18,0,1,2,21
11992,1702,2022-11-12 12:26:00,c6ec61bc128ce7ea2a10115ba7305b52,0,11,0,1,10,22
11993,1702,2022-11-12 12:32:00,b70ef57467089115401807aef39b5ef1,0,15,0,0,10,25
11994,1702,2022-11-12 12:37:00,786280a8477ef6791e84188efa7c1753,0,15,0,2,7,24
11995,1702,2022-11-12 12:42:00,a783d23728e3a6b0ce638930aec5ade1,0,15,0,0,9,24
11996,1702,2022-11-12 12:47:00,a3f0412392c3800662c7e0db4162ce37,0,12,0,2,10,24
11997,1702,2022-11-12 12:52:00,98074ac4cdbcbabd1aa305e1657b3419,0,11,0,3,11,25
11998,1702,2022-11-12 12:57:00,179e8c1f1277322d1a59cc5120c73e39,0,15,1,1,13,30
11999,1702,2022-11-12 13:02:00,0c8e52325e24ca635e289abc6fda6359,0,17,0,0,14,31
12000,1702,2022-11-12 13:07:00,e2746b5d2907b1e2e34f81e8f20e8b33,0,21,0,3,6,30
12001,1702,2022-11-12 13:11:00,2ca397a158ee0600fe956648ea08f1bb,0,19,0,3,15,37
12002,1702,2022-11-12 13:17:00,31a51d7ba29cb80cfa18368e1b71f56d,0,20,0,2,9,31
12003,1702,2022-11-12 13:22:00,8d3d1f9a6c6e1a577b99a831aae7ebe5,0,15,0,3,8,26
12004,1702,2022-11-12 13:26:00,6f1fa3ab6be3d2aa0877c427e8d3e99c,0,25,0,3,8,36
12005,1702,2022-11-12 13:32:00,7c58b3f160ccbd792110027e6f0406f2,0,24,0,3,9,36
12006,1702,2022-11-12 13:37:00,f684dd3510e13a6bfafc2763a37c47ad,0,27,1,8,6,42
12007,1702,2022-11-12 13:42:00,e168294358e7ee581b803c9d6296c853,0,24,0,1,8,33
12008,1702,2022-11-12 13:48:00,b9b15c656465f88b8788a2eb4d410a2d,0,19,0,0,3,22
12009,1702,2022-11-12 13:52:00,dababa035db27d684029ffb9cdb7d395,0,20,0,2,1,23
12010,1702,2022-11-12 13:57:00,e282135eebb521d93c96f0908e7bb2ad,0,29,0,3,2,34
12011,1702,2022-11-12 14:02:00,5d13a1b9f072152776e4493bb16a420c,1,24,0,6,1,32
12012,1702,2022-11-12 14:07:00,b90b454c4471adf34de6e26e4d3aed85,0,28,0,4,8,40
12013,1702,2022-11-12 14:13:00,5116d0b5ce69f815b60498b2f2e756be,1,27,1,2,3,34
12014,1702,2022-11-12 14:17:00,e4e0ee72dfef64f8adf87a12bf455715,0,23,0,3,8,34
12015,1702,2022-11-12 14:22:00,6943d82be952122520c82d005cd45a02,2,20,0,2,4,28
12016,1702,2022-11-12 14:26:00,6994ad491b0d28eb68552f580fcea8e2,0,18,0,0,6,24
12017,1702,2022-11-12 14:32:00,68bd8c712975d1886f2a3793ae95e586,0,24,0,2,2,28
12018,1702,2022-11-12 14:37:00,e0cc4dedf0f149078fe4cf852fd718a4,0,21,0,6,4,31
12019,1702,2022-11-12 14:41:00,f5639b9f80fd741774c87130e0fe67fe,0,22,0,3,4,29
12020,1702,2022-11-12 14:47:00,095da116e8679f30c9ec3b00bf6a993c,0,16,0,2,3,21
12021,1702,2022-11-12 14:52:00,0b0827fe3a8fca59ebed08f961219070,0,13,0,0,5,18
12022,1702,2022-11-12 14:57:00,3a63cd0b80ac5694fbdf641f6b51fe12,0,19,0,0,7,26
12023,1702,2022-11-12 15:01:00,1992644ea81a56850265bc57b93e8721,0,29,0,0,4,33
12024,1702,2022-11-12 15:07:00,30109fb01d8427a51ea147546c0f2915,0,22,0,6,4,32
12025,1702,2022-11-12 15:11:00,d82c02199aec7c7d9bfa8ec8a3ce13c9,0,22,0,0,5,27
12026,1702,2022-11-12 15:16:00,e890eb5247279c8c4ff3586c88d40651,0,26,0,5,3,34
12027,1702,2022-11-12 15:22:00,767e09645763db7cea6c9051f147910d,0,25,0,0,5,30
12028,1702,2022-11-12 15:27:00,9abfe1fad6ed01ba5b777138e9e7a630,0,19,0,0,7,26
12029,1702,2022-11-12 15:33:00,165dcc8293d2886377ad47e664636aff,0,16,0,2,7,25
12030,1702,2022-11-12 15:37:00,4c9976a42d91fe2013f6195493200686,0,25,0,1,8,34
12031,1702,2022-11-12 15:41:00,b83e6f9dafc82652250cf7ca8344c3a3,0,20,0,4,4,28
12032,1702,2022-11-12 15:47:00,1596a5a765bd24b3dda90d55b0ec2e42,0,21,0,0,1,22
12033,1702,2022-11-12 15:52:00,c3aa8aa93e4a4eb5c463a1af3a38633d,0,19,0,0,4,23
12034,1702,2022-11-12 15:57:00,8d4b2280ac68d34ee4f3bde2e2a8fa18,0,27,0,2,3,32
12035,1702,2022-11-12 16:02:00,0ad84949be103d8635636d521ef12987,0,16,0,4,4,24
12036,1702,2022-11-12 16:06:00,fe53bb5c68d3f935fa8d4c8463d61a23,1,29,0,3,0,33
12037,1702,2022-11-12 16:11:00,8e700337119d4a27aae3b3311a069649,0,20,0,1,1,22
12038,1702,2022-11-12 16:17:00,d441c8b9cf3fbd3fb623b046bd4c01a8,0,18,0,2,2,22
12039,1702,2022-11-12 16:22:00,f111dcee29b031bbf238eb7ec0a8936b,0,23,0,1,5,29
12040,1702,2022-11-12 16:27:00,babd569eeb9a6077e3077601bc1b1c4f,0,22,0,0,4,26
12041,1702,2022-11-12 16:32:00,cf363ed5f01d600e0085fced8a7d68e0,0,18,0,2,2,22
12042,1702,2022-11-12 16:37:00,4081733b10f50c0a91cab85c8a310067,0,22,0,1,1,24
12043,1702,2022-11-12 16:42:00,69812526319dfdef2c1c46e5f3c5b2b2,0,26,0,0,3,29
12044,1702,2022-11-12 16:47:00,7bead170260693548ea3cf7e3f019071,1,21,0,3,2,27
12045,1702,2022-11-12 16:52:00,1d621c5f69c6a86182b64f5765167c5d,1,22,0,0,5,28
12046,1702,2022-11-12 16:56:00,3ecc241c03b8ecdc8c37c6cd478556dd,2,24,0,3,1,30
12047,1702,2022-11-12 17:02:00,f191d4b5fade1050809fa3c317201f6b,0,26,0,2,0,28
12048,1702,2022-11-12 17:06:00,1c87076fa3991dc938fe7d3703a3f2a6,0,29,0,5,0,34
12049,1702,2022-11-12 17:11:00,287fc3a646043780b2666af39f2f6e9a,0,20,0,5,5,30
12050,1702,2022-11-12 17:18:00,9d416926c09a5d2cc74f8e2d23f68092,0,28,0,4,3,35
12051,1702,2022-11-12 17:22:00,b43a37167bc3cee4c8ebebbac9ccc579,0,26,0,1,1,28
12052,1702,2022-11-12 17:27:00,7bb890b2e855c7819d23314b97bf2a2b,0,24,0,1,2,27
12053,1702,2022-11-12 17:31:00,9e11093e746aea6a756fc26b282efba1,1,22,1,1,5,30
12054,1702,2022-11-12 17:38:00,c64b142330c6813c4ed4d719741d1f68,0,21,0,5,4,30
12055,1702,2022-11-12 17:42:00,9a4194dc3fe85aadd35fa09843becdbf,0,17,0,5,9,31
12056,1702,2022-11-12 17:47:00,08737abe23ad957d7c76a8e8878d8fdc,0,20,1,5,11,37
12057,1702,2022-11-12 17:52:00,0684cee9fb0bd63b5d12703405488ece,0,12,0,1,17,30
12058,1702,2022-11-12 17:57:00,728ace5c440948236231df31c2f09fe6,0,23,1,2,7,33
12059,1702,2022-11-12 18:01:00,ed01e9d29a2b9044691f6f0b8ebb7c40,0,25,0,3,7,35
12060,1702,2022-11-12 18:07:00,4e2eac3d8d6bbc64fe8fa3a3a6cd2882,0,23,0,4,5,32
12061,1702,2022-11-12 18:12:00,240200cfa662b025c5fc2648b10f1611,0,26,0,5,5,36
12062,1702,2022-11-12 18:17:00,abd73c4bb95a952d5b4aa057948285f2,0,26,0,1,10,37
12063,1702,2022-11-12 18:21:00,82c0f7cc3a1fa4920835ec18cfb6c968,0,15,0,1,11,27
12064,1702,2022-11-12 18:27:00,bdd695571c2c8bedef251dc757aaef8e,1,17,0,4,3,25
12065,1702,2022-11-12 18:32:00,6a68b2b2c84fe238cd3b2dd1f6baa952,0,25,0,3,4,32
12066,1702,2022-11-12 18:37:00,42da01c4a908f1a5a5d4954d3ccca677,0,19,0,3,5,27
12067,1702,2022-11-12 18:41:00,77cf2ba5799274e194725a0e193f8e24,0,21,1,4,5,31
12068,1702,2022-11-12 18:46:00,ce82eeb8c2c3e6feb03d2c2c7367016f,0,19,0,0,3,22
12069,1702,2022-11-12 18:52:00,2b912ecbb3b45c923122d8338826201d,0,15,1,0,1,17
12070,1702,2022-11-12 18:57:00,e87480f0ac693458cc8134b131d963b7,0,23,1,0,0,24
12071,1702,2022-11-12 19:03:00,ad86fa381ced609fbc5e3da93e176d4f,0,29,4,1,0,34
12072,1702,2022-11-12 19:08:00,31573fd3dec4a87a7eb9f1b9725fff52,1,24,1,1,1,28
12073,1702,2022-11-12 19:12:00,31ec79615b6fa1a12c438a523bdb84ff,1,23,1,2,1,28
12074,1702,2022-11-12 19:17:00,57d2372a0aae7d87d64063f9a3db9e59,0,14,0,2,1,17
12075,1702,2022-11-12 19:22:00,15ac80afc527d2a20edf973a849a5789,0,14,0,0,0,14
12076,1702,2022-11-12 19:26:00,fe5ec17755539265ed344ab01bd6a6f1,0,11,0,1,1,13
12077,1702,2022-11-12 19:32:00,2f225f909b30ba78c4003e4b48c1980c,0,15,0,0,0,15
12078,1702,2022-11-12 19:37:00,040b60ed45e1c4f83374c10d7760de21,0,19,1,0,0,20
12079,1702,2022-11-12 19:41:00,4fd4cefc778414733ccf4b836983f590,0,12,0,2,1,15
12080,1702,2022-11-12 19:46:00,0b4c776632ce4bfd72d2f1c892128b09,0,14,0,1,2,17
12081,1702,2022-11-12 19:52:00,d0e0046c49cd2ee568521bc70469a63b,0,20,3,0,1,24
12082,1702,2022-11-12 19:56:00,ebadbeaf29c54366a5104f0fa1596a6b,0,19,0,1,0,20
12083,1702,2022-11-12 20:02:00,a4d7d26e287d527fb0a322e3ee2871ce,0,10,0,0,2,12
12084,1702,2022-11-12 20:08:00,caf92a995afa2bfbb639e58be8ab43d4,0,17,0,1,1,19
12085,1702,2022-11-12 20:12:00,6a09373bbd4d666d490233c44c22f2b9,0,15,0,0,3,18
12086,1702,2022-11-12 20:17:00,b76ec5a7986f9d2ff21ad7a2559a88be,0,14,0,0,0,14
12087,1702,2022-11-12 20:22:00,f288014093dedba2b34a58bf0ee2ef26,0,21,1,0,1,23
12088,1702,2022-11-12 20:26:00,ff76c12b23ee52621c2013dbc202bc49,0,18,2,0,1,21
12089,1702,2022-11-12 20:32:00,723ab9074e5c92c8bca18c92218613c5,0,14,1,0,2,17
12090,1702,2022-11-12 20:37:00,ba4d1cfe4956c2adfbfb416291bf8e3f,0,10,0,1,0,11
12091,1702,2022-11-12 20:41:00,1332510b86bf0b6089c3b6981bc5a812,0,18,0,0,0,18
12092,1702,2022-11-12 20:47:00,bff4b08d2a901f6ac3d700b858c3a6ca,0,10,0,1,1,12
12093,1702,2022-11-12 20:52:00,1279c324f061757da1e4e223e8b13829,0,18,1,0,1,20
12094,1702,2022-11-12 20:55:00,343475ae445ac2f6f960fafe237cef69,0,19,0,1,0,20
12095,1702,2022-11-12 21:02:00,49a5fc45c26247bb84158312366cb175,0,18,0,0,1,19
12096,1702,2022-11-12 21:07:00,ebb93ed474663fe6fd7c35ef4c698933,0,22,1,0,0,23
12097,1702,2022-11-12 21:12:00,14739413279eb069f4f0774cf30f4a81,0,16,1,2,1,20
12098,1702,2022-11-12 21:16:00,9d1de36c1ae4e23a2fcfdc0c15f8e9d9,0,25,0,2,2,29
12099,1702,2022-11-12 21:21:00,3e636f7a3cd6193ec8bb6fd901ede5a1,0,14,0,1,1,16
12100,1702,2022-11-12 21:26:00,9be150ad470a49b4625b544859ecca8c,0,19,0,0,4,23
12101,1702,2022-11-12 21:32:00,470f18e69912025d9748be58654ac3b1,0,11,0,0,3,14
12102,1702,2022-11-12 21:37:00,c14ce7e0e92e14e2add13450992661dc,0,18,0,1,1,20
12103,1702,2022-11-12 21:42:00,8337d17230ead4c4c784f2259c6ff43b,0,18,1,2,0,21
12104,1702,2022-11-12 21:47:00,ef7a0a1944aeaaaf366319ce8ae97f42,0,17,0,0,0,17
12105,1702,2022-11-12 21:52:00,008fa5d532fb60d25bc4223beaa98bbf,0,13,0,1,3,17
12106,1702,2022-11-12 21:57:00,90b94254bd18ce412eeac2d1eb619b1a,0,19,0,2,1,22
12107,1702,2022-11-12 22:01:00,92955ee2c7ca969222fe32387b600949,0,25,0,0,1,26
12108,1702,2022-11-12 22:07:00,20ec2955642da1d3d86394e403df9817,0,11,0,0,0,11
12109,1702,2022-11-12 22:11:00,b89bde9f8acf8301dce98374692bf037,0,22,0,0,1,23
12110,1702,2022-11-12 22:17:00,d25a0bd98a557da328908652c5df221c,0,14,1,0,1,16
12111,1702,2022-11-12 22:23:00,cfc395ea46d2589d2ca73ef15c609660,0,21,0,0,1,22
12112,1702,2022-11-12 22:27:00,c953a53b53e840a9c806c93fa1769a56,0,16,0,0,1,17
12113,1702,2022-11-12 22:32:00,8cd7b24d55b24ef73ee514184245306b,1,17,0,1,2,21
12114,1702,2022-11-12 22:36:00,a4b95313fe88b0fbea4af8589026f9b1,0,22,2,0,0,24
12115,1702,2022-11-12 22:41:00,39e493474b19227f0d0017c64b7b0056,0,14,0,2,1,17
12116,1702,2022-11-12 22:47:00,357acd742efb44eedcbfa27a120b876e,0,13,2,0,0,15
12117,1702,2022-11-12 22:52:00,eb560f123866872127ae6373de6cb0c8,0,15,0,0,1,16
12118,1702,2022-11-12 22:57:00,6f415a395d7e7f58f3631988fd28e192,0,13,0,0,0,13
12119,1702,2022-11-12 23:02:00,2740eb22f24d5f45244b6f9b8b5d1ba9,1,17,0,0,0,18
12120,1702,2022-11-12 23:07:00,eff6a2e3dbb87d9c84ad401553fa1dde,0,10,1,0,0,11
12121,1702,2022-11-12 23:12:00,3c749873810769a73d2c6e2c1945d2bd,0,14,0,0,4,18
12122,1702,2022-11-12 23:17:00,0d7da8601a34f0762f7d8c94f5bd2b6a,0,17,0,0,2,19
12123,1702,2022-11-12 23:21:00,e9aa5186f6259b4b36f3677643159184,0,12,0,0,0,12
12124,1702,2022-11-12 23:27:00,4918bfd19bec41651d9110c5e4296d46,0,8,0,0,0,8
12125,1702,2022-11-12 23:32:00,89af0a36ff306df60a2b22d997153824,0,14,0,0,1,15
12126,1702,2022-11-12 23:37:00,786cff15f01e902174f38867466907df,0,6,0,2,1,9
12127,1702,2022-11-12 23:42:00,ff5ea07344fd52cf97b42fabc0e632c6,0,18,2,0,0,20
12128,1702,2022-11-12 23:46:00,ea9d17bba4d434f5026f7bce08b4ed0b,0,18,0,0,3,21
12129,1702,2022-11-12 23:52:00,10789e2186e073f6f61ea3f20e899703,0,13,0,1,0,14
12130,1702,2022-11-12 23:57:00,37a52b6c6befe02b3265a9987f09f3bd,0,8,0,1,0,9
12131,1702,2022-11-13 00:02:00,802054713b196a0f44022f22ee983e47,0,15,0,0,1,16
12132,1702,2022-11-13 00:06:00,fabaa73aa13688ae208095cc3ce9c199,0,9,0,0,1,10
12133,1702,2022-11-13 00:11:00,aa90822ad1750a5ef1316cbae0284d84,0,14,0,0,1,15
12134,1702,2022-11-13 00:17:00,d67f09a89f7a844600171ad655522c6a,0,4,0,0,0,4
12135,1702,2022-11-13 00:22:00,7c32b879c2684c0c1c99ced7af2c7b7e,0,12,0,3,0,15
12136,1702,2022-11-13 00:26:00,eade2e696f71049715f16b30cc27c81f,0,8,0,0,1,9
12137,1702,2022-11-13 00:31:00,01157d07180927f68b5e876f3dada6ce,0,11,0,1,0,12
12138,1702,2022-11-13 00:36:00,d0fff56e1c2af8005f4b668be2f118f9,0,7,0,0,1,8
12139,1702,2022-11-13 00:42:00,4ddc190d06c5eb6558ad86cc5a0229a6,0,6,0,0,2,8
12140,1702,2022-11-13 00:46:00,94f3948a4beb1556947c80abba58b326,0,10,0,0,0,10
12141,1702,2022-11-13 00:52:00,e717aa0534ac9ad975fa3f6e32870b1b,0,9,2,0,0,11
12142,1702,2022-11-13 00:56:00,57a5433a79218b9ae846e9c8b8be56eb,0,3,0,0,0,3
12143,1702,2022-11-13 01:02:00,38e9d9ff554e7c12424df2773611a408,0,8,0,0,1,9
12144,1702,2022-11-13 01:06:00,9d5e086cedb3a3cbb85cacf21facf005,0,12,1,0,1,14
12145,1702,2022-11-13 01:11:00,371582dda9aa58c985506a996a446f9e,1,13,0,0,0,14
12146,1702,2022-11-13 01:17:00,e05a2bf6c431b24fd8a5ed4041b62158,0,11,0,0,0,11
12147,1702,2022-11-13 01:23:00,b8951ffb61d8ca68a011c249bd629da8,0,12,1,0,0,13
12148,1702,2022-11-13 01:26:00,d7a4d4e910197ab9720b3b94ebc7c068,0,9,0,0,2,11
12149,1702,2022-11-13 01:32:00,dbec9fe84fa86cd69ab0d7df9736a0dd,0,8,0,0,1,9
12150,1702,2022-11-13 01:37:00,4ed59abc2da6cbd721ae7f095803f16d,0,8,1,1,0,10
12151,1702,2022-11-13 01:41:00,17550c42ef2b0e502e8fa926f3700291,0,5,0,0,1,6
12152,1702,2022-11-13 01:46:00,c398dd85a1fcda1fa0a67b0c40c56366,0,6,1,0,0,7
12153,1702,2022-11-13 01:52:00,577c99939ddeba4791a5c0e5bfcd9c73,0,12,1,1,0,14
12154,1702,2022-11-13 02:01:00,af5db631c71adc1640a578ceb6504918,0,5,1,0,0,6
12155,1702,2022-11-13 02:07:00,e76cae2ab5f32c95ed4b9a454aaaee11,0,6,0,0,0,6
12156,1702,2022-11-13 02:12:00,17f85c61144a4d0cb82039ec82cf13e0,0,3,1,0,0,4
12157,1702,2022-11-13 02:17:00,07b1d0ee1ed8a368728f686fc245a932,0,10,2,0,0,12
12158,1702,2022-11-13 02:22:00,f9126b48a272b099534a45d84c8d5d9a,0,7,0,0,0,7
12159,1702,2022-11-13 02:26:00,296f304c2058f66aaa6254a797d38d19,0,4,0,0,0,4
12160,1702,2022-11-13 02:31:00,2b52da100c502fd6c1b994db4e5a5a87,0,7,0,0,1,8
12161,1702,2022-11-13 02:37:00,1d18b1333c6d59cddcabdc2d5ee8fec1,0,7,0,0,0,7
12162,1702,2022-11-13 02:42:00,e56128d8003f7254ccd074870fe7a185,0,8,0,0,1,9
12163,1702,2022-11-13 02:46:00,6e691a2c0b8e2e84bc94644712a7ad47,0,8,0,0,0,8
12164,1702,2022-11-13 02:52:00,521fd6d785bd11053c7a060ba27804e3,0,8,0,1,1,10
12165,1702,2022-11-13 02:56:00,84cf2737a7a8a51cff626914168778a1,0,2,0,0,1,3
12166,1702,2022-11-13 03:02:00,e0dea34b333ee94582722b5302ef230c,0,6,0,0,0,6
12167,1702,2022-11-13 03:07:00,2362e1ec8fa90ca34a6c1cc3b9c8bdae,0,3,0,1,1,5
12168,1702,2022-11-13 03:11:00,09378f4a57341c250c18043e025c569d,0,8,2,0,1,11
12169,1702,2022-11-13 03:17:00,3d77688573892001e0c346bf0accd951,0,3,3,0,0,6
12170,1702,2022-11-13 03:22:00,d1c9c9b10420b5dc83397514a14faaca,0,4,0,0,0,4
12171,1702,2022-11-13 03:27:00,ef4e6ce0dd8235627bfc9fd4655c0f0b,0,6,0,0,0,6
12172,1702,2022-11-13 03:32:00,56035bfb37a009100277e25f652b4eb7,0,6,0,0,0,6
12173,1702,2022-11-13 03:37:00,9476b5dbb47383708fd00a3df5aab04e,0,11,0,0,0,11
12174,1702,2022-11-13 03:42:00,60dc7928f860126dacd87e07fac82791,0,6,0,0,0,6
12175,1702,2022-11-13 03:47:00,3451f12f49664fd2dedc11d743fe50cb,0,7,0,0,1,8
12176,1702,2022-11-13 03:51:00,8a020a3e1994b7cc28fb2d3337522bff,0,1,1,0,0,2
12177,1702,2022-11-13 03:56:00,1706c82e75694f38751e0248b5ef25a9,0,16,0,0,2,18
12178,1702,2022-11-13 04:02:00,3e77b1986ad81ff4cde50d966aacfb42,0,3,0,0,1,4
12179,1702,2022-11-13 04:06:00,3bc0eda46d786329a05b3899a0d4db6a,0,6,0,0,0,6
12180,1702,2022-11-13 04:12:00,2488779b9526dfdc558597aad09c541f,0,13,0,0,0,13
12181,1702,2022-11-13 04:17:00,225e0a526583d86f9766842a48456112,0,7,0,0,0,7
12182,1702,2022-11-13 04:21:00,817c58bc739f3237f5100ef38938d579,0,10,0,0,0,10
12183,1702,2022-11-13 04:26:00,a1561d9e9e6675f6902d738022110890,0,9,0,0,0,9
12184,1702,2022-11-13 04:32:00,1aa5e3c32c1d8fba656e28afaac07481,0,1,0,0,1,2
12185,1702,2022-11-13 04:36:00,2832f2900e3ed9dd4470fb96046d561e,0,4,0,0,1,5
12186,1702,2022-11-13 04:41:00,58fd310afadc016e4adcfb92b070f43e,0,3,0,0,0,3
12187,1702,2022-11-13 04:47:00,7824a6b93336f395d0ad69836340196e,0,1,0,1,0,2
12188,1702,2022-11-13 04:51:00,75bd08e46b438599a1b32680a1f7aaa3,0,11,0,0,0,11
12189,1702,2022-11-13 04:57:00,4367a3576a375642d40868de855b5617,0,2,0,0,0,2
12190,1702,2022-11-13 05:02:00,e310c4c4b5ac7a22e04741697c6574a5,0,11,0,0,0,11
12191,1702,2022-11-13 05:07:00,89dcddf4a30e67f378eeb7b76c66b7c4,0,1,2,0,0,3
12192,1702,2022-11-13 05:12:00,752b6c7dd42cf9b29a112a2db14d02c6,0,3,0,0,0,3
12193,1702,2022-11-13 05:17:00,d0ec8bacecbd39dbe542dffcc5c0a0b8,0,6,0,2,2,10
12194,1702,2022-11-13 05:22:00,9a20bebc7b282291b59598fbe3b4fd2a,0,5,0,0,1,6
12195,1702,2022-11-13 05:26:00,bc3b37b449adb6560d7f9b746c2fd1b4,0,5,0,0,0,5
12196,1702,2022-11-13 05:31:00,430fef052cf5e3b8078efab3847d14b9,0,8,0,0,1,9
12197,1702,2022-11-13 05:36:00,8220b59843ab27e46a886fa5170bb9a0,0,3,0,2,0,5
12198,1702,2022-11-13 05:41:00,d920cc4c9b7fc5ddcbbdb5dce7b6bc63,0,5,0,0,0,5
12199,1702,2022-11-13 05:47:00,264a5ff52603005bba241617c7616ad0,0,5,1,0,1,7
12200,1702,2022-11-13 05:51:00,3d4ff52ba7b222130ac80156761a1ba9,0,8,0,0,0,8
12201,1702,2022-11-13 05:56:00,06a2561afdda722d122fba785f5f30c2,0,3,0,1,0,4
12202,1702,2022-11-13 06:02:00,f6ae67ad1f9f65fbdd7c87003f941fea,0,6,0,0,1,7
12203,1702,2022-11-13 06:06:00,69d2c35722ff76d147f50ee4863ee818,0,5,0,0,0,5
12204,1702,2022-11-13 06:12:00,5cd25ed59cd2bf729f2e18c127005ea3,0,2,0,1,1,4
12205,1702,2022-11-13 06:16:00,9fedcf5b60a3a0430bcd178d6e6716a5,0,6,1,0,0,7
12206,1702,2022-11-13 06:22:00,5e02c7794f24a0447d5ba32f2d1d4bc6,0,7,0,1,1,9
12207,1702,2022-11-13 06:27:00,fd8ff44a1014fd6c2908bb29e884505c,0,9,0,1,0,10
12208,1702,2022-11-13 06:32:00,56abc2bcece790c5978ddc6369469720,0,12,1,0,1,14
12209,1702,2022-11-13 06:36:00,44d9dcedc762967693e5022c6accd503,0,15,0,0,1,16
12210,1702,2022-11-13 06:42:00,5db87996f0305b5fd5de413d1e9a380b,0,15,2,1,2,20
12211,1702,2022-11-13 06:47:00,05d95a584945b81d7f337baaf140a63e,0,9,0,1,5,15
12212,1702,2022-11-13 06:53:00,239e7b5b143a0910704acd43e989f081,0,12,1,1,2,16
12213,1702,2022-11-13 06:57:00,1e8cc76aa505012f47ef273c5ead08dc,0,9,0,1,4,14
12214,1702,2022-11-13 07:02:00,0653c8e6706f4717d7d09146aba34504,0,11,0,0,3,14
12215,1702,2022-11-13 07:07:00,b385289318409c7772d338abf72af73c,1,10,0,1,4,16
12216,1702,2022-11-13 07:11:00,2eb9f95b29d2f304a3ada3acc1dca2ce,0,7,0,1,4,12
12217,1702,2022-11-13 07:17:00,2af81b06615cdb561d9bef504b245d27,0,9,0,1,3,13
12218,1702,2022-11-13 07:22:00,42ffc89d2caabd5cd8ced3f246d099eb,0,11,0,1,4,16
12219,1702,2022-11-13 07:27:00,56a1a1aa48da0bcc31c6f6b394bdfdc0,0,11,0,0,6,17
12220,1702,2022-11-13 07:32:00,22e36a52809942cd3d2f56a2c3bd825f,0,10,0,1,6,17
12221,1702,2022-11-13 07:36:00,40da74cac7af3edb690d1f6a2ecae35a,0,13,0,1,5,19
12222,1702,2022-11-13 07:41:00,69a2dcdff210cc5da5c519ffbb0a6efb,0,13,0,1,3,17
12223,1702,2022-11-13 07:47:00,730dd932be65b19d041b9c65cdb5d761,0,11,0,3,7,21
12224,1702,2022-11-13 07:51:00,11ff7bfbaed55e3eac0487248d194028,0,10,1,0,6,17
12225,1702,2022-11-13 07:57:00,8c6d5cf74c1f62647c70e03b3e800be5,0,8,0,0,3,11
12226,1702,2022-11-13 08:02:00,26f67c14bb6f3d416bf292ac66c62777,0,12,0,0,4,16
12227,1702,2022-11-13 08:07:00,5f841176e1707f7f5e1a50312ba8a138,0,8,0,1,4,13
12228,1702,2022-11-13 08:12:00,00417b74c69075ae478f34baf5c1097e,0,10,0,0,6,16
12229,1702,2022-11-13 08:17:00,3e0a2fd6565340436947ab2ebc68e4de,0,11,0,0,4,15
12230,1702,2022-11-13 08:22:00,36af3f199f7ddc0ebbda2528513f244d,0,9,0,1,10,20
12231,1702,2022-11-13 08:28:00,fc6200c50ba09b0810a1e98a107f9458,0,13,0,1,4,18
12232,1702,2022-11-13 08:33:00,8b1a41fd721ea81b56488ddf04622ab6,1,11,0,2,2,16
12233,1702,2022-11-13 08:37:00,5e9337e7ada224c075ef5cb58dde6855,0,9,0,2,8,19
12234,1702,2022-11-13 08:42:00,9e50bd45c8eaf1822c972e1ada449104,0,3,0,0,5,8
12235,1702,2022-11-13 08:48:00,4bf41de88abf47d5fdda417a4c5b8ab1,0,15,0,1,3,19
12236,1702,2022-11-13 08:53:00,ff42c7b28a2e8541ac87ddf00d57a153,0,17,0,0,4,21
12237,1702,2022-11-13 08:57:00,97827eb84f28b90d544b40245fc2baf6,0,13,0,2,3,18
12238,1702,2022-11-13 09:02:00,5582d722c1b51a283413bc3b983a299b,0,8,0,0,5,13
12239,1702,2022-11-13 09:08:00,bf47b09d1fc43e9fc7304d2fde7af10d,0,13,0,3,10,26
12240,1702,2022-11-13 09:12:00,78d586cd0a1f3822f709bbd07a39330f,0,17,0,1,2,20
12241,1702,2022-11-13 09:18:00,3a322535067b4f8f147b34d832c09219,0,13,1,2,5,21
12242,1702,2022-11-13 09:23:00,c41aa3552737c0e82dd704d28a6f6dd9,0,17,0,1,7,25
12243,1702,2022-11-13 09:27:00,8c7fafc7919d53af8bdf46d71d8a6620,0,16,0,2,8,26
12244,1702,2022-11-13 09:32:00,a45ccd838cfc75335d7f675e625d8d7c,0,14,0,2,10,26
12245,1702,2022-11-13 09:38:00,55858e4ce55e687a6be54ff539db4a87,0,18,0,1,2,21
12246,1702,2022-11-13 09:42:00,74ed2822d9c0f120e0bb092c6f349aec,0,15,0,2,10,27
12247,1702,2022-11-13 09:47:00,ba7585a975a56ab408d60226bc67460d,1,19,0,3,2,25
12248,1702,2022-11-13 09:53:00,31f229ae083f77beeaa43511c41770d2,0,23,0,2,7,32
12249,1702,2022-11-13 09:57:00,926b90337edd554aa011f24ecdc27b37,0,12,0,0,4,16
12250,1702,2022-11-13 10:03:00,5bcfb804ddaeba20f859ebe0f13285a4,0,15,1,0,2,18
12251,1702,2022-11-13 10:07:00,8d630177caa31cda558ac55e89dad0b1,0,11,0,3,11,25
12252,1702,2022-11-13 10:12:00,794452a8d8e57988d4ab6bf2656505ca,0,12,0,2,9,23
12253,1702,2022-11-13 10:18:00,7c3dd5b2e5af23e429d5279826dd475d,0,18,0,1,11,30
12254,1702,2022-11-13 10:23:00,bddca68d2ed124121e8ab160a59f6688,0,17,0,2,5,24
12255,1702,2022-11-13 10:28:00,df37ffdd4a0f6b3888eaf691490b7fd1,0,14,0,1,13,28
12256,1702,2022-11-13 10:32:00,5b29108a65f2819c61b2190b3d6cc244,0,24,0,2,6,32
12257,1702,2022-11-13 10:37:00,eea3b2756a243143cd1105ae87857ad7,0,14,0,2,6,22
12258,1702,2022-11-13 10:42:00,09390dd159571d6ff3c37bd71a1312ea,0,18,0,1,9,28
12259,1702,2022-11-13 10:47:00,ab0a59e54b5725559237c76e0646386f,0,11,0,0,11,22
12260,1702,2022-11-13 10:52:00,56e41595667de50264bc37ec678c33ab,0,18,0,2,8,28
12261,1702,2022-11-13 10:57:00,b178d3ea136c062e7819e53efc7f348e,0,9,0,2,8,19
12262,1702,2022-11-13 11:03:00,b195c42578d41cc253bfe04e9b144da4,0,6,0,3,12,21
12263,1702,2022-11-13 11:07:00,89beca7f161653c08473ccf54d3f1cbf,0,13,0,3,12,28
12264,1702,2022-11-13 11:12:00,993d5e3ee934fc8c141a5d4768dc5954,0,12,0,3,6,21
12265,1702,2022-11-13 11:17:00,c0d5c000080d205bde737492d47cbbc8,0,18,0,2,9,29
12266,1702,2022-11-13 11:22:00,473e7616a705a5563b81dd25e6daaf42,0,13,0,2,7,22
12267,1702,2022-11-13 11:27:00,6f0673ce091bde4a47e59577963feb5a,0,18,0,1,7,26
12268,1702,2022-11-13 11:32:00,684dc082821dff95dca7f1860ee653e2,2,12,1,0,11,26
12269,1702,2022-11-13 11:37:00,6cf15c2941e430d521555b23fa375450,1,13,1,2,8,25
12270,1702,2022-11-13 11:42:00,f3ee807838b2481dbbb314996c89685e,0,14,1,0,7,22
12271,1702,2022-11-13 11:47:00,f80b1a268cd41eba43d4fa15c737487b,0,20,0,0,8,28
12272,1702,2022-11-13 11:52:00,3fec0599685f0bddee4722354f0e8b08,0,8,0,2,11,21
12273,1702,2022-11-13 11:57:00,b48d0629f1e081e43f69f6b0c090809e,0,11,0,2,12,25
12274,1702,2022-11-13 12:02:00,b66a3490ac9094d7dd21ecfdbf5e4436,1,19,0,1,9,30
12275,1702,2022-11-13 12:07:00,4bc75efd208acef4b4a8d22fb0ad46ee,0,26,1,1,11,39
12276,1702,2022-11-13 12:12:00,da2c9a88f53f3524685487e99fb644bc,0,21,1,7,8,37
12277,1702,2022-11-13 12:18:00,05788074822628a2404c6ad38e8cffc7,1,18,1,5,9,34
12278,1702,2022-11-13 12:22:00,9c23f380e894066c45d442e175f7146a,0,17,0,2,15,34
12279,1702,2022-11-13 12:27:00,478592da11f3c41e7fe01f2c5adfe496,0,22,0,1,7,30
12280,1702,2022-11-13 12:32:00,daa153f4f449e0c3720eb28e02c139b6,0,17,0,0,9,26
12281,1702,2022-11-13 12:37:00,c6c943f466cb1ee38c8728b76b5e9e16,0,15,0,7,9,31
12282,1702,2022-11-13 12:42:00,48b53f5991b40ec4d54f73daf6eb5e31,0,22,0,2,7,31
12283,1702,2022-11-13 12:47:00,b80575699eabc7acd2145c2557161c96,0,18,0,3,8,29
12284,1702,2022-11-13 12:52:00,944c9ea2fb7f466917c511b84888f2d9,0,16,0,0,11,27
12285,1702,2022-11-13 12:56:00,8037929f4a43f73e28fb33052b4fa781,0,13,0,3,9,25
12286,1702,2022-11-13 13:02:00,662c93392a0b3a14392bcac0dfd1b135,0,16,0,3,9,28
12287,1702,2022-11-13 13:07:00,ff368fa38c63e8ed0a7369816a63de82,0,9,1,1,12,23
12288,1702,2022-11-13 13:12:00,5cb26b4bd4547384af9cf5838e3e422a,0,11,0,2,7,20
12289,1702,2022-11-13 13:17:00,b08ad8196f9f34e902f58e7f9b037986,1,17,0,0,7,25
12290,1702,2022-11-13 13:22:00,03cf8eee04626e8ec5561c34ce21af88,0,17,0,5,4,26
12291,1702,2022-11-13 13:27:00,366f6617b30ca913bb5b6902dc38c2f2,1,16,0,0,7,24
12292,1702,2022-11-13 13:32:00,5d8702a338b33b308aa06c7a81a2cdae,1,16,0,1,5,23
12293,1702,2022-11-13 13:37:00,e622760df03ae354cc1fc622752385ce,0,13,1,3,4,21
12294,1702,2022-11-13 13:42:00,461f7bedc9943fc159dc5c9d8d9dedec,0,17,1,0,5,23
12295,1702,2022-11-13 13:47:00,f5f84158fd384ac61d91c6613a26de33,0,22,0,3,10,35
12296,1702,2022-11-13 13:52:00,7a53de9dd8fbd18723fee2ab792d8bcc,0,17,0,4,10,31
12297,1702,2022-11-13 13:56:00,d58e657c7c2a99fc24a857cf8888aef1,0,15,0,0,11,26
12298,1702,2022-11-13 14:02:00,9d72f7413e559d701fd2eb425961b880,0,20,0,0,9,29
12299,1702,2022-11-13 14:08:00,3b53bb90a26f95c88ecb9a33923d6ef7,0,16,0,0,6,22
12300,1702,2022-11-13 14:11:00,d5eb9b5b8e2277f30756e01b19c1d2d8,0,20,0,1,8,29
12301,1702,2022-11-13 14:16:00,2361b99fcccc1b55fedf3e195696fab1,0,24,0,1,1,26
12302,1702,2022-11-13 14:22:00,fc4cf4d8c2c71a6eb969640f8eaf6e34,0,22,0,2,1,25
12303,1702,2022-11-13 14:27:00,24eeff6b6c6065673bc1dcc946854898,0,25,0,3,2,30
12304,1702,2022-11-13 14:31:00,acf11b9c2d9cc9f3cdd76820e63b0d15,0,30,0,1,1,32
12305,1702,2022-11-13 14:36:00,173f6847f3a4238af80afee9014b0829,0,28,0,4,0,32
12306,1702,2022-11-13 14:41:00,5ffacd00619e5fdfcb9bfddd7c68945d,1,26,0,3,0,30
12307,1702,2022-11-13 14:47:00,111bc04134e9a0cb26af7314f13c78d5,0,28,0,2,0,30
12308,1702,2022-11-13 14:52:00,ad22883c5a46200d0194dda8d4dc1260,0,27,0,0,3,30
12309,1702,2022-11-13 14:56:00,d60a6ba20e338b90918f7c8c459d8e22,0,14,0,0,7,21
12310,1702,2022-11-13 15:01:00,a6bc6740737edcf355177e9a8482aadf,0,20,0,1,3,24
12311,1702,2022-11-13 15:07:00,53b124048688b882c662d6a545c95e0a,0,18,0,0,0,18
12312,1702,2022-11-13 15:11:00,8612dc1852f7a3b6733b58a4c75d6ade,0,24,1,1,0,26
12313,1702,2022-11-13 15:17:00,aa24ce0ce037575233fc317ad0275590,0,19,0,1,3,23
12314,1702,2022-11-13 15:21:00,059d9f74d1042e6a50e4177e274b294e,0,19,0,0,6,25
12315,1702,2022-11-13 15:26:00,cb58e209f91f79bb01cc043888293238,0,20,0,1,5,26
12316,1702,2022-11-13 15:31:00,21077e268da68ddcf5872dedd1595ad6,0,23,1,0,1,25
12317,1702,2022-11-13 15:38:00,7f4df3723c9ec5b7e81491bb2a61dd94,0,25,0,3,0,28
12318,1702,2022-11-13 15:42:00,009d33cd59d3be0c92105e999d17d18b,0,21,0,1,2,24
12319,1702,2022-11-13 15:47:00,6f4431f6315ef6e46766c6fcf0f11696,0,15,0,1,0,16
12320,1702,2022-11-13 15:52:00,8177305ffa3f4d87cf260e4fa79cf164,0,15,0,0,1,16
12321,1702,2022-11-13 15:57:00,d60ca5afd0b5df21a149204706acd720,0,17,0,1,2,20
12322,1702,2022-11-13 16:02:00,1b80f6df46681150506d9cc6989c3060,0,14,0,0,0,14
12323,1702,2022-11-13 16:07:00,89a6c24537d0cfe3c92627d9e3f69e8d,0,16,0,2,5,23
12324,1702,2022-11-13 16:11:00,c959dc05f72d7eae575da5668d0dbcbe,0,19,0,2,5,26
12325,1702,2022-11-13 16:17:00,1c456fcbd2bbedbf9d77e634f0ceef7e,0,22,0,4,4,30
12326,1702,2022-11-13 16:22:00,5df2fcabea862eb8a88b099346e5d521,0,19,0,0,7,26
12327,1702,2022-11-13 16:26:00,b1fbcc2b12a22ec404d93856ed7cfe39,0,15,0,1,8,24
12328,1702,2022-11-13 16:32:00,0ffa5b9f5421b826d87a098fa02f61e8,0,18,0,0,5,23
12329,1702,2022-11-13 16:37:00,1920fecbeb4639396a98cff44b4d83ac,1,16,2,1,4,24
12330,1702,2022-11-13 16:41:00,72a92736cf3342df7a5af3531198465e,0,18,0,1,4,23
12331,1702,2022-11-13 16:47:00,c82d5e587021ea0ce074f1bcc088cfbc,0,15,0,2,5,22
12332,1702,2022-11-13 16:52:00,56b5e30591c12ab77effff96a8de32dc,0,17,0,3,8,28
12333,1702,2022-11-13 16:57:00,52e8505a94c29e76d9a5f97d68aedab3,2,20,0,2,11,35
12334,1702,2022-11-13 17:01:00,251da8cf7b76ed7078835796da83f4ac,0,16,0,1,4,21
12335,1702,2022-11-13 17:07:00,4ab6818c146f1c29f68b76cb80d08312,0,14,0,0,13,27
12336,1702,2022-11-13 17:12:00,0d01a3fd8a0fb3b478e528aea401c89a,0,13,0,1,15,29
12337,1702,2022-11-13 17:18:00,7f28db40469fcf2a2aebf4282afebfe8,0,14,1,1,7,23
12338,1702,2022-11-13 17:23:00,b51b2cf164e917be5f366bf5926c2149,0,21,0,0,8,29
12339,1702,2022-11-13 17:26:00,dd629a53aacc554199c03016ee3b1a9e,0,19,0,2,4,25
12340,1702,2022-11-13 17:32:00,fcf30c65fd6b6586806d73189ee03810,0,11,0,0,11,22
12341,1702,2022-11-13 17:37:00,d4bb71a1f41aa08423178fee0e4de201,0,13,0,0,7,20
12342,1702,2022-11-13 17:41:00,5e2642daebc30d9e9b656fdd10d2fc97,0,15,1,0,7,23
12343,1702,2022-11-13 17:47:00,9ab8279ca2e6757b0f4ab171432d2a1d,0,12,0,2,5,19
12344,1702,2022-11-13 17:52:00,6e3034aa0c3e2f9997c8133852953b55,0,15,1,1,7,24
12345,1702,2022-11-13 17:57:00,4d0f204e470140556be273adafcbea05,0,15,0,2,6,23
12346,1702,2022-11-13 18:02:00,31eba1b7920dda4e02ecd61ee10a7e62,0,12,0,0,11,23
12347,1702,2022-11-13 18:08:00,4d403507cd9e5730ead8baaa6a83857e,0,18,0,0,11,29
12348,1702,2022-11-13 18:12:00,366f22485c97765337166eda6918f587,0,24,1,5,4,34
12349,1702,2022-11-13 18:17:00,b536ef74970ba37aee25bba778d91e82,1,14,0,0,13,28
12350,1702,2022-11-13 18:22:00,bab2798111ed478d0e517275b5440f01,0,11,0,1,9,21
12351,1702,2022-11-13 18:27:00,cd1e4d81a583b73cfb4d54e8385c8f55,0,19,0,1,2,22
12352,1702,2022-11-13 18:32:00,f44159e43f8c6b05578d81b3406e6cdc,0,16,1,1,9,27
12353,1702,2022-11-13 18:37:00,81d2dbff78af7a45c8b7cd32d85d5f3c,0,23,1,2,6,32
12354,1702,2022-11-13 18:41:00,c3c35ab92dbf038582cc79645cc2c2f0,0,19,0,1,5,25
12355,1702,2022-11-13 18:47:00,339ee88d1a8d3284475509dc76b30f79,0,21,0,1,8,30
12356,1702,2022-11-13 18:51:00,9cd61955ae063ef1bd82e31c4b63714d,0,16,0,0,3,19
12357,1702,2022-11-13 18:56:00,17c1f87e49520dfff7976342010e1470,0,27,0,0,5,32
12358,1702,2022-11-13 19:02:00,1021d4ab1eb4719e84afbed0c2775b7e,0,23,2,0,1,26
12359,1702,2022-11-13 19:06:00,4a75f979ba220687deebc4ebade9bb67,0,19,0,2,3,24
12360,1702,2022-11-13 19:11:00,52082866f47df71d866ca33c9c48acf2,0,15,0,0,0,15
12361,1702,2022-11-13 19:18:00,b274eaa0df7ad83545bd9c8cb46b7ea9,0,21,0,2,1,24
12362,1702,2022-11-13 19:22:00,32f10d6899c0a998c8db7fee6e6a813a,0,15,0,1,2,18
12363,1702,2022-11-13 19:27:00,cefb6201977a8583121d0a0a8599fd8a,0,21,1,0,1,23
12364,1702,2022-11-13 19:32:00,1feceaaf7064e6a2c25c71a78dc67e7b,0,16,0,1,0,17
12365,1702,2022-11-13 19:37:00,1f1b68b86cec35ac3a190c58feb22b76,0,16,0,0,0,16
12366,1702,2022-11-13 19:41:00,e926363fa68dc616f74b5a9abc4e6beb,0,14,1,0,0,15
12367,1702,2022-11-13 19:46:00,4a896cc4eed202cfce1779e655088848,0,14,0,0,0,14
12368,1702,2022-11-13 19:52:00,91242e6bbbf29825294aadb145c9ccdc,0,22,0,0,1,23
12369,1702,2022-11-13 19:56:00,86547603f7f89a524b36c98886be4e21,0,11,1,1,0,13
12370,1702,2022-11-13 20:03:00,9b556f27d264214002f74e2c0be0ddb5,0,16,0,0,1,17
12371,1702,2022-11-13 20:07:00,d472df3c36d32082ba631636baa4c62e,0,13,0,1,0,14
12372,1702,2022-11-13 20:11:00,6d399cd50489a4c3bdcb5cebab333a16,0,16,0,0,1,17
12373,1702,2022-11-13 20:17:00,70725885c8192c74baeb5d2440793fa2,0,15,0,0,1,16
12374,1702,2022-11-13 20:22:00,2aa627a9c9b9284cc94a27ac484fd19e,1,14,0,0,2,17
12375,1702,2022-11-13 20:27:00,97d3c5d1800ff8332d515b82b5f3e81c,0,15,0,1,0,16
12376,1702,2022-11-13 20:32:00,4debd7965573773bb8eadd80e9ca2ac8,0,24,0,0,0,24
12377,1702,2022-11-13 20:37:00,6c8fa6cda6991738d7df5706cb494215,0,18,0,0,0,18
12378,1702,2022-11-13 20:42:00,c1b2f01c3c30ae65a24fb2a478fc42bf,0,21,0,3,2,26
12379,1702,2022-11-13 20:47:00,563d7a055fad647b26da407e738cb340,0,14,0,2,0,16
12380,1702,2022-11-13 20:51:00,47d4ba523f085ca0eeb46c92eefc3d43,0,12,1,2,0,15
12381,1702,2022-11-13 20:57:00,5d835c49d495fce56139797e82a906b1,0,15,1,0,3,19
12382,1702,2022-11-13 21:02:00,75be7c640654371311ad005b96f9cb81,0,23,0,0,1,24
12383,1702,2022-11-13 21:07:00,6b071bd28d749eb377c9c77f06922a27,0,8,0,1,0,9
12384,1702,2022-11-13 21:11:00,9e0a5e3f1571d3406e5384b966c6387c,0,20,0,0,0,20
12385,1702,2022-11-13 21:17:00,b78890965f120cb38ba5c35b30eeef7b,0,12,1,0,1,14
12386,1702,2022-11-13 21:22:00,767136b355c2d55bbc04ada1561967d7,0,12,2,0,0,14
12387,1702,2022-11-13 21:27:00,bcf41b7975007ce1ea91df6e98a604bc,0,16,0,0,0,16
12388,1702,2022-11-13 21:32:00,d5b20df9a3a67aa69c7408a0b7b2ea10,0,21,0,0,0,21
12389,1702,2022-11-13 21:41:00,aeea796b4122e69f39f62a9cdf53a08f,0,11,0,0,0,11
12390,1702,2022-11-13 21:47:00,ee5d8bd066001f501686077eaf7fe6b1,0,18,1,0,0,19
12391,1702,2022-11-13 21:51:00,450ac781d0181f74bc00b56424a73e81,0,13,0,1,0,14
12392,1702,2022-11-13 21:57:00,bccda2d6779cf84256f8fbfdad6e6383,0,19,0,0,2,21
12393,1702,2022-11-13 22:02:00,fd5c7cac646079f38d98ed16ab0f3c65,0,16,2,0,1,19
12394,1702,2022-11-13 22:06:00,3749f7b12d1a3837da391786e1522fa3,0,17,0,2,0,19
12395,1702,2022-11-13 22:11:00,03b3e2fc802b7d61aa5fe77683164b13,0,21,0,1,1,23
12396,1702,2022-11-13 22:17:00,e7d83f4b79398d3b68f061d4c5b8317d,0,15,0,0,2,17
12397,1702,2022-11-13 22:22:00,cf8230a7d49906f7e137f49785afb362,1,17,0,0,0,18
12398,1702,2022-11-13 22:26:00,bd4e4d233463e5e155ae09dc05031587,0,9,1,0,2,12
12399,1702,2022-11-13 22:32:00,d54bf4dff10e3e08bd84cd7aca0f6f5a,0,21,0,0,1,22
12400,1702,2022-11-13 22:37:00,46271d57b9713de66ac51313e08b7b77,0,7,0,0,3,10
12401,1702,2022-11-13 22:41:00,48d1eb9e9383aacee4bd8fbd1e01c01f,0,11,0,0,0,11
12402,1702,2022-11-13 22:47:00,4dee8f3f908dff716e5e933d6ea9f10a,0,13,0,0,0,13
12403,1702,2022-11-13 22:53:00,887063f6eea247a7ce654b235e665c70,0,11,1,1,0,13
12404,1702,2022-11-13 22:56:00,a617de06e7489f88bea81dfcfda3605e,0,12,0,1,3,16
12405,1702,2022-11-13 23:02:00,f04701a76a64166d0487d6aeb801f7fd,0,13,1,1,2,17
12406,1702,2022-11-13 23:05:00,57cdcee293c95522e52eca1519501c26,0,5,0,1,0,6
12407,1702,2022-11-13 23:11:00,dc340623b68d0ca424e7ebd652efbdba,0,14,0,0,1,15
12408,1702,2022-11-13 23:17:00,ec71f2abc2f5a58122e1bc867e228018,0,9,0,0,0,9
12409,1702,2022-11-13 23:21:00,4d6c23fed51dbb5557890ae6e6a1858a,0,1,3,0,0,4
12410,1702,2022-11-13 23:26:00,53fa26512f44d3eace77c9fd56733756,0,2,0,1,0,3
12411,1702,2022-11-13 23:32:00,60db0195d1b89292935ec0a08ba64663,0,5,0,1,0,6
12412,1702,2022-11-13 23:37:00,25a5c66029ede5761183428bb42ba0c5,0,1,0,0,0,1
12413,1702,2022-11-13 23:41:00,150d983e3e6dd9665192debad2307e84,0,6,2,0,0,8
12414,1702,2022-11-13 23:47:00,1fc11b47b01e02e1538315a7dea7313f,0,9,0,0,0,9
12415,1702,2022-11-13 23:52:00,c0a7b9989cb117d0f8fbd9c76dd959b9,0,1,0,0,0,1
12416,1702,2022-11-13 23:56:00,2ba57e1781c5d9649ac13247629585ee,0,7,0,0,0,7
12417,1702,2022-11-14 00:02:00,882c7ef542ec0ba056b0387f7b3d7fcc,0,8,0,0,0,8
12418,1702,2022-11-14 00:07:00,dd69e6d96bce7d9de8ed5111cba641ec,0,5,0,0,0,5
12419,1702,2022-11-14 00:11:00,d75828240534b70981a88d4812698a1e,0,2,0,0,0,2
12420,1702,2022-11-14 00:17:00,b4c82bee6f7de4c3bccde829f456278f,0,7,0,0,0,7
12421,1702,2022-11-14 00:22:00,8d0a00d43a550fb96e049b779e7ae4d0,0,0,0,0,1,1
12422,1702,2022-11-14 00:27:00,3b30a3bb76151534a6aec168eaccba8a,0,1,0,1,0,2
12423,1702,2022-11-14 00:32:00,f128f49dc4ce52fa260a98a6c8dd662d,0,0,0,0,0,0
12424,1702,2022-11-14 00:37:00,cdca4f8aa0aa5d08216204542f2669cf,0,1,0,0,0,1
12425,1702,2022-11-14 00:42:00,004adbde088facda459addeec1cd98d0,0,0,0,0,0,0
12426,1702,2022-11-14 00:46:00,0ab05e83dacd592d9c35bd1c51f3e7d7,0,2,0,0,0,2
12427,1702,2022-11-14 00:51:00,2aa77b9e74239428145ab893f9b6baf5,0,5,0,0,0,5
12428,1702,2022-11-14 00:56:00,0249db3a73ec8b587cce8e17727667cc,0,3,0,0,0,3
12429,1702,2022-11-14 01:02:00,b69084e1fccf4a0fad61a4f8f29eb8ad,0,2,0,0,0,2
12430,1702,2022-11-14 01:11:00,4b3581854311ba7c8a226ea503ba6c93,0,4,0,0,0,4
12431,1702,2022-11-14 01:17:00,bff2633c7e55fe6590b4eea15406078d,0,6,0,0,0,6
12432,1702,2022-11-14 01:21:00,77db74b01914e60b59effcc513259dc1,0,1,0,1,0,2
12433,1702,2022-11-14 01:26:00,f502839fa3ae38970ef08f34ed44c454,0,0,0,0,0,0
12434,1702,2022-11-14 01:31:00,b91101241f1b74562fdf8c8544aa8cdf,0,0,0,0,1,1
12435,1702,2022-11-14 01:36:00,67ff38fc2b00119aead3ecdaffa16f5c,0,0,0,0,0,0
12436,1702,2022-11-14 01:41:00,6406710f000dbf1cd8104a5711d82025,0,4,0,0,0,4
12437,1702,2022-11-14 01:47:00,8ba44ee8e7afb959152d02dd88f968e9,0,1,0,0,0,1
12438,1702,2022-11-14 01:52:00,1d3f7eefe05b1d6f2f42016efbc6187e,0,1,0,0,0,1
12439,1702,2022-11-14 01:56:00,6617bb49cdb858db40822a77856decae,0,0,0,0,0,0
12440,1702,2022-11-14 02:02:00,61872516aa71a5007aeee25ede6369a6,0,0,0,0,0,0
12441,1702,2022-11-14 02:08:00,3d56d5b24bb166ce893a6a5e65c090ce,0,0,0,0,0,0
12442,1702,2022-11-14 02:11:00,39d911b7ce13c7673f2059d67073a3c6,0,0,0,0,0,0
12443,1702,2022-11-14 02:16:00,d32a921ab2f296a4034503f5ebd1a412,0,1,0,0,0,1
12444,1702,2022-11-14 02:23:00,6c0a3d4a703ef315ea54024968f86ef3,0,0,0,0,0,0
12445,1702,2022-11-14 02:27:00,42957f19bc45c0b32ffe47ebda26c0f0,0,3,0,0,0,3
12446,1702,2022-11-14 02:32:00,50e0648bc5a8164cde6bc0e82acf4704,0,0,0,0,0,0
12447,1702,2022-11-14 02:37:00,1156fd64fee5cdc2a8eb1e88b7e95561,0,1,0,0,0,1
12448,1702,2022-11-14 02:41:00,df76fc7d2b91f3f8fdbdc93e9fb79894,0,0,0,0,1,1
12449,1702,2022-11-14 02:47:00,6d811bda4bf326d6121a6f2694403585,0,0,0,0,0,0
12450,1702,2022-11-14 02:52:00,ffd63c77a8f1dcc12391c63fbdb2cee6,0,0,0,0,0,0
12451,1702,2022-11-14 02:57:00,ce7128ba33d41cbd430feed6a11eeafc,0,3,0,0,0,3
12452,1702,2022-11-14 03:02:00,51c57666c033b8f0bf42c75bd0baf51f,0,0,0,0,0,0
12453,1702,2022-11-14 03:07:00,bdadcd4a7cfe1617a205346e833873a6,0,2,0,0,1,3
12454,1702,2022-11-14 03:12:00,beac1f89ea914efe31baea17b4a91e22,0,3,0,0,0,3
12455,1702,2022-11-14 03:17:00,f8efa7a96ee97e17e5808c3cc961af64,0,1,0,0,0,1
12456,1702,2022-11-14 03:21:00,76a5efe25466424f6b235789a700067b,0,4,0,0,1,5
12457,1702,2022-11-14 03:27:00,9a959919b19583bea6a401bd0766a894,0,2,0,0,0,2
12458,1702,2022-11-14 03:32:00,c902329b63b7f37c539b5b2f7b63815d,0,1,0,0,0,1
12459,1702,2022-11-14 03:38:00,2e5067b99bc217f9185741430673aeeb,0,0,0,0,0,0
12460,1702,2022-11-14 03:42:00,db4a2e6a5217fccc6f536dffb91fb290,0,2,0,0,0,2
12461,1702,2022-11-14 03:47:00,98535584d21d01b5616a95e3e140fc15,0,0,0,0,0,0
12462,1702,2022-11-14 03:53:00,bbfe732770448f291ca3c98116805979,0,2,0,1,0,3
12463,1702,2022-11-14 03:56:00,e54d4348964b2ee9b18fc7a984a301f1,0,2,0,0,0,2
12464,1702,2022-11-14 04:02:00,30c3ce8258d20240b11fbce6f8975084,0,1,0,0,1,2
12465,1702,2022-11-14 04:07:00,d2736d6de323ea0b7166292ce37d72fa,0,0,0,0,0,0
12466,1702,2022-11-14 04:11:00,d6df564206c732e9afbfadfcf1bbd511,0,0,0,0,0,0
12467,1702,2022-11-14 04:17:00,2446c15f3217306b79ad925a3aa8f925,0,0,0,0,0,0
12468,1702,2022-11-14 04:22:00,13cc11585b33624d2da1eef5f8b4115d,0,0,0,0,0,0
12469,1702,2022-11-14 04:27:00,b5c778170cd81042b8e5cd6d004e3532,0,0,0,0,0,0
12470,1702,2022-11-14 04:32:00,e2de47a12a72bc15489fac0675f97727,0,1,0,0,0,1
12471,1702,2022-11-14 04:37:00,130e753ed3991dcfabdc3abaf36660fd,0,6,0,0,0,6
12472,1702,2022-11-14 04:42:00,89b72bab8c658fac9351e4d5505e5dc9,0,0,1,0,0,1
12473,1702,2022-11-14 04:47:00,c897e110aa03f3f23c71f6e177f0a921,0,0,1,0,0,1
12474,1702,2022-11-14 04:52:00,b30c13c2d4ad3017f82e0d1426d8c753,0,1,0,0,0,1
12475,1702,2022-11-14 04:56:00,ba999490859722a2e10be9a6fedac5e3,0,0,0,0,0,0
12476,1702,2022-11-14 05:02:00,59df271af600c5355aae86e9142e9293,0,0,0,0,0,0
12477,1702,2022-11-14 05:07:00,b7aae6c9307e79ac29058fab1cf7388f,0,3,0,0,1,4
12478,1702,2022-11-14 05:12:00,099c10c853602b4731a6cb988b850a6b,0,1,0,0,0,1
12479,1702,2022-11-14 05:17:00,d6d345bdef921f61b35d0a0ce528fee9,0,1,0,0,0,1
12480,1702,2022-11-14 05:22:00,eaa0dfd8823245a4b7e46b89a8218afe,0,1,0,0,0,1
12481,1702,2022-11-14 05:26:00,d8e69c4a77e6ed679544586eab4c7642,0,0,0,1,0,1
12482,1702,2022-11-14 05:33:00,181675941bee1e1dad78c7cd0c299f34,0,2,0,0,0,2
12483,1702,2022-11-14 05:37:00,b05e92d11da1b148f56067905aab6689,0,0,0,1,0,1
12484,1702,2022-11-14 05:41:00,6b756e73702e0fa1089b5b4f4b876176,0,0,0,0,0,0
12485,1702,2022-11-14 05:47:00,3562652b9485c337e7b33e9e0819599e,0,4,0,0,0,4
12486,1702,2022-11-14 05:52:00,e446e88977ea6b842d8e8b9169b7ba82,0,2,1,0,1,4
12487,1702,2022-11-14 05:56:00,41594de6e4a1033cb25699a99af5fed9,0,1,0,1,0,2
12488,1702,2022-11-14 06:03:00,723f867ab1a86bbefea76a3f10da5dc2,0,4,0,0,0,4
12489,1702,2022-11-14 06:08:00,7d565b935b63ffa68d808252cfe50452,0,5,0,1,0,6
12490,1702,2022-11-14 06:12:00,576c14ca941e16dcb35e66b689c78e63,0,3,2,1,0,6
12491,1702,2022-11-14 06:17:00,415e74c41f330cbe7c99b244509dcd16,0,8,0,1,0,9
12492,1702,2022-11-14 06:21:00,417f7036058ff21bb02779c098a4c79b,0,4,0,0,1,5
12493,1702,2022-11-14 06:26:00,06b81525a54f2e18072168b4b2f10765,0,7,0,0,1,8
12494,1702,2022-11-14 06:32:00,569dccd33edc39e5c823f25eaec11011,0,5,1,0,0,6
12495,1702,2022-11-14 06:37:00,f37101be68158e65ceb2e5dc64e4de61,0,9,0,1,0,10
12496,1702,2022-11-14 06:41:00,8fa6d7985f20d32830c2eedc445fcd28,0,12,0,3,1,16
12497,1702,2022-11-14 06:48:00,8b9b96f758f60b1dbf951347f2c8a3c7,0,9,0,1,2,12
12498,1702,2022-11-14 06:52:00,813d79287ffc9d9a8dd7c2e08ae6cf37,0,22,1,0,7,30
12499,1702,2022-11-14 06:57:00,0cb08594876220c32b781434584e9699,1,13,0,2,4,20
12500,1702,2022-11-14 07:02:00,5a4ec5694e8e4de7cbe778cfc1feb2c2,0,21,0,2,10,33
12501,1702,2022-11-14 07:07:00,a8999220fec92302a9899da77ab70f76,0,9,0,0,8,17
12502,1702,2022-11-14 07:12:00,236d286c8cc56d27a604ca20771fb77b,0,10,0,1,8,19
12503,1702,2022-11-14 07:17:00,95d0442208711e66ac4580fced085a6f,0,15,0,3,6,24
12504,1702,2022-11-14 07:23:00,7ad44d3ed71480753721367e741e8c94,0,9,0,0,11,20
12505,1702,2022-11-14 07:27:00,cfcd02701b300a8810c2407f798d7802,0,13,0,1,9,23
12506,1702,2022-11-14 07:32:00,bc59c18eae4090c04903b3621fc2225e,0,15,0,1,9,25
12507,1702,2022-11-14 07:37:00,2546de19af71f7ec3dbe45d1a928cc15,0,11,0,0,15,26
12508,1702,2022-11-14 07:43:00,ca45e25f52748cc3032b2675850cb061,0,11,0,0,12,23
12509,1702,2022-11-14 07:47:00,b9e9f7f98293deadeaecee0d52b09277,0,15,1,1,7,24
12510,1702,2022-11-14 07:52:00,9ffb934a8f45e2dc194fcd192c6e6547,0,8,1,3,12,24
12511,1702,2022-11-14 07:57:00,e0bf34c2976e64232ef5f79f5e2b10e2,0,12,0,1,10,23
12512,1702,2022-11-14 08:01:00,403b934e4c507d1712c9fabdeeeac272,0,18,0,2,5,25
12513,1702,2022-11-14 08:07:00,b790ef0f884272299cfbc822091d1262,2,14,0,1,8,25
12514,1702,2022-11-14 08:12:00,372e31f0d8c6e5f79781059fb8d63e83,0,15,1,0,8,24
12515,1702,2022-11-14 08:18:00,b662471c590af2db65656f36f70559a8,0,14,0,4,11,29
12516,1702,2022-11-14 08:22:00,da869f897a34c327e98cf568bc9c3a78,1,17,0,2,10,30
12517,1702,2022-11-14 08:27:00,fa369d323f2e6d88092276376eb22bb7,1,15,0,2,11,29
12518,1702,2022-11-14 08:32:00,c2d50d1e57032a9736ba647e31a5115d,2,16,2,1,11,32
12519,1702,2022-11-14 08:37:00,7565e2342b5cb25c9c485b9c8f05ada3,0,7,0,2,13,22
12520,1702,2022-11-14 08:42:00,2316190a41a5932958c0e04e1300aa81,1,15,0,5,10,31
12521,1702,2022-11-14 08:47:00,83d5943848cbb77720bb54379c5da907,0,17,0,2,16,35
12522,1702,2022-11-14 08:51:00,a28a227872bae86ee32054afc6f1cbb3,0,13,0,3,7,23
12523,1702,2022-11-14 08:57:00,85f49344f8e4db0f7fad2ec54a4593bd,0,13,0,2,11,26
12524,1702,2022-11-14 09:03:00,7896bbaae121f12227afb990ab20fa5b,0,13,0,2,8,23
12525,1702,2022-11-14 09:07:00,435d03350f8a789396958762ed26b9f8,0,15,0,2,9,26
12526,1702,2022-11-14 09:12:00,7ab8b3071e7edb1a31c78ee8f2f00689,0,14,0,5,8,27
12527,1702,2022-11-14 09:17:00,0620c79557948a27bdf44d54faf9b73f,0,24,0,0,6,30
12528,1702,2022-11-14 09:22:00,30f454d49a31e725b62656f0bf47e845,0,10,0,3,10,23
12529,1702,2022-11-14 09:27:00,74831a75c33eaddab6150efd769b974b,0,10,0,2,11,23
12530,1702,2022-11-14 09:32:00,855b0217c5cefeb315af2556d8f415b0,0,16,0,7,8,31
12531,1702,2022-11-14 09:37:00,63f742c587afe7073b1b2777e72250ed,2,14,0,2,14,32
12532,1702,2022-11-14 09:41:00,7c5969afbedf3fbaeaf1a672d422c253,1,15,1,1,5,23
12533,1702,2022-11-14 09:47:00,7607e281c70c4cbd15acfcf70757c51a,1,12,0,0,10,23
12534,1702,2022-11-14 09:53:00,43e420a1c3cbf587a64662828cbb8c04,0,14,0,3,8,25
12535,1702,2022-11-14 09:57:00,28c3a4f1728686036d53b8c4fbb3b0c8,0,11,0,1,11,23
12536,1702,2022-11-14 10:02:00,7932171bb20158df21d9f8e5ec2aa2b0,0,14,1,0,11,26
12537,1702,2022-11-14 10:07:00,58fb14c280e1b187319d32f58f3d4599,1,13,0,5,14,33
12538,1702,2022-11-14 10:11:00,0c336942389e3c5a53f208f45e018d78,1,16,0,6,7,30
12539,1702,2022-11-14 10:17:00,5fac5188bf7222b3d2b65ff9312b64b9,1,14,0,3,16,34
12540,1702,2022-11-14 10:23:00,638eac0129d9dc5ffcbe76d54e2ebb87,0,13,0,1,10,24
12541,1702,2022-11-14 10:27:00,877c25a73d42d28a2ff612ebd99610ad,0,16,0,1,13,30
12542,1702,2022-11-14 10:33:00,9862c5ea556a39274d9c030a6f4b1d56,0,11,1,3,13,28
12543,1702,2022-11-14 10:37:00,0116f3f57a413de40116ba490bef0358,0,15,0,6,12,33
12544,1702,2022-11-14 10:41:00,cfb98eba14860169f2e85355fd81bad3,0,15,0,0,9,24
12545,1702,2022-11-14 10:47:00,c1bc7a62080cf356fa2ecbb568388936,0,13,0,4,11,28
12546,1702,2022-11-14 10:52:00,de36d9ed2b7d4833c31c929f2e8fd29f,0,17,0,0,10,27
12547,1702,2022-11-14 10:57:00,2b087fac53c9537530870a75fcf76ce2,0,6,0,6,10,22
12548,1702,2022-11-14 11:02:00,12b47eca60bcbc84ecbccbd43102ad25,0,17,3,1,4,25
12549,1702,2022-11-14 11:07:00,47b30f6339e6aa926105d8fbd3a22c02,2,19,0,1,8,30
12550,1702,2022-11-14 11:12:00,20eaa3b0daa265b9a17a26a2f95224bc,0,11,1,4,9,25
12551,1702,2022-11-14 11:18:00,fbda92e266a59d0eb44134c325308a27,4,10,0,1,9,24
12552,1702,2022-11-14 11:21:00,4cb3f15c2e4f4c438261566ac6a57599,0,6,1,5,10,22
12553,1702,2022-11-14 11:27:00,595ead36f4750463d995b3b40ed81e14,1,6,1,2,7,17
12554,1702,2022-11-14 11:32:00,f9d6e0df9bd389563a9057bd1dc5b9c9,1,20,1,2,7,31
12555,1702,2022-11-14 11:37:00,488c8d05db410968c4ea35e65c1db469,1,13,0,2,12,28
12556,1702,2022-11-14 11:42:00,df85a56b4c769f927197cd16c6dd30f5,2,11,0,0,11,24
12557,1702,2022-11-14 11:47:00,b2bb25c2f0488a9b8585bda26c925007,0,11,0,1,12,24
12558,1702,2022-11-14 11:52:00,d50c3dac092dce8c77448a6c3bb5be06,0,16,1,5,4,26
12559,1702,2022-11-14 11:57:00,7605179179b60d400f57dd3d4223cd42,0,9,0,1,12,22
12560,1702,2022-11-14 12:01:00,b53f0edd0d2aa73018536f9c4310b359,0,14,1,1,8,24
12561,1702,2022-11-14 12:07:00,a060aca250938994b384025822b9674f,0,10,0,2,8,20
12562,1702,2022-11-14 12:11:00,f5ab793f6918d1a5a17d5b802d9ea5eb,0,13,0,5,5,23
12563,1702,2022-11-14 12:18:00,ea5b966c2a3744b001e2c665d9133521,0,11,0,3,9,23
12564,1702,2022-11-14 12:23:00,e4a09b6b0489dc29c67bece15070b102,0,19,0,2,10,31
12565,1702,2022-11-14 12:27:00,bee2c565bc2261986af301591ce6705b,0,13,1,1,7,22
12566,1702,2022-11-14 12:32:00,bbb3f09b8a00378906b55b923235bcc3,1,15,1,2,7,26
12567,1702,2022-11-14 12:38:00,4b52e9c65ef7f555afa190684b47e3ef,1,11,4,0,8,24
12568,1702,2022-11-14 12:42:00,910190e6ce6f608e3fd55e6bf6ffbdde,0,14,0,2,3,19
12569,1702,2022-11-14 12:47:00,df337ba28f529b9935c52306e0e0c9d4,0,16,0,5,2,23
12570,1702,2022-11-14 12:52:00,4017c42b74b57383417fedddd94b9796,0,17,1,1,5,24
12571,1702,2022-11-14 12:56:00,5148f7387d527add92e76b75c29ff6e8,1,11,0,4,10,26
12572,1702,2022-11-14 13:02:00,1eafc38eb2ae7d829aa7ad28c5123f08,0,18,0,5,6,29
12573,1702,2022-11-14 13:07:00,bbca24dd7eaac608d8470f1862387679,0,14,0,3,4,21
12574,1702,2022-11-14 13:12:00,906bc3e60ff9aeeba5f73a5baa227427,0,13,0,1,9,23
12575,1702,2022-11-14 13:17:00,cac7a3a5518d2cfc358d611a8c8bc4a2,0,18,0,2,7,27
12576,1702,2022-11-14 13:22:00,74c00ff3fd62d027748008b793b30584,0,14,0,3,7,24
12577,1702,2022-11-14 13:28:00,b335499edb7fe2f27be0ffa5abc300e3,1,12,0,5,8,26
12578,1702,2022-11-14 13:32:00,0346966c636b3fc795fbad36bf9c1308,0,13,0,2,7,22
12579,1702,2022-11-14 13:38:00,4eaf0cd683eddb36e906b75975d9fd7f,0,13,0,3,4,20
12580,1702,2022-11-14 13:42:00,bf0bdb2de2aff3a44dd0f6cc48dc2991,0,22,0,5,4,31
12581,1702,2022-11-14 13:47:00,e483dbd9efac6ca06bb0f71b5ada485b,0,11,0,7,6,24
12582,1702,2022-11-14 13:53:00,bed9a16a097cc009ea9dcaf11eb0a33c,0,12,0,4,13,29
12583,1702,2022-11-14 13:57:00,347c9b4ec58f1d39fa02ce576da1ccf0,0,17,0,2,4,23
12584,1702,2022-11-14 14:02:00,924b68f34a8456d7708187c356b9a678,0,14,0,5,8,27
12585,1702,2022-11-14 14:08:00,77a6f79308e97c9e939701adbcfe2ba0,0,15,0,2,12,29
12586,1702,2022-11-14 14:11:00,dc8f4dfb153f8752f5bed382dfc34409,0,10,1,2,7,20
12587,1702,2022-11-14 14:17:00,58d9e31fdcefb859667023618e10c370,0,8,0,3,7,18
12588,1702,2022-11-14 14:22:00,364a86bc6eb7a597c509c5636bb394eb,0,22,0,2,7,31
12589,1702,2022-11-14 14:27:00,f9b27a62306117f7216c8d01a0720459,0,9,0,2,15,26
12590,1702,2022-11-14 14:32:00,db6adc24d8453e1f366403d7967fb038,3,14,0,3,10,30
12591,1702,2022-11-14 14:37:00,f0f207e7601d2ee4d577ce202dc936bf,1,11,1,4,10,27
12592,1702,2022-11-14 14:41:00,dfb3372375a6c9d644e53bd2be8a988b,0,11,0,1,7,19
12593,1702,2022-11-14 14:47:00,8e33a762b980560fa978ef475f4c1723,0,4,1,6,15,26
12594,1702,2022-11-14 14:52:00,951dd52dbe7c6d1a44b6b1028bea51df,0,10,0,4,5,19
12595,1702,2022-11-14 14:57:00,61fb348adec3c0c23e9b14f29551e8c2,0,8,0,1,9,18
12596,1702,2022-11-14 15:02:00,d889a668944e5c6f5c4d9cd67c4e1dfc,0,9,1,1,11,22
12597,1702,2022-11-14 15:08:00,3434f15b4c432e1cb545cb715b345cd5,0,8,0,3,10,21
12598,1702,2022-11-14 15:13:00,eef03e8f528cf104abc35d96ffa784d8,1,12,0,1,4,18
12599,1702,2022-11-14 15:17:00,59d263395fe7cac9a048dedf52513be2,0,9,0,5,11,25
12600,1702,2022-11-14 15:22:00,273d990aed33b06ead1b97f261dd6ba6,0,19,0,4,7,30
12601,1702,2022-11-14 15:27:00,d5862ae37d53de0dfa3a075a91d46352,0,11,0,2,13,26
12602,1702,2022-11-14 15:32:00,d1f0194403f26fbce74fa600a3cf9679,0,6,0,6,12,24
12603,1702,2022-11-14 15:37:00,05e56dfa078f772adf048549bfb21234,0,16,0,4,11,31
12604,1702,2022-11-14 15:42:00,9a4f6b49a146148b4b251374cf370f88,0,14,0,3,7,24
12605,1702,2022-11-14 15:47:00,a7aee25b6b2a641be62b3cf146c2cd4f,1,9,0,3,8,21
12606,1702,2022-11-14 15:52:00,4c63c34458bf896e44a281ec957f00f8,1,14,0,3,9,27
12607,1702,2022-11-14 15:56:00,3f16df947e41c277da48030f0cd726fc,0,11,0,0,11,22
12608,1702,2022-11-14 16:02:00,abcf020c9db460db1585d9aac661e49d,0,15,2,3,6,26
12609,1702,2022-11-14 16:07:00,046d30521fa664a5518c8f8507499851,1,12,0,2,12,27
12610,1702,2022-11-14 16:11:00,049364e9f56567c6f6072d7714db5f1c,0,15,1,6,6,28
12611,1702,2022-11-14 16:17:00,791aeb751d5cc871c2489244d53418d0,0,13,0,0,9,22
12612,1702,2022-11-14 16:22:00,a3e7a8aa2d9227760a749e93b7da9596,0,10,1,0,8,19
12613,1702,2022-11-14 16:27:00,e3ca3c697aa1f44fce4c9e9d6509b43c,0,9,0,0,11,20
12614,1702,2022-11-14 16:32:00,cc83e015b953f57affe494c9e7a2a07d,0,14,0,0,7,21
12615,1702,2022-11-14 16:37:00,f954164c5290d13b7f057e0d4219e0a5,0,14,0,2,10,26
12616,1702,2022-11-14 16:41:00,7f5ecbbaec1899b27c980cd1c77d61e0,0,15,0,9,4,28
12617,1702,2022-11-14 16:48:00,90af09735b1bbe92b680ac1bd9a217c6,1,12,0,5,10,28
12618,1702,2022-11-14 16:52:00,25a844cab98c62d495b0d33fb6b5132c,1,11,1,3,13,29
12619,1702,2022-11-14 17:02:00,9ec1b45615ac9b4842a3b4afc0cfef30,0,18,0,2,7,27
12620,1702,2022-11-14 17:07:00,ff78dba2f308b8701ee818a730ace9f7,0,11,0,1,9,21
12621,1702,2022-11-14 17:12:00,a84ad422f24ea505a99521902aa5ed91,0,17,0,5,8,30
12622,1702,2022-11-14 17:17:00,59487d18a516d1c76b0f0f8eb24871be,0,19,0,6,6,31
12623,1702,2022-11-14 17:23:00,66e4cb90d73f051255bf296dc1947bc2,0,20,1,6,6,33
12624,1702,2022-11-14 17:26:00,7f13952b354e644734ae9586df7d6b72,0,19,0,7,9,35
12625,1702,2022-11-14 17:32:00,1045613fcf06b45c996baf144c189653,0,12,2,3,7,24
12626,1702,2022-11-14 17:42:00,27bd7a32b072b800590e8ed8adde0a06,0,18,0,6,8,32
12627,1702,2022-11-14 17:47:00,ba22c6f222b0e0d0e103cbd2c66709e4,0,14,0,3,11,28
12628,1702,2022-11-14 17:57:00,ee60d63dd828fdd5cfea9e674a75dcad,1,18,0,3,10,32
12629,1702,2022-11-14 18:02:00,90238817a2449318779b04ed26d85df6,0,8,0,6,15,29
12630,1702,2022-11-14 18:07:00,661436ea99da4101832bca73510fcad9,0,19,0,8,9,36
12631,1702,2022-11-14 18:12:00,6c08ac3665a1490e19bd58678d485e27,0,17,0,7,8,32
12632,1702,2022-11-14 18:17:00,e37550276bf2669130c81b8adc55275e,7,17,2,6,10,42
12633,1702,2022-11-14 18:22:00,2ae11c16a3d58f68be24628e1393a9e0,1,15,0,2,14,32
12634,1702,2022-11-14 18:32:00,d66781f1860649729d7c48f2657435c7,6,20,2,1,11,40
12635,1702,2022-11-14 18:37:00,1c5599503f8ee5bffe8e7fc9891acb58,0,17,0,0,7,24
12636,1702,2022-11-14 18:41:00,b91c884dc443c50f5e8a7e365ca83691,0,12,2,2,14,30
12637,1702,2022-11-14 18:48:00,d75bc2e05462ac0172790e328e0ba943,0,18,0,3,5,26
12638,1702,2022-11-14 18:52:00,9d5b74139d1d4ccc65ad2eed67c50a2a,1,22,0,1,7,31
12639,1702,2022-11-14 18:56:00,fb12daf12e7d4c52cdac259aad532e7f,1,17,0,0,2,20
12640,1702,2022-11-14 19:02:00,839e8e3446e3b8c811f49f80cc1b6003,0,22,0,0,3,25
12641,1702,2022-11-14 19:07:00,d50b9b68cfa8ef1e78fbed625d1c5cd4,0,27,1,0,1,29
12642,1702,2022-11-14 19:11:00,b5780d1e063142366acec6253c03f198,0,13,1,0,1,15
12643,1702,2022-11-14 19:17:00,abcb2695840e870aa7f978d57c18fb38,0,11,1,0,0,12
12644,1702,2022-11-14 19:22:00,d8ef47eed9b0fba909c697e3e4950176,0,15,1,0,0,16
12645,1702,2022-11-14 19:27:00,c4e52ced9f40125266411712c734c0d0,0,11,0,1,0,12
12646,1702,2022-11-14 19:32:00,610587fe4d7e914c32c101ac2195739f,0,13,0,0,1,14
12647,1702,2022-11-14 19:38:00,76c76b23a49cd4a9a75a75f61071f7a4,1,14,1,0,0,16
12648,1702,2022-11-14 19:41:00,a67e1f8474242dac2840ecc0982a7aff,0,16,1,0,3,20
12649,1702,2022-11-14 19:46:00,d80edf63dd1bb8d656ef75d301cb0abf,0,18,0,0,3,21
12650,1702,2022-11-14 19:51:00,304ee80747f9154f03cff6be3aff075a,0,22,1,4,0,27
12651,1702,2022-11-14 19:56:00,4caddf7e4e34c057a00231e913e5a656,0,18,0,1,1,20
12652,1702,2022-11-14 20:02:00,615eda28055ba53e618abb73c771f672,0,14,0,0,0,14
12653,1702,2022-11-14 20:07:00,2dfcf606e179a65bd560af794429f0c5,0,16,0,0,1,17
12654,1702,2022-11-14 20:12:00,7350fc398a9c424fbe9bbf650cdbef24,0,16,0,0,0,16
12655,1702,2022-11-14 20:17:00,e7815254eea524ac49e5d9bbe35097e7,1,17,0,1,0,19
12656,1702,2022-11-14 20:22:00,25ecb0dbb32210cb48dcede71e2818e9,0,14,0,0,0,14
12657,1702,2022-11-14 20:26:00,a7ad07d5b73cd71446785bed0caaa4de,0,20,0,4,1,25
12658,1702,2022-11-14 20:31:00,7fb57e75aaf8ed642bfa570d93ceb275,0,13,2,0,0,15
12659,1702,2022-11-14 20:36:00,adb88c34dc561766811b82a7bbe2bc52,0,19,1,0,2,22
12660,1702,2022-11-14 20:41:00,96ef659f44c7d3efb74ecc7dc8331e1b,0,10,0,1,2,13
12661,1702,2022-11-14 20:46:00,96bd4d0b30c1ff8faae95c0924a5e9f6,0,11,0,2,1,14
12662,1702,2022-11-14 20:51:00,e3bb5b616d14d79b7d9b795441f69190,0,16,0,0,1,17
12663,1702,2022-11-14 20:56:00,69ee1a32fbef520b5434ea002b3957e4,0,12,1,0,1,14
12664,1702,2022-11-14 21:01:00,50b5606a351e9fc5f0816d3219a9d8b3,0,27,0,1,1,29
12665,1702,2022-11-14 21:07:00,9c48a0792806403b478e9ae25a9316f8,0,9,0,0,1,10
12666,1702,2022-11-14 21:11:00,724204e2aba4cadd0190af3a20f89c04,0,21,0,2,0,23
12667,1702,2022-11-14 21:17:00,f07f99cc448d9a8a7fda5c4a1fa1139a,0,21,0,0,0,21
12668,1702,2022-11-14 21:21:00,6ac499b3f133de4a8bb93a0349627174,0,19,0,0,2,21
12669,1702,2022-11-14 21:26:00,98065e1559009d27867271f0cc482f26,0,19,0,0,0,19
12670,1702,2022-11-14 21:31:00,3d91afc2f53fc688e18cd0c816357b8f,0,21,0,2,0,23
12671,1702,2022-11-14 21:38:00,77cf043bc014bd8702f2592bab96d54f,0,14,0,0,2,16
12672,1702,2022-11-14 21:41:00,d6f6a5a29895f1b4426fff449bbd6f18,0,20,0,0,1,21
12673,1702,2022-11-14 21:47:00,bfb084fb85aa0eb47f526903d4ff9e3c,0,17,0,2,1,20
12674,1702,2022-11-14 21:51:00,793118920c5ee4a095f4c250e996a4be,0,16,0,0,2,18
12675,1702,2022-11-14 21:56:00,ed31473c2300080eef391f3b51efb14a,0,16,0,0,0,16
12676,1702,2022-11-14 22:02:00,947afcb7fd1d5d6e58e33ac74f90bb3a,0,14,0,0,3,17
12677,1702,2022-11-14 22:08:00,3add4f5f4c6fbd577342b9e348c3a74a,0,22,3,0,1,26
12678,1702,2022-11-14 22:11:00,87ac82bebe6bda4ca9c8ffe681e1e8dc,0,21,0,0,3,24
12679,1702,2022-11-14 22:16:00,8fba71ab4771424614db47bf0f5277f9,0,9,0,0,2,11
12680,1702,2022-11-14 22:22:00,fe16332b31eeeee961572b787a690e1b,0,20,0,0,0,20
12681,1702,2022-11-14 22:27:00,7ca567a8621f0dbae7213073bbe5f538,0,19,0,0,0,19
12682,1702,2022-11-14 22:32:00,52b541655f2d9b04fc5df09974ff1efa,0,12,1,0,1,14
12683,1702,2022-11-14 22:37:00,8588403dcc73b264ae9a834f0cbc77ce,0,12,0,1,1,14
12684,1702,2022-11-14 22:42:00,bd6c9b570ac670d62e0210db4a656645,0,14,1,1,0,16
12685,1702,2022-11-14 22:47:00,90b1a3bcdb54ebbf1d31a26431c42c2a,0,7,1,0,0,8
12686,1702,2022-11-14 22:52:00,5dc0453dba9485aaf96438bff557afbb,0,12,0,0,0,12
12687,1702,2022-11-14 22:56:00,85f81e9ca611fb637ef5cad77455243b,0,14,0,0,1,15
12688,1702,2022-11-14 23:02:00,6527ff7c0bc16197993ddc7fe172ec5a,0,15,0,0,0,15
12689,1702,2022-11-14 23:07:00,935d3102daa549eacc822cb644906e33,0,7,1,1,1,10
12690,1702,2022-11-14 23:11:00,a8a373887969db9bd4af2285001a7969,0,13,0,0,1,14
12691,1702,2022-11-14 23:17:00,394fc634159ed0e1a143285297489720,0,7,0,0,0,7
12692,1702,2022-11-14 23:21:00,c08f57c2ac7ab542e6d10f53252659ac,0,18,0,0,0,18
12693,1702,2022-11-14 23:27:00,de700e02f2208975cbe9799403bec7ea,0,13,0,0,0,13
12694,1702,2022-11-14 23:32:00,d95d53827daaab006dc018e061a0f25b,0,9,0,0,2,11
12695,1702,2022-11-14 23:36:00,3223878a4ab6671a4ad1b8c9a1931a11,0,13,0,1,0,14
12696,1702,2022-11-14 23:42:00,8af9a6fdd902d54c8c61919c3365e7fe,0,13,1,1,2,17
12697,1702,2022-11-14 23:47:00,67e3956d303b71ea9c40504e06a1e6d6,0,7,0,0,0,7
12698,1702,2022-11-14 23:52:00,f764aa0e6962ca094fb532fadfe50729,0,8,0,0,1,9
